Input	Target	Predicted
fire	ஃபயர்	சின்
phayar	ஃபயர்	பாட்
baar	ஃபார்	பாட்
bar	ஃபார்	பாம்
far	ஃபார்	பாட்
for	ஃபார்	பாட்
hpaar	ஃபார்	மிட்டர்
agatrtri	அகற்றி	அடையி
agattri	அகற்றி	அட்டி
akatrtri	அகற்றி	அர்்கிய
agatrtrinaar	அகற்றினார்	இரு்கத்தில்
akatrinaar	அகற்றினார்	அரிப்பால்
akatrtrinaar	அகற்றினார்	இருப்புகள்
academi	அகாதமி	அர்போரி
academy	அகாதமி	அர்போரி
angiekariththathu	அங்கீகரித்தது	அற்படுத்திற்கு
angkeekariththathu	அங்கீகரித்தது	முற்க்கிற்றது
angkeegaara	அங்கீகார	முற்க்கா
angkeekaara	அங்கீகார	அரிசாகமா
angkeegaaraththai	அங்கீகாரத்தை	முற்குக்களை
angkeekaaraththai	அங்கீகாரத்தை	முக்குக்களை
anggeegaaram	அங்கீகாரம்	முறுமையாகப்
anggeekaaram	அங்கீகாரம்	அவர்க்கார்
angiekaaram	அங்கீகாரம்	அவர்களால்
angkeekaaram	அங்கீகாரம்	அவர்க்கார்
asan	அசன்	அவின்
aasin	அசின்	மேனின்
asin	அசின்	அவின்
asaiyaadha	அசையாத	அரிந்த
asaiyaatha	அசையாத	அரியாத
stationaree	அசையாத	ஸ்டீட்டியா
stationari	அசையாத	சிர்விிய்
stationarii	அசையாத	சிர்வியாவி
stationary	அசையாத	சிர்கிரியா
stationri	அசையாத	சிர்விிய்
stetionaree	அசையாத	ஸ்டீட்டியா
stetionary	அசையாத	சிர்கிரியா
stetionri	அசையாத	சிர்விிய்
asaiaamal	அசையாமல்	அர்தார்
asaiyaamal	அசையாமல்	அர்தியம்
asaiyamal	அசையாமல்	அர்தார்
ashoka	அசோக	மகாமா
asoga	அசோக	அசியா
asoka	அசோக	அசியா
ashokarin	அசோகரின்	மு்தியின்
asokarin	அசோகரின்	அர்ச்சில்
ashokar	அசோகர்	மக்கர்
asokar	அசோகர்	அசியர்
ajai	அஜய்	அரி
ajaii	அஜய்	அரி
ajay	அஜய்	அரி
aje	அஜய்	மேனி
azai	அஜய்	அரா
azay	அஜய்	அரா
adakkinaar	அடக்கினார்	இரு்கத்தில்
adanggiyirukkum	அடங்கியிருக்கும்	இருப்புக்கார்
adangiyirukkum	அடங்கியிருக்கும்	அறிப்புக்கார்
adankiyirukkum	அடங்கியிருக்கும்	அற்படுத்துகள்
adangkiyullathu	அடங்கியுள்ளது	அடு்கி்பட்டு
adams	அடம்ஸ்	அரிஸ்
adigalaal	அடிகளால்	இரு்களில்
adigalin	அடிகளின்	இருக்கில்
adigalil	அடிகளில்	இரு்களின்
adikalil	அடிகளில்	இரு்களின்
adigalai	அடிகளை	இரு்கை
adigazhai	அடிகளை	இரு்கை
adikalai	அடிகளை	அதைகளை
adigal	அடிகள்	அரியம்
adikal	அடிகள்	அரியம்
adikkadip	அடிக்கடிப்	இர்க்கிில்
adikkum	அடிக்கும்	இடை்கும்
adippadaiyilaana	அடிப்படையிலான	அற்படுத்தையை
adippadaiyilaanadhu	அடிப்படையிலானது	அற்படுத்திற்கு
adippadaiyilaanathu	அடிப்படையிலானது	அற்படுத்திற்கு
adippadiyilaanathu	அடிப்படையிலானது	அற்படுத்திற்கு
adiyaaga	அடியாக	அரியாக
adiyaga	அடியாக	அரியாக
adiyaka	அடியாக	அரியாக
adiyin	அடியின்	அர்டின்
adiyil	அடியில்	அர்டின்
atiyil	அடியில்	அர்டின்
adiye	அடியே	அடி
adiyee	அடியே	அர்சி
atiyee	அடியே	அர்சி
adiyodu	அடியோடு	அற்போது
adiyoodu	அடியோடு	அற்போது
atiyootu	அடியோடு	அன்போது
adivayirrai	அடிவயிற்றை	இருப்பதை
adivayitrai	அடிவயிற்றை	இருப்பதை
adivayittrai	அடிவயிற்றை	இய்்கு்களை
ativayirrai	அடிவயிற்றை	இருப்பதை
addes	அடிஸ்	அர்ஜி
addis	அடிஸ்	அர்ஜி
addiss	அடிஸ்	அர்ஜின்
addys	அடிஸ்	அர்ஜி
addyss	அடிஸ்	அர்ஜின்ஸ்
ades	அடிஸ்	அரிஸ்
adis	அடிஸ்	அரிஸ்
adyss	அடிஸ்	அரிஷ்
adukka	அடுக்க	இழுந்த
adukkaaga	அடுக்காக	இரு்்தாக
adukkaaka	அடுக்காக	இரு்்தாக
atukkaaga	அடுக்காக	அதிக்காாக
atukkaaka	அடுக்காக	அதைக்காக
aduththu	அடுத்து	இழுந்து
aduthu	அடுத்து	இட்்து
adutthu	அடுத்து	இழுந்து
attaak	அட்டாக்	அர்மாம்
attack	அட்டாக்	அர்பியன்
anivadhae	அணிவதே	அர்பானை
anivadhey	அணிவதே	அர்போரி
anivathae	அணிவதே	அர்சியை
anivathey	அணிவதே	அர்போரி
adhigappadiyaana	அதிகப்படியான	அதிக்புக்கான
athigappadiyaana	அதிகப்படியான	அதிக்புக்கான
athikappatiyaana	அதிகப்படியான	அற்படுத்தையை
adhikamaana	அதிகமான	அரிமாகாான
adikamaana	அதிகமான	அரிமையான
athikamaana	அதிகமான	அரிமாகாான
atikamaana	அதிகமான	அரிமாகாான
adhikamaanavai	அதிகமானவை	அரி்கத்தை
athigamaanavai	அதிகமானவை	அரி்கத்தை
athikamaanavai	அதிகமானவை	அரி்கத்தை
adhikamaanoor	அதிகமானோர்	அரிப்புகள்
athigamaanoor	அதிகமானோர்	அரிப்புகள்
athikamaanoar	அதிகமானோர்	அரிச்சியம்
athiradith	அதிரடித்	அர்க்கில்
athiradip	அதிரடிப்	அரும்பின்
adhilirundhdha	அதிலிருந்த	அதிக்கின்றன
athiliruntha	அதிலிருந்த	அதிக்பட்ட
adhilulla	அதிலுள்ள	இரு்கின்றன
athilulla	அதிலுள்ள	அதிக்பாக
adele	அதிலே	அடியா
adhilae	அதிலே	அடை
adhile	அதிலே	அடியா
athilae	அதிலே	அர்யா
athile	அதிலே	அட்டி
adheedha	அதீத	அழுமா
adhidha	அதீத	அழுமா
atheetha	அதீத	அர்மா
athitha	அதீத	அழிக
athaepoola	அதேபோல	அர்சாமை
atheepola	அதேபோல	அர்சாமை
athepola	அதேபோல	அரியாயா
advaita	அத்வைத	அதிகமான
advaitha	அத்வைத	அழிந்த
athvaidha	அத்வைத	அழிந்த
athvaitha	அத்வைத	அதித்த
advaidam	அத்வைதம்	அரிக்கம்
advaitham	அத்வைதம்	அதைக்கும்
adwaytham	அத்வைதம்	அரி்களால்
athvaidham	அத்வைதம்	அரிக்கம்
athvaitham	அத்வைதம்	அரிக்கார்
andhach	அந்தச்	அமியன்
anthac	அந்தச்	அர்பார்
anthach	அந்தச்	அமியன்
andhath	அந்தத்	அர்பார்
anthath	அந்தத்	அர்பார்
andham	அந்தம்	அர்மாம்
antham	அந்தம்	அர்மம்
andhu	அந்து	இயாது
anthu	அந்து	இயாது
ana	அனா	அமா
anaa	அனா	அமா
anna	அனா	அராமா
annaa	அனா	அர்சா
anaadhai	அனாதை	அர்மா
anaathai	அனாதை	அர்மான
anaadhaiyaana	அனாதையான	அரிமையான
anaathaiyaana	அனாதையான	அரிமாக்கை
anupallavee	அனுபல்லவி	அடுப்பதை
anupallavi	அனுபல்லவி	இந்திரியி
anupazhavee	அனுபல்லவி	அதிக்கைய
anupazhavi	அனுபல்லவி	இந்திரியா
anubavikkum	அனுபவிக்கும்	அற்பிருக்கம்
anupavikkum	அனுபவிக்கும்	அற்பிருக்கம்
anupavikum	அனுபவிக்கும்	அற்பத்தார்
anuraadhapura	அனுராதபுர	அன்பிட்டாக
anuraathapura	அனுராதபுர	அன்பிட்டாக
anuradhapura	அனுராதபுர	அதிக்ப்பாக
anurathapura	அனுராதபுர	அன்பிட்டாக
anushka	அனுஷ்கா	அசியா
anushkaa	அனுஷ்கா	அசியானை
andriyum	அன்றியும்	அவர்களாலும்
antriyum	அன்றியும்	அம்ப்பும்
abaabaa	அபாபா	அரியா
ababa	அபாபா	அமா
abbaba	அபாபா	அர்பா
apapa	அபாபா	அராமா
aboo	அபூ	மாயா
abu	அபூ	அது
aboorva	அபூர்வ	அர்பாக
apoorva	அபூர்வ	அர்சாக
aboorvamaaga	அபூர்வமாக	அரிசாகமான
aboorvamaaka	அபூர்வமாக	அரிசாகமான
aburvamaaka	அபூர்வமாக	அரிமாக்கா
apoorvamaaga	அபூர்வமாக	முற்கின்ற
apoorvamaaka	அபூர்வமாக	முற்க்காக
abdhul	அப்துல்	மு்்கள்
abdool	அப்துல்	அர்சின்
abdul	அப்துல்	அர்தார்
abduul	அப்துல்	அர்சாம்
abthul	அப்துல்	முடுகள்
appaguthiyil	அப்பகுதியில்	இந்திர்ட்டின்
appakuthiil	அப்பகுதியில்	இந்திர்களின்
appakuthiyil	அப்பகுதியில்	இந்திர்ட்டின்
appaguthiyai	அப்பகுதியை	முற்குகளை
appakuthiai	அப்பகுதியை	அந்திர்கை
appakuthiyai	அப்பகுதியை	இந்திர்கை
appadaththin	அப்படத்தின்	இந்திரியின்
appadatthin	அப்படத்தின்	இந்திரியின்
appadam	அப்படம்	அந்தார்
appen	அப்பெண்	அர்சன்
appenn	அப்பெண்	அர்ஜின்
appoluthuthaan	அப்பொழுதுதான்	முற்க்கு்களில்
appoluthuthan	அப்பொழுதுதான்	முற்கிர்கள்
appozhuthuthaan	அப்பொழுதுதான்	முற்குகிறார்
apppozhuthuthaan	அப்பொழுதுதான்	மு்்குகி்களில்
aposthalar	அப்போஸ்தலர்	முறுமையாகம்
appoashthalar	அப்போஸ்தலர்	முற்கிர்கள்
appoosthalar	அப்போஸ்தலர்	முற்கிரமாம்
apposthalar	அப்போஸ்தலர்	முற்கிறார்
americargalin	அமெரிக்கர்களின்	இந்திர்க்கில்
americarkalin	அமெரிக்கர்களின்	இந்திர்க்கில்
amerikkargalin	அமெரிக்கர்களின்	இந்திருக்கிின்
amerikkarkalin	அமெரிக்கர்களின்	இந்திருக்கிின்
americaavin	அமெரிக்காவின்	இந்திரியின்
americavin	அமெரிக்காவின்	இந்திரியின்
amerikkaavin	அமெரிக்காவின்	இந்திர்ட்டின்
americaavirkum	அமெரிக்காவிற்கும்	மு்்கி்திலும்
americavirkkum	அமெரிக்காவிற்கும்	மு்்க்கு்தையும்
americavirkum	அமெரிக்காவிற்கும்	மு்்கி்திலும்
amerikkaavirkum	அமெரிக்காவிற்கும்	மு்்க்கின்றனர்
americaavilum	அமெரிக்காவிலும்	மு்்கி்களும்
americavilum	அமெரிக்காவிலும்	மு்்கி்களும்
amerikkaavilum	அமெரிக்காவிலும்	மு்்க்கு்தாலும்
americaavilulla	அமெரிக்காவிலுள்ள	முற்கப்பட்டன
americavilulla	அமெரிக்காவிலுள்ள	முற்கப்பட்டன
amerikkaavilulla	அமெரிக்காவிலுள்ள	முற்கப்பட்டன
americaavudan	அமெரிக்காவுடன்	முற்கிர்கள்
americavudan	அமெரிக்காவுடன்	முற்கிர்கள்
amerikkaavudan	அமெரிக்காவுடன்	இந்திரங்களில்
americaavum	அமெரிக்காவும்	முற்கிறார்
americavum	அமெரிக்காவும்	முற்களாகும்
amerikkaavum	அமெரிக்காவும்	மு்்கி்களும்
amaichchu	அமைச்சு	அற்போது
amaichu	அமைச்சு	அன்று
amaiththup	அமைத்துப்	அற்பாகும்
amaithup	அமைத்துப்	அற்றும்
amaitthup	அமைத்துப்	அற்பாடும்
amaiththum	அமைத்தும்	அற்றாகும்
amaithum	அமைத்தும்	அற்றும்
amaitthum	அமைத்தும்	அற்பாகும்
perrullatu	அமையப்	செல்கின்றன
petrtrullathu	அமையப்	பாட்டி்தது
petrullathu	அமையப்	பாட்டித்தது
amsa	அம்ச	அசியா
amchankalaaka	அம்சங்களாக	முற்கின்றன
amchankalaka	அம்சங்களாக	முற்கின்றன
amsangalaaga	அம்சங்களாக	அரிசாய்கான
amsangkalaaka	அம்சங்களாக	மு்பி்தாக
amachankalin	அம்சங்களின்	இந்திரியின்
amasankalin	அம்சங்களின்	இந்திரியின்
amsangalin	அம்சங்களின்	இந்திரியில்
amsangkalin	அம்சங்களின்	இந்திரியின்
amchankalai	அம்சங்களை	முற்கத்தை
amsangalai	அம்சங்களை	அந்திர்கை
amsankalai	அம்சங்களை	அந்திர்கை
amsangalaiyum	அம்சங்களையும்	மு்்கி்களும்
amsangazhaiyum	அம்சங்களையும்	மு்்கி்களும்
amsanggalaiyum	அம்சங்களையும்	மு்்கி்களால்
amsangal	அம்சங்கள்	அவிக்கால்
amsangazh	அம்சங்கள்	அம்புகளில்
amsanggal	அம்சங்கள்	முறுமையில்
amsamaaga	அம்சமாக	அர்பாகா
amcham	அம்சம்	மக்கம்
amsam	அம்சம்	அசியம்
ammonium	அம்மோனியம்	அசிச்கால்
ammoniumm	அம்மோனியம்	முறுமையில்
ammoniuum	அம்மோனியம்	முறுமையாகம்
ammoniuumm	அம்மோனியம்	முறுமையாளர்
ammoonium	அம்மோனியம்	முறுமையால்
ammooniumm	அம்மோனியம்	முறுமையில்
ammooniyam	அம்மோனியம்	முறுமையில்
amoniam	அம்மோனியம்	அர்சாம்
amoniamm	அம்மோனியம்	அர்சுகம்
amonium	அம்மோனியம்	அர்சாமல்
amoniuum	அம்மோனியம்	அர்சுகம்
amonnium	அம்மோனியம்	அர்சுகள்
amonniuum	அம்மோனியம்	முறுமையாகம்
amooniamm	அம்மோனியம்	அர்சுகள்
amoonium	அம்மோனியம்	அசிசாமல்
amoonnium	அம்மோனியம்	முறுமையாகம்
ammonia	அம்மோனியா	அர்சுமி
ammoniaa	அம்மோனியா	அர்சுமி
ammoniia	அம்மோனியா	அர்சுமி
ammoonia	அம்மோனியா	அர்சுமி
ammooniaa	அம்மோனியா	அர்சுமி
ammooniia	அம்மோனியா	அர்சுமி
ammooniya	அம்மோனியா	அர்சியை
amonia	அம்மோனியா	அரியா
amoniaa	அம்மோனியா	அசியா
amoniia	அம்மோனியா	அர்சி
amoonia	அம்மோனியா	அசிசாயா
arakkanai	அரக்கனை	அதிகமானை
arrakkanai	அரக்கனை	அரி்கத்தை
aruga	அருக	அழுமா
aruka	அருக	அழுமா
arugaaga	அருகாக	அழி்காக
arukaaka	அருகாக	அதிக்க
arukaka	அருகாக	அதிதாக
aarun	அருண்	அமின்
aaruun	அருண்	அவின்
aroon	அருண்	அரின்
arrun	அருண்	அமின்
arruun	அருண்	அர்சன்
arun	அருண்	அரான்
arunn	அருண்	அரியன்
aruun	அருண்	அவின்
aruunn	அருண்	அர்ட்
vijai	அருண்	விஜ்
vijay	அருண்	விச்சி
arundhi	அருந்தி	அர்்கியி
arunthi	அருந்தி	இர்்கியி
arppaniththaar	அர்ப்பணித்தார்	அற்படுத்துகள்
arppaniththu	அர்ப்பணித்து	முற்்பட்டது
arimuga	அறிமுகம	அதித்த
arimugama	அறிமுகம	அற்பதாக
arimuka	அறிமுகம	அரியாக
mudikirathu	அறிய	முற்கிற்கு
mudiyaatha	அறிய	முற்காக
mutikiratu	அறிய	முற்கிற்கு
mutiyata	அறிய	முக்கி
ariyak	அறியக்	அரியா்
ariyakkoodiya	அறியக்கூடிய	அமிப்புடியி
ariyappadum	அறியப்படும்	அற்பிட்கம்
ariyappattavar	அறியப்பட்டவர்	அற்படுத்துகள்
ariyappattaar	அறியப்பட்டார்	அறிப்புக்கால்
ariyappattaalum	அறியப்பட்டாலும்	அற்படுத்துகள்
ariyappattulladhu	அறியப்பட்டுள்ளது	அற்படுத்துக்கு
ariyappattullathu	அறியப்பட்டுள்ளது	அற்படுத்துக்கு
ariyavillai	அறியவில்லை	அரிப்புகை
ariyavum	அறியவும்	அற்றாகும்
ariyaa	அறியா	அரியா
ariyaamal	அறியாமல்	அர்த்தார்
arivadhil	அறிவதில்	அர்க்கில்
arivathaal	அறிவதில்	அரிப்பால்
arivathil	அறிவதில்	அர்க்கில்
arivaar	அறிவார்	அர்சாம்
arivaal	அறிவால்	அர்மான்
arivippu	அறிவிப்பு	அன்பிற்கு
arivippugal	அறிவிப்புகள்	இந்திரங்கள்
arivippukal	அறிவிப்புகள்	இந்திரங்கள்
arivippup	அறிவிப்புப்	அற்பிட்களும்
arivae	அறிவே	அர்யா
arupathu	அறுபது	அழிந்து
ali	அலி	அடி
alii	அலி	அடி
aligaar	அலிகார்	அர்மான்
aligar	அலிகார்	அர்மான்
aligarh	அலிகார்	அர்மைன்
alikaar	அலிகார்	அர்மான்
aliyin	அலியின்	அர்டின்
aliyai	அலியை	அர்யா
alboansaa	அல்போன்சா	இந்தோரியா
alphonse	அல்போன்சா	அர்போரி
alpoansaa	அல்போன்சா	இந்தோரியா
alavu	அளவு	அடு
alavugalail	அளவுகளில்	இரு்களில்
alavugalil	அளவுகளில்	இரு்களின்
alavukalil	அளவுகளில்	இரு்களின்
alavugalaik	அளவுகளைக்	இரு்கையால்
alavukalaik	அளவுகளைக்	இரு்கையால்
alavugalaiyum	அளவுகளையும்	இடு்களாலும்
alavukalaiyum	அளவுகளையும்	இடு்களாலும்
alavukkaana	அளவுக்கான	அதிக்காாக
alavukku	அளவுக்கு	அழிந்து
alavudan	அளவுடன்	இருகள்
alavum	அளவும்	அழும்
azhiththa	அழித்த	அழிந்த
azhiththal	அழித்தல்	அரிக்கள்
alaippugalai	அழைப்புகளை	அருக்கத்தை
alaippukalai	அழைப்புகளை	அருக்கத்தை
azhaippukalai	அழைப்புகளை	அருக்கத்தை
alaippugal	அழைப்புகள்	இருப்புகள்
alaippukal	அழைப்புகள்	அருக்கிறார்
azhaippukal	அழைப்புகள்	இருப்புகள்
avadhaara	அவதார	அதைகா
avathaara	அவதார	அதியா
avathaaranggalai	அவதாரங்களை	அருக்கத்தை
avathaarangkalai	அவதாரங்களை	அரி்கு்களை
avathaaramaaga	அவதாரமாக	அதிக்காக
avathaaramaaka	அவதாரமாக	அதிக்காக
avathaaramaana	அவதாரமான	அரிமையாான
avadhaaram	அவதாரம்	அதிகள்
avathaaram	அவதாரம்	அர்மால்
avaraagavae	அவராகவே	அரிமையை
avaraakavae	அவராகவே	அரிமையை
avaridamae	அவரிடமே	அர்பாமான
avaritamae	அவரிடமே	அர்பாலை
avatrtrul	அவற்றுள்	இரங்கள்
avatrul	அவற்றுள்	இர்கள்
avattrul	அவற்றுள்	இத்தார்
avalum	அவளும்	அழும்
avalai	அவளை	அடை
astro	அஸ்ட்ரோ	முனியா
astroa	அஸ்ட்ரோ	முக்கி
aagindradhu	ஆகின்றது	அன்போது
aagindrathu	ஆகின்றது	அன்போது
aakinrathu	ஆகின்றது	அற்போது
aakintrathu	ஆகின்றது	அன்போது
aasirama	ஆசிரம	மகாமாக
aasiramaththin	ஆசிரமத்தின்	முறுக்கிில்
aachiramaththai	ஆசிரமத்தை	முற்கியான
aasiramaththai	ஆசிரமத்தை	முற்கத்தை
aachiriyaraaka	ஆசிரியராக	முற்கின்றன
aasiriyaraaga	ஆசிரியராக	முற்கின்றன
aasiriyaraaka	ஆசிரியராக	முற்கின்றன
assiriyaraaga	ஆசிரியராக	முற்கின்றன
aasiriyaraakak	ஆசிரியராகக்	முற்கின்றார்
assiriyaraagak	ஆசிரியராகக்	முற்கின்றார்
asar	ஆசேர்	அவர்
aseer	ஆசேர்	அமின்
aser	ஆசேர்	அமான்
ashar	ஆசேர்	மாட்
asher	ஆசேர்	அமான்
iser	ஆசேர்	மேக்
ysar	ஆசேர்	மான்
yseer	ஆசேர்	மேக்
yser	ஆசேர்	மேக்
ysher	ஆசேர்	மேடர்
aadi	ஆடி	அரி
aadii	ஆடி	அவி
adi	ஆடி	அடி
adii	ஆடி	அடி
aodi	ஆடி	அரி
aodii	ஆடி	அவி
audi	ஆடி	அராஜ்
audii	ஆடி	மானி
auudi	ஆடி	அரி
avdi	ஆடி	அரியா
awdi	ஆடி	அரியா
awdii	ஆடி	அர்சி
maatham	ஆடி	மாடம்
matam	ஆடி	மாடம்
aadu	ஆடு	அது
aadukalin	ஆடுகளின்	அர்க்கில்
aadugalukku	ஆடுகளுக்கு	அற்படுத்தும்
aadukalukku	ஆடுகளுக்கு	அற்படுத்தும்
aadugalai	ஆடுகளை	அரு்்தை
aadukalai	ஆடுகளை	அரி்கைய
aadugal	ஆடுகள்	அரியம்
aadukal	ஆடுகள்	அரியம்
aanaagap	ஆணாகப்	அர்மார்
aanaakap	ஆணாகப்	அர்பர்
kulantai	ஆண்	குடுகளை
kulanthai	ஆண்	குடுகளை
kuzhandhai	ஆண்	குடுகளை
aangalil	ஆண்களில்	அர்த்தில்
aankalil	ஆண்களில்	அர்த்தில்
aangalikku	ஆண்களுக்கு	அன்றியாக்கு
aangalukku	ஆண்களுக்கு	அன்பிற்கு
aangalukkum	ஆண்களுக்கும்	மு்்கிற்கும்
aankalukkum	ஆண்களுக்கும்	அமிப்புகம்
aangaludan	ஆண்களுடன்	அவர்களால்
aankaludan	ஆண்களுடன்	அவர்களால்
aangalai	ஆண்களை	அர்கதை
aankalai	ஆண்களை	அர்கையை
aangalaiyum	ஆண்களையும்	அவர்களாகும்
aankalaiyum	ஆண்களையும்	அவர்களாகும்
aankaliayum	ஆண்களையும்	அவர்களாகும்
aandaan	ஆண்டான்	அர்சான்
aantaan	ஆண்டான்	அர்சான்
aandaar	ஆண்டார்	அர்சாம்
aantaar	ஆண்டார்	அர்சாம்
aadhanaal	ஆதனால்	அவியல்
aathanaal	ஆதனால்	அவியர்
aatharavaliththa	ஆதரவளித்த	அன்பிட்டாக
aatharavaliththu	ஆதரவளித்து	அன்றிக்கு
aatharavaagap	ஆதரவாகப்	அதைக்கும்
aatharavaakap	ஆதரவாகப்	அரிக்கார்
aatharavaap	ஆதரவாகப்	அரிகமாம்
aatharavaagavum	ஆதரவாகவும்	அவர்களாகும்
aatharavaakavum	ஆதரவாகவும்	அவர்களாகும்
aatharavin	ஆதரவின்	அர்டின்
aatharavil	ஆதரவில்	அம்பில்
aatharikka	ஆதரிக்க	அதிக்தாக
aatharikkum	ஆதரிக்கும்	அற்பிக்கும்
aathmaavum	ஆத்மாவும்	அற்றாகும்
aathmaavai	ஆத்மாவை	அர்கதை
aanthaigal	ஆந்தைகள்	அர்த்தார்
aanthaikal	ஆந்தைகள்	அர்சாமல்
aanththaigal	ஆந்தைகள்	அர்சியார்
aanththaikal	ஆந்தைகள்	அர்சியம்
aanand	ஆனந்த்	அமின்
aananth	ஆனந்த்	அமின்
aananthdh	ஆனந்த்	அர்யன்
aananthth	ஆனந்த்	அர்சான்
anand	ஆனந்த்	அமின்
anandd	ஆனந்த்	அட்டில்
anandh	ஆனந்த்	அட்ட்
anannd	ஆனந்த்	அர்சன்
annt	ஆனந்த்	அமின்
aanmaavin	ஆன்மாவின்	அம்பியின்
aanmaavai	ஆன்மாவை	அர்சாமை
aabathaithk	ஆபத்தைக்	அர்பியின்
aabaththaik	ஆபத்தைக்	அர்த்தார்
aapaththaik	ஆபத்தைக்	அர்சியம்
aapgaaniya	ஆப்கானிய	மு்்பியை
aapkaaniya	ஆப்கானிய	அர்சியை
afghaaniya	ஆப்கானிய	மு்்பியை
afghaniya	ஆப்கானிய	அர்சியை
aappirikkaa	ஆப்பிரிக்கா	மு்்புகளை
aaprikkaa	ஆப்பிரிக்கா	முறுக்கை
affrica	ஆப்பிரிக்கா	மு்்பியா
afreca	ஆப்பிரிக்கா	அர்சியா
africa	ஆப்பிரிக்கா	அர்சியா
africaa	ஆப்பிரிக்கா	அர்சியி
afrika	ஆப்பிரிக்கா	அசியாா
afriqa	ஆப்பிரிக்கா	அர்சிய
aphphrica	ஆப்பிரிக்கா	மு்்பியி
aphreca	ஆப்பிரிக்கா	அர்சியா
aphrica	ஆப்பிரிக்கா	அர்சியா
aphricaa	ஆப்பிரிக்கா	அர்சுமி
aphrika	ஆப்பிரிக்கா	அர்சாமா
appirikka	ஆப்பிரிக்கா	முற்கின்றன
appricaa	ஆப்பிரிக்கா	அர்சுமி
efrica	ஆப்பிரிக்கா	அர்சியா
ephrica	ஆப்பிரிக்கா	அர்சியா
aappirikkaavin	ஆப்பிரிக்காவின்	இந்திர்க்கின்
africaavin	ஆப்பிரிக்காவின்	முறுக்கிில்
aappirikkaavil	ஆப்பிரிக்காவில்	இந்திர்க்கில்
africaavil	ஆப்பிரிக்காவில்	முறும்பியில்
africavil	ஆப்பிரிக்காவில்	முறும்பிின்
ain	ஆயின்	யான்
ainn	ஆயின்	ஆன்
ayin	ஆயின்	அவின்
ein	ஆயின்	யான்
einn	ஆயின்	ஆன்
en	ஆயின்	யான்
enn	ஆயின்	அல்
aayerak	ஆயிரக்	அர்மா்
aayirak	ஆயிரக்	அர்மார்
aayeraththil	ஆயிரத்தில்	அவ்க்களின்
aayiraththil	ஆயிரத்தில்	அவ்குகளில்
aayut	ஆயுட்	அமான்
out	ஆயுட்	அம்
aaivu	ஆய்வு	அற்கு
aayvu	ஆய்வு	அற்கு
aaivukalilum	ஆய்வுகளிலும்	முற்கிறார்
aayvugalilum	ஆய்வுகளிலும்	முற்கினார்
aayvukalilum	ஆய்வுகளிலும்	முற்கினார்
aaivukalil	ஆய்வுகளில்	அம்பிகளின்
aayvugalil	ஆய்வுகளில்	அவ்குகளில்
aayvukalil	ஆய்வுகளில்	அவ்குகளில்
aaivukalum	ஆய்வுகளும்	அம்ப்பும்
aayvugalum	ஆய்வுகளும்	அவர்க்கும்
aayvukalum	ஆய்வுகளும்	அவர்க்கும்
aaivukalai	ஆய்வுகளை	அந்தியை
aayvugalai	ஆய்வுகளை	அர்சியான
aayvukalai	ஆய்வுகளை	அர்சியான
aaivukkum	ஆய்வுக்கும்	முற்க்கும்
aayvukkum	ஆய்வுக்கும்	அம்பிக்கும்
aaivuch	ஆய்வுச்	அமியன்
aayvuch	ஆய்வுச்	அம்பின்
aaivup	ஆய்வுப்	அர்கம்
aayvup	ஆய்வுப்	அர்கும்
aaraathanaa	ஆராதனா	அர்சாமா
aradhana	ஆராதனா	அழுமா
aaraayndha	ஆராய்ந்த	அற்பதாக
aaraayntha	ஆராய்ந்த	அற்பதாக
aaraaynththa	ஆராய்ந்த	அற்பதாக
aaraayndhanar	ஆராய்ந்தனர்	அவர்க்கார்
aaraaynthanar	ஆராய்ந்தனர்	அவிக்காலல்
aaraaynththanar	ஆராய்ந்தனர்	அரிச்சியம்
aaraainthaar	ஆராய்ந்தார்	அவர்களால்
aaraaynthaar	ஆராய்ந்தார்	அவர்களால்
aaraaynththaar	ஆராய்ந்தார்	அவர்களால்
aaraainthu	ஆராய்ந்து	அன்றது
aaraaynthu	ஆராய்ந்து	அன்றிறது
araaynththu	ஆராய்ந்து	அன்றிறது
aariyargalaal	ஆரியர்களால்	இந்திர்களில்
aariyarkalaal	ஆரியர்களால்	இந்திர்களில்
aariyargal	ஆரியர்கள்	அவிக்காலல்
aariyarkal	ஆரியர்கள்	அவிக்காலல்
aardar	ஆர்டர்	அமியர்
ardar	ஆர்டர்	அமியர்
arder	ஆர்டர்	அர்சான்
ordar	ஆர்டர்	அரியா்
order	ஆர்டர்	அரியான்
aarppaattaththil	ஆர்ப்பாட்டத்தில்	மு்ப்படுத்தில்
aarva	ஆர்வ	அராமா
aarvaththaal	ஆர்வத்தால்	அவிக்காலல்
aarvaththin	ஆர்வத்தின்	அந்திரியின்
aarvaththukku	ஆர்வத்துக்கு	முற்கின்று
aarvaththudan	ஆர்வத்துடன்	அமிப்புகள்
aarvaththutan	ஆர்வத்துடன்	அமிப்புகள்
aarvaththaiyum	ஆர்வத்தையும்	அமிப்புகள்
aarvamaaga	ஆர்வமாக	அரிமாகா
aarvamaaka	ஆர்வமாக	அர்பாகா
aarvam	ஆர்வம்	அர்பர்
aarvalarum	ஆர்வலரும்	அவர்க்கும்
aarvee	ஆர்வி	அர்சி
aarvi	ஆர்வி	அர்சி
harvey	ஆர்வி	மிக்கி
aaraam	ஆறாம்	அமாம்
aaruthal	ஆறுதல்	அர்மார்
aatralaaka	ஆற்றலாக	அரிமாகா
aatrtralaaga	ஆற்றலாக	அர்பாடாக
aatrtralaaka	ஆற்றலாக	அர்பாடாக
aatrtralum	ஆற்றலும்	அர்த்தும்
aattralum	ஆற்றலும்	அர்தாகும்
aatrtralae	ஆற்றலே	அந்தார
aatrtralilae	ஆற்றலே	அந்திரமை
aattralae	ஆற்றலே	அந்தா
aattrale	ஆற்றலே	அர்சாமை
aatri	ஆற்றி	அர்சி
aatrtri	ஆற்றி	அர்சி
aattree	ஆற்றி	மு்்ி
aattri	ஆற்றி	அர்சி
aatrtrinaar	ஆற்றினார்	அசிச்கார்
aattrinaar	ஆற்றினார்	அர்சுகள்
aatrtrin	ஆற்றின்	அர்சியன்
aattrin	ஆற்றின்	அர்சின்
aatrtril	ஆற்றில்	அர்சியம்
aattril	ஆற்றில்	அர்சியர்
aatrtruppaduththum	ஆற்றுப்படுத்தும்	இப்படுத்துக்கும்
aattruppaduththum	ஆற்றுப்படுத்தும்	மு்ப்பிட்டுகள்
aattruppadutthum	ஆற்றுப்படுத்தும்	மு்ப்பிட்டுகள்
aatrtrum	ஆற்றும்	மன்றும்
aattrum	ஆற்றும்	முற்கும்
aalaya	ஆலய	அராஜ
aalayangalil	ஆலயங்களில்	இந்திர்களின்
aalayanggalil	ஆலயங்களில்	இந்திர்களின்
aalayangkalil	ஆலயங்களில்	இந்திரியில்
aalayankalil	ஆலயங்களில்	இந்திர்களின்
aalayangal	ஆலயங்கள்	அவர்களில்
aalayanggal	ஆலயங்கள்	அவர்க்கள்
aalayangkal	ஆலயங்கள்	அவிக்காலல்
aalayankal	ஆலயங்கள்	அவர்களில்
aalayach	ஆலயச்	அமின்
aalayaththin	ஆலயத்தின்	அம்ப்பிின்
aalayatthin	ஆலயத்தின்	அம்பிடியில்
aalayaththil	ஆலயத்தில்	அவ்க்களின்
aalayaththai	ஆலயத்தை	அரிமுகையை
aalayamaaga	ஆலயமாக	அரிமாகா
aalayamaaka	ஆலயமாக	அரிமாகா
aalayam	ஆலயம்	அவர்
aaloachanai	ஆலோசனை	முறுகளை
aaloasanai	ஆலோசனை	அர்சாமை
aalosanai	ஆலோசனை	முறையை
aaloachanaikalai	ஆலோசனைகளை	முற்கத்தை
aaloasanaigalai	ஆலோசனைகளை	அரிசாயத்தை
aaloasanaikalai	ஆலோசனைகளை	அந்திர்கை
aalosanaigalai	ஆலோசனைகளை	முற்கத்தை
aalosanaikalai	ஆலோசனைகளை	முற்கத்தை
aaloachanaik	ஆலோசனைக்	முறுகளைப்
aaloasanaik	ஆலோசனைக்	அர்சுகள்
aalosanaik	ஆலோசனைக்	முறுகளில்
aaloasanaiyin	ஆலோசனையின்	இந்திரியின்
aalosanaiyin	ஆலோசனையின்	முறுக்கில்
aalosanaiyinpadi	ஆலோசனையின்	முக்கிர்க்தி
aaloasanaiyai	ஆலோசனையை	அந்திரமை
aalosanaiyai	ஆலோசனையை	முறுக்கை
aashis	ஆஷிஷ்	மானிஸ்
aashish	ஆஷிஷ்	மாரிஸ்
aasis	ஆஷிஷ்	மானிஸ்
asees	ஆஷிஷ்	மானிஸ்
asheesh	ஆஷிஷ்	மானிஸ்
ashish	ஆஷிஷ்	மானிஸ்
asiis	ஆஷிஷ்	மானிஸ்
asis	ஆஷிஷ்	ஐஸ்
aash	ஆஷ்	மே
ash	ஆஷ்	மேன்
engkae	இங்கே	அர்மா
ingae	இங்கே	அர்யா
ingkae	இங்கே	அர்மா
engkaeyae	இங்கேயே	அர்சாமி
ingaeyae	இங்கேயே	அர்சுமை
ingkaeyae	இங்கேயே	அர்சாமி
ichaikkaruvikalin	இசைக்கருவிகளின்	இந்திர்க்கியின்
isaikkaruvigalin	இசைக்கருவிகளின்	இந்திர்க்கியின்
ichaikkaruvikal	இசைக்கருவிகள்	மு்்குகிறார்
isaikkaruvigal	இசைக்கருவிகள்	இந்திரங்களில்
isaiyamaippaalar	இசையமைப்பாளர்	இந்திரங்கள்
isaiymaippaalar	இசையமைப்பாளர்	இந்திரங்கள்
isaiyamaippaalargalin	இசையமைப்பாளர்களின்	அற்படுக்காட்டியில்
isaiyamaippaalargalil	இசையமைப்பாளர்களில்	அற்படுக்குக்கிின்
isaiyamaippaalargal	இசையமைப்பாளர்கள்	இர்தார்க்கி்தில்
echchaalai	இச்சாலை	முறுகளை
ichchaalai	இச்சாலை	முறுகளை
echchaalaiyil	இச்சாலையில்	முறும்பியில்
ichchaalaiyil	இச்சாலையில்	முறும்பியில்
idaththilulla	இடத்திலுள்ள	இருக்ப்பாக
idamaagavum	இடமாகவும்	உதவிக்கும்
idamthaan	இடம்தான்	இருதின்
idampeyarum	இடம்பெயரும்	இடு்கிறார்
idugai	இடுகை	உதையை
idugaigal	இடுகைகள்	இரு்களால்
idaik	இடைக்	உலைப்
idaiyae	இடையே	அடை
idaiyaeyum	இடையேயும்	இடு்களும்
inaiyaana	இணையான	அதியான
idhanathu	இதனது	இழுந்து
ithanathu	இதனது	இழுந்து
idhanil	இதனில்	உலைய்
ithanil	இதனில்	அரியின்
idhanpoathu	இதன்போது	இடு்பட்டு
ithanpoathu	இதன்போது	அழிந்தது
idazhaalar	இதழாளர்	இரு்கள்
idhazhaalar	இதழாளர்	இரு்கள்
ithalaalar	இதழாளர்	அடைகளில்
ithazhaalar	இதழாளர்	இரு்கள்
iththiraippadaththil	இத்திரைப்படத்தில்	அற்படுக்காட்டியில்
iththiraippadam	இத்திரைப்படம்	அறிப்புக்கள்
iththirappadam	இத்திரைப்படம்	அமைப்புகளில்
iththeevin	இத்தீவின்	அம்பிடின்
iththaervil	இத்தேர்வில்	இந்திரியில்
iththervil	இத்தேர்வில்	இந்திர்களின்
iththoguppil	இத்தொகுப்பில்	இந்திர்களின்
iththokuppil	இத்தொகுப்பில்	இந்திர்களில்
iththogaiyai	இத்தொகையை	அரி்கத்தை
iththokaiyai	இத்தொகையை	அரி்கத்தை
india	இந்தியா	அர்சி
indiia	இந்தியா	அர்சியா
indiiaa	இந்தியா	அர்சுமி
indiya	இந்தியா	அர்சிய
indiyaa	இந்தியா	அர்சுமை
inthiyaa	இந்தியா	அர்சியை
inththiyaa	இந்தியா	அர்சியை
intiya	இந்தியா	அரிசாயா
indiavin	இந்தியாவின்	அந்திரியன்
inthiyaavin	இந்தியாவின்	இந்திரியின்
inththiyaavin	இந்தியாவின்	முறுக்களின்
indiavilum	இந்தியாவிலும்	முற்கினார்
inthiyaavilum	இந்தியாவிலும்	மு்்கி்களும்
inththiyaavilum	இந்தியாவிலும்	மு்்கி்களும்
indiavilulla	இந்தியாவிலுள்ள	முற்கப்பட்ட
inthiyaavilulla	இந்தியாவிலுள்ள	முற்கப்பட்டன
inththiyaavilulla	இந்தியாவிலுள்ள	முற்றுக்பாட்ட
indiavukkaana	இந்தியாவுக்கான	மு்ப்படுடான
inthiyaavukkaana	இந்தியாவுக்கான	அசிக்கு்திலா
inththiyaavukkaana	இந்தியாவுக்கான	முற்க்கின்றன
indiavukku	இந்தியாவுக்கு	முற்கிற்கு
inthiyaavukku	இந்தியாவுக்கு	முற்கின்றன
inththiyaavukku	இந்தியாவுக்கு	முற்்பிற்கும்
indiavudan	இந்தியாவுடன்	முறுமையில்
inthiyaavudan	இந்தியாவுடன்	முற்கிர்கள்
inththiyaavudan	இந்தியாவுடன்	முற்கிர்கள்
indiavum	இந்தியாவும்	முற்க்கும்
inthiyaavum	இந்தியாவும்	முற்களாகும்
inththiyaavum	இந்தியாவும்	முற்கிற்கும்
indhukkalaal	இந்துக்களால்	இந்திர்களில்
indhukkalin	இந்துக்களின்	இந்திர்களின்
indhukkalil	இந்துக்களில்	இந்திர்களின்
indhukkalin	இந்துக்களில்	இந்திர்களின்
indhukkalum	இந்துக்களும்	முற்கிறார்
hindukkalaiyum	இந்துக்களையும்	மு்்பிருக்கம்
indhukkalaiyum	இந்துக்களையும்	மு்்கி்களால்
hindukkal	இந்துக்கள்	முன்னங்கள்
indhukkal	இந்துக்கள்	முறுமையில்
inthoa	இந்தோ	அர்சா
inththoa	இந்தோ	அசியா
innaattin	இந்நாட்டின்	இந்திரியின்
inthnaattin	இந்நாட்டின்	இந்திரியின்
innigazhvu	இந்நிகழ்வு	அன்பிற்கு
inthnikalvu	இந்நிகழ்வு	முற்கிற்கு
inniruvanaththin	இந்நிறுவனத்தின்	இந்திர்க்கின்
inthniruvanaththin	இந்நிறுவனத்தின்	இப்படுத்திின்
inniruvanaththil	இந்நிறுவனத்தில்	இப்படுத்திின்
inthniruvanaththil	இந்நிறுவனத்தில்	மு்்பிட்களில்
inaththavargalin	இனத்தவர்களின்	இருப்புகளின்
inaththavarkalin	இனத்தவர்களின்	இருப்புகளின்
inaththavargal	இனத்தவர்கள்	இருப்புகள்
inaththavarkal	இனத்தவர்கள்	இருப்புகள்
inaam	இனாம்	அவர்
inimai	இனிமை	அர்யா
inimaiyaaga	இனிமையாக	அரிமையாாக
inimaiyaaka	இனிமையாக	அதிக்காக
inimaiyaana	இனிமையான	அரிமாக்கை
innalgalukku	இன்னல்களுக்கு	அற்படுத்திற்கு
innelkalukku	இன்னல்களுக்கு	முற்்படுக்கும்
innalgalai	இன்னல்களை	அருக்கதை
innalkalai	இன்னல்களை	அரி்கு்கை
innelkalai	இன்னல்களை	அரி்கு்கை
indriyae	இன்றியே	அர்சுமி
inriya	இன்றியே	அர்சாய
intriyae	இன்றியே	அர்சுமா
ippayir	இப்பயிர்	அர்சியில்
ippalliyin	இப்பள்ளியின்	இந்திரியின்
ippoathellaam	இப்போதெல்லாம்	முற்கின்றார்
ippothellaam	இப்போதெல்லாம்	முற்கின்றார்
imayamalai	இமயமலை	அர்கதை
imayamalaiyil	இமயமலையில்	இந்திரியில்
imchai	இம்சை	மு்்ை
imsai	இம்சை	அமியா
eemfal	இம்பால்	அர்சார்
eemphal	இம்பால்	அம்பர்
emfal	இம்பால்	அர்சார்
emphal	இம்பால்	அம்பர்
iimphal	இம்பால்	மக்கள்
imfal	இம்பால்	அர்சார்
impal	இம்பால்	அம்பர்
imphal	இம்பால்	அம்பர்
immaraththin	இம்மரத்தின்	இந்திர்டின்
eiyakkum	இயக்கும்	அற்றாகும்
iyakkum	இயக்கும்	அதிக்கும்
eiyanra	இயன்ற	அர்மா
iyandra	இயன்ற	அழிகா
iyantra	இயன்ற	அழிகா
eiyanrathu	இயன்றது	அறிந்து
iyandradhu	இயன்றது	அழிந்து
iyantrathu	இயன்றது	அழிந்து
eiyalpai	இயல்பை	அர்கைய
iyalbai	இயல்பை	அரிமை
iyalbhai	இயல்பை	அரிமையை
iyalpai	இயல்பை	அரிமைய
eiyalpaik	இயல்பைக்	அரு்களில்
iyalbaik	இயல்பைக்	இரு்களில்
iyalpaik	இயல்பைக்	இரு்களில்
eraani	இராணி	அர்சி
iraani	இராணி	அட்டி
raani	இராணி	ராஜி
irukkakkoodiya	இருக்கக்கூடிய	இருப்புக்கிய
irukkath	இருக்கத்	இரு்களால்
irukkavum	இருக்கவும்	இரு்களாகும்
irukkavae	இருக்கவே	இரு்்தாக
irukkavea	இருக்கவே	இதை்களை
irunooru	இருநூறு	அழி்க்கு
irunoorukkum	இருநூறுக்கும்	அறிப்புக்கம்
irupaal	இருபால்	இருகள்
iruppu	இருப்பு	இரு்குும்
irrupputh	இருப்புத்	அதிக்காம்
irupputh	இருப்புத்	இடை்களும்
irruppup	இருப்புப்	அற்பத்தும்
iruppup	இருப்புப்	இடு்களும்
iruppaik	இருப்பைக்	இரு்கியம்
iruma	இரும	அழுமா
irumbu	இரும்பு	இடு்க்து
irumpu	இரும்பு	இடு்கு
irumbuk	இரும்புக்	இடு்காகும்
irumpuk	இரும்புக்	இடு்கும்
irumbuch	இரும்புச்	இரு்கத்தில்
irumpuch	இரும்புச்	இரு்கியம்
irul	இருள்	உரக்
erangku	இறங்கு	இட்்கு
irangku	இறங்கு	இடு்கு
irangu	இறங்கு	உழுத்து
erangkum	இறங்கும்	இதைக்ும்
irangkum	இறங்கும்	இது்கும்
irangum	இறங்கும்	இதைக்கும்
erappai	இறப்பை	இரு்கை
irappai	இறப்பை	இரு்கை
iravaadha	இறவாத	அழிவு
iravaatha	இறவாத	இழுந்த
iruga	இறுக	உத்த
iruka	இறுக	உத்த
irugiya	இறுகிய	இரு்கி
irukiya	இறுகிய	உத்தியை
irukkiya	இறுகிய	இரு்கத்தை
irugum	இறுகும்	இதைகும்
irukum	இறுகும்	உர்மாம்
iraivan	இறைவன்	உலைய்
ilakkangal	இலக்கங்கள்	இருப்புகள்
ilakkangkal	இலக்கங்கள்	இருப்புகள்
ilakkana	இலக்கண	உழுத்த
ilakkanangkalai	இலக்கணங்களை	இருப்புகளை
ilakkanangkali	இலக்கணங்களை	இடுப்புக்கி
ilakkanankalai	இலக்கணங்களை	உருக்கு்கை
ilakkanangkal	இலக்கணங்கள்	இருப்புகளில்
ilakkanankal	இலக்கணங்கள்	இருப்புகள்
ilakkanach	இலக்கணச்	இரு்களில்
ilakkanaththil	இலக்கணத்தில்	இருப்புகளின்
ilakkanaththai	இலக்கணத்தை	இருப்பதை
ilakkanap	இலக்கணப்	இரு்களால்
ilakkanamum	இலக்கணமும்	உதவிக்கார்
ilakkanam	இலக்கணம்	உதவிகளும்
ilakkai	இலக்கை	உதையை
ilatcham	இலட்சம்	இரங்கள்
latcham	இலட்சம்	விசாமம்
ilaa	இலா	அதை
ilaechaana	இலேசான	அர்மான
ilaesaana	இலேசான	அர்சா
laesaana	இலேசான	ராகா
leasaana	இலேசான	ராகா
pengaludan	இளம்	பாட்டங்கள்
penkalutan	இளம்	சார்க்காலல்
ilampen	இளம்பெண்	இர்்கின்
ilampengalai	இளம்பெண்களை	இருப்புகை
ilampengaludan	இளம்பெண்களை	அடுத்துகளில்
ilampenkalai	இளம்பெண்களை	இருப்புகை
ilampengal	இளம்பெண்கள்	இருப்புகள்
ilampenkal	இளம்பெண்கள்	இருப்புகள்
ilavayadhu	இளவயது	இழுந்து
ilavayath	இளவயது	உதையைப்
ilavayathu	இளவயது	உழுந்து
izhaiya	இழைய	அடை
ivanaal	இவனால்	அரியம்
evatrtrukku	இவற்றுக்கு	அற்பட்டுக்
ivatrtrukku	இவற்றுக்கு	இடு்கிற்கு
ivattrukku	இவற்றுக்கு	இய்்களுக்கு
evatrtrul	இவற்றுள்	இரு்கள்
ivatrtrul	இவற்றுள்	இரு்காம்
ivatrul	இவற்றுள்	இரங்கள்
evaikalin	இவைகளின்	அர்க்கில்
ivaigalin	இவைகளின்	இருக்கில்
evaikalilirunthu	இவைகளிலிருந்து	அறிக்கப்பட்டு
ivaigalilirundhu	இவைகளிலிருந்து	அடு்குகின்றன
evaikalum	இவைகளும்	அற்றாகும்
ivaigalum	இவைகளும்	இடை்கும்
evaikal	இவைகள்	அர்மான்
ivaigal	இவைகள்	இராமல்
evaiyum	இவையும்	அர்கம்
ivaiyum	இவையும்	அதைகம்
ivvaiyum	இவையும்	அற்பாலும்
eekkal	ஈக்கள்	அம்பர்
eesanai	ஈசனை	அர்யா
eeyam	ஈயம்	அமாம்
iiyam	ஈயம்	அமாம்
iyam	ஈயம்	அமாம்
eerppuch	ஈர்ப்புச்	அர்க்கியில்
ugandhadhu	உகந்தது	உழுந்து
uganthathu	உகந்தது	உழுந்து
ukandhathu	உகந்தது	உழுந்து
hussain	உசேன்	ஹாட்ட்
usaen	உசேன்	அவின்
udanpaadu	உடன்பாடு	உருக்க்கு
udalin	உடலின்	உரைய்
udalaith	உடலைத்	உதையை
udalaip	உடலைப்	உலைய்
udalaiyum	உடலையும்	உதவுகள்
udalnala	உடல்நல	உழுமான
udalnalathai	உடல்நலத்தை	உதுக்கைய
udalnalaththai	உடல்நலத்தை	இருப்பதை
udalnalththai	உடல்நலத்தை	இரு்கு்கை
udalnalan	உடல்நலன்	உடைகளின்
udalnalap	உடல்நலப்	உதைகளால்
udaindha	உடைந்த	உழுந்த
udaintha	உடைந்த	உழுந்த
udaindhaal	உடைந்தால்	இரு்களில்
udainthaal	உடைந்தால்	இரு்களால்
udaindhu	உடைந்து	உழுந்து
udainththu	உடைந்து	உரிருந்து
udainthu	உடைந்து	உழுந்து
vaendum	உட்கொள்ள	நார்கும்
vendum	உட்கொள்ள	விட்டும்
ventum	உட்கொள்ள	விட்டும்
utkollaamal	உட்கொள்ளாமல்	இருப்புகள்
utkolluvathan	உட்கொள்வதன்	உருப்புகளில்
utkolvathan	உட்கொள்வதன்	இருப்புகள்
utkolvathaal	உட்கொள்வதால்	இருப்புகளில்
udpura	உட்புற	உழுத்த
utpura	உட்புற	இழு்்தா
udpurach	உட்புறச்	இரு்களில்
utpurach	உட்புறச்	இரு்கையில்
udpuraththil	உட்புறத்தில்	இருப்பத்தில்
utpuraththil	உட்புறத்தில்	இருப்புகளின்
udpuraththai	உட்புறத்தை	இருப்பதை
utpuraththai	உட்புறத்தை	இருப்புகை
udpuramulla	உட்புறமுள்ள	இருக்பட்ட
utpuramulla	உட்புறமுள்ள	அழுத்துக்கான
unarvadhu	உணர்வது	உழுந்து
unarvathu	உணர்வது	உழுந்து
unavugalilum	உணவுகளிலும்	உதவுக்கார்
unavukalilum	உணவுகளிலும்	உதவுக்கார்
unavugalai	உணவுகளை	உழுத்தை
unavukalai	உணவுகளை	உழுத்தை
unavugal	உணவுகள்	உருகள்
unavukal	உணவுகள்	உருகள்
unavukkaaga	உணவுக்காக	உழுத்தான
unavukkaaka	உணவுக்காக	உழுத்தான
unavukku	உணவுக்கு	உழுக்கும்
thurai	உணவுத்	தாமை
turai	உணவுத்	தேவை
unavupporutkal	உணவுப்பொருட்கள்	இருப்புக்களில்
unavupporuttkal	உணவுப்பொருட்கள்	இருத்துக்களில்
unavum	உணவும்	உதையம்
undadhaal	உண்டதால்	இரு்கள்
undathaal	உண்டதால்	இரு்களால்
untathaal	உண்டதால்	இரு்களால்
unadanar	உண்டனர்	உர்மான்
undanar	உண்டனர்	உதைகள்
untanar	உண்டனர்	உதைகள்
undaana	உண்டான	உழுமான
untaana	உண்டான	உதையான
undi	உண்டி	உல்லி
uththiyoaga	உத்தியோக	இதைக்காாக
uththiyoaka	உத்தியோக	இரு்்தாான
ubachaara	உபசார	உதையான
ubasaara	உபசார	அழியா
upasaara	உபசார	அழியா
ubanidatham	உபநிடதம்	உதவிகளும்
ubanitatham	உபநிடதம்	உதவிகளையும்
upanidatham	உபநிடதம்	உதவிகளும்
upanitatham	உபநிடதம்	உதவிகளையும்
uppin	உப்பின்	அர்டின்
uppugal	உப்புகள்	இரு்கியம்
uppukal	உப்புகள்	இரு்களால்
uppuk	உப்புக்	இருக்கம்
uppukkal	உப்புக்கள்	இருப்புகள்
uppukku	உப்புக்கு	இடு்கிற்கு
ubbusam	உப்புசம்	இர்களில்
uppusam	உப்புசம்	அர்சுகள்
uppudan	உப்புடன்	இரு்களில்
umakku	உமக்கு	உழுத்து
umilum	உமிழும்	உதவுகம்
umizhum	உமிழும்	உதவுகம்
uyirina	உயிரின	உத்தை
uyirinaththin	உயிரினத்தின்	இருப்பத்தில்
uyirinaththai	உயிரினத்தை	இருப்பதை
uyirinamaana	உயிரினமான	இரு்்தாாக
urachiya	உரசிய	உத்தை
urasiya	உரசிய	அடை
urugiya	உருகிய	உத்தைய
urukiya	உருகிய	உத்தையை
uruvappadangkalai	உருவப்படங்களை	இருக்குக்களை
uruvappadankalai	உருவப்படங்களை	இருக்கு்திலை
uruvappatangkalai	உருவப்படங்களை	இருக்குக்களை
uruvaaga	உருவாக	உழுமான
uruvaaka	உருவாக	உழுமாக
uruvaagaamal	உருவாகாமல்	உருக்களில்
uruvaagiyulladhaaga	உருவாகியுள்ளதாக	அழுத்துக்க்கான
uruvaagiyullathaaga	உருவாகியுள்ளதாக	அழுத்துக்கையான
uruvaagiyulladhu	உருவாகியுள்ளது	இருக்படுத்து
uruvaagiyullathu	உருவாகியுள்ளது	இருக்படுத்து
uruvaagiyullana	உருவாகியுள்ளன	அழுத்துக்கான
uruvaagum	உருவாகும்	உருக்கும்
uruvaagumboadhu	உருவாகும்போது	உருக்பட்தது
uruvaagumpoathu	உருவாகும்போது	உருக்பட்தது
urvaagumpoathu	உருவாகும்போது	உருக்பட்தது
uruvaaguvadhai	உருவாகுவதை	உடுப்பதை
uruvaaguvathai	உருவாகுவதை	உடுப்பதை
vaendum	உருவாக்க	நார்கும்
veendum	உருவாக்க	விட்டும்
veentum	உருவாக்க	விட்டும்
vendum	உருவாக்க	விட்டும்
ventum	உருவாக்க	விட்டும்
uruvaakkak	உருவாக்கக்	உதவிக்கார்
uruvaakkakkoodiya	உருவாக்கக்கூடிய	இருக்குக்களை
uruvaakkath	உருவாக்கத்	உதவுக்கார்
uruvaakkaththi	உருவாக்கத்தில்	இடுப்பத்தி
uruvaakkaththil	உருவாக்கத்தில்	இருப்புகளின்
uruvaakkaththai	உருவாக்கத்தை	இருப்புகளை
uruvaakkam	உருவாக்கம்	உதவிகளையும்
uruvaakkavum	உருவாக்கவும்	உருக்குகள்
uruvaakkuthal	உருவாக்குதல்	இருப்புகளில்
uruvaakkum	உருவாக்கும்	உருக்காலம்
uruvaakkumpoathu	உருவாக்கும்போது	இருக்கப்பட்டு
uruvaakkuvathai	உருவாக்குவதை	உருக்கு்களை
uraiyaadal	உரையாடல்	உருக்கள்
uraiyaatal	உரையாடல்	உருக்கள்
uraiyaadalgal	உரையாடல்கள்	இருப்புகள்
uraiyaadalkal	உரையாடல்கள்	இருப்புகள்
uraiyaatalkal	உரையாடல்கள்	உருக்கையில்
urangaatha	உறங்காத	உழுந்த
urangkaatha	உறங்காத	உழுந்த
urangku	உறங்கு	உரிக்கு
urangu	உறங்கு	உழுத்து
urangkum	உறங்கும்	உருக்கும்
urangum	உறங்கும்	உருக்கம்
urangkumpoathu	உறங்கும்போது	உருக்பட்தது
urangumpoathu	உறங்கும்போது	உருக்பட்தது
uravaal	உறவால்	உரைய்
uruthunaiyaaga	உறுதுணையாக	உருக்க்காக
uruthunaiyaaka	உறுதுணையாக	உருக்க்காக
uruthunaiyaga	உறுதுணையாக	உருக்க்காக
uruppugali	உறுப்புகளில்	இருப்பத்தி
uruppugalil	உறுப்புகளில்	இருப்புகளில்
uruppugalum	உறுப்புகளும்	இருப்புகள்
uruppugalai	உறுப்புகளை	உருப்பத்தை
utrtru	உற்று	உரிந்து
uttru	உற்று	உருது
ulagaich	உலகைச்	உலைய்
ulunththu	உளுந்து	உரிருந்து
ulunthu	உளுந்து	உழுந்து
ullaga	உள்ளக	உதவாக
ullaka	உள்ளக	உதவாக
ullagap	உள்ளகப்	உதைகள்
ullakap	உள்ளகப்	உதவையம்
ulladakkangalai	உள்ளடக்கங்களை	இருக்கு்திலை
ulladakkangkalai	உள்ளடக்கங்களை	இருக்குக்களை
ullatakkangkali	உள்ளடக்கங்களை	இருக்குக்களை
ulladakkangal	உள்ளடக்கங்கள்	இருப்புகளில்
ulladakkangkal	உள்ளடக்கங்கள்	இருப்புக்களில்
ullatakkangkal	உள்ளடக்கங்கள்	இருப்புக்களில்
ulladakkaththai	உள்ளடக்கத்தை	இருப்புகளை
ullatakkaththai	உள்ளடக்கத்தை	இருப்புக்கை
ulladakkam	உள்ளடக்கம்	உதவுக்கார்
ullatakkam	உள்ளடக்கம்	உதவுக்கார்
ulladakki	உள்ளடக்கி	இருப்பதி
ullatakki	உள்ளடக்கி	உருப்பதி
ullapadi	உள்ளபடி	இருப்பிி
ullavaraaga	உள்ளவராக	உழுத்தா
ullavaraaka	உள்ளவராக	உழுத்தான
ulleedu	உள்ளீடு	இழுந்து
ulleedugalai	உள்ளீடுகளை	இருப்புகை
ulleedukalai	உள்ளீடுகளை	இருப்பதை
ulleedugal	உள்ளீடுகள்	இருப்புகள்
ulleedukal	உள்ளீடுகள்	இருப்புகள்
ulvaanggum	உள்வாங்கும்	உருக்குகம்
ulvaangkum	உள்வாங்கும்	உதவிக்கும்
ulvaankum	உள்வாங்கும்	உருக்காலம்
ulaippil	உழைப்பில்	இருக்கில்
uzhaippil	உழைப்பில்	இருக்கில்
uavar	உவர்	உரக்
uvar	உவர்	உரக்
ookkuvippathu	ஊக்குவிப்பது	அற்படுத்துக்க
uookkuvippathu	ஊக்குவிப்பது	அறிக்கப்பட்டு
uukkuvippathu	ஊக்குவிப்பது	இருக்பட்தது
ookkuvippu	ஊக்குவிப்பு	அற்படு்க்கு
uookkuvippu	ஊக்குவிப்பு	இருக்பட்டும்
uukkuvippu	ஊக்குவிப்பு	இருப்பதாகும்
oosal	ஊசல்	அவின்
uoosal	ஊசல்	அவின்
uusal	ஊசல்	அவர்
oonchal	ஊஞ்சல்	அர்மான்
oonchchal	ஊஞ்சல்	அர்சியம்
unchal	ஊஞ்சல்	உரையில்
uunchchal	ஊஞ்சல்	அரைக்கால்
uunjsal	ஊஞ்சல்	அர்சியம்
oodagath	ஊடகத்	உலைம்
oodakath	ஊடகத்	உலைம்
udakath	ஊடகத்	உதைக்
uudakath	ஊடகத்	உதைக்
oodagaththin	ஊடகத்தின்	இருக்கில்
oodakaththin	ஊடகத்தின்	இருக்கில்
udagaththin	ஊடகத்தின்	இருக்கில்
uudakaththin	ஊடகத்தின்	இருக்கில்
oodagamaaga	ஊடகமாக	உழுமான
oodakamaaka	ஊடகமாக	உழுத்த
udakamaaka	ஊடகமாக	உழுமான
uudakamaaka	ஊடகமாக	உழுத்த
oodaadum	ஊடாடும்	இராமும்
uoodaadum	ஊடாடும்	இதைகும்
uudaadum	ஊடாடும்	உர்மாம்
oothaak	ஊதாக்	அராம்
uuthaak	ஊதாக்	உரக்
ooran	ஊரன்	உலை
uooran	ஊரன்	உரை
uuraan	ஊரன்	உரைப்
uuran	ஊரன்	உரை
ooraar	ஊரார்	அராம்
uuraar	ஊரார்	உலைப்
oorilirunththu	ஊரிலிருந்து	இருக்பட்து
oorilirunthu	ஊரிலிருந்து	இருக்போது
uurilirunththu	ஊரிலிருந்து	இருக்பட்து
uurilirunthu	ஊரிலிருந்து	இருக்போது
oorilaeyae	ஊரிலேயே	அரும்பி
urilaeyae	ஊரிலேயே	இரு்கிய
uurilaeyae	ஊரிலேயே	இரு்கிய
oorvalanggal	ஊர்வலங்கள்	இருப்புகள்
oorvalangkal	ஊர்வலங்கள்	இருப்புகள்
uurvalangkal	ஊர்வலங்கள்	இருப்புகள்
oorvalaththil	ஊர்வலத்தில்	இருப்பியில்
uurvalaththil	ஊர்வலத்தில்	இருப்பியில்
oorvalam	ஊர்வலம்	இதைகள்
uurvalam	ஊர்வலம்	உதவையம்
ootrtruvathu	ஊற்றுவது	அதிக்தது
ootruvathu	ஊற்றுவது	அதித்தது
uutrtruvathu	ஊற்றுவது	இருக்போது
accon	எகான்	அர்ஜின்
akkon	எகான்	அர்சன்
akon	எகான்	அவின்
akonn	எகான்	அரின்
aqon	எகான்	அவின்
aqonn	எகான்	அரின்
aqqon	எகான்	அர்சன்
yekan	எகான்	யால்
edisan	எடிசன்	அர்ஜின்
edison	எடிசன்	அர்ஜின்
idison	எடிசன்	அர்ஜின்
yedisan	எடிசன்	அர்ஜின்
edukkappada	எடுக்கப்பட	இருக்கின்றன
yedukappatta	எடுக்கப்பட	இருக்ப்பாக
etta	எட்ட	அர்மா
ettavillai	எட்டவில்லை	அரி்கு்தை
yettavillai	எட்டவில்லை	அந்திர்கை
ettaatha	எட்டாத	அற்பத்த
ettiya	எட்டிய	அர்சாமி
yettiya	எட்டிய	அர்சிய
ennikkaigal	எண்ணிக்கைகள்	இந்திரங்கள்
ennikkaikal	எண்ணிக்கைகள்	இந்திரங்கள்
yennikkaigal	எண்ணிக்கைகள்	இந்திரங்கள்
ennikkaikku	எண்ணிக்கைக்கு	அற்படுத்துக்கு
yennikkaikku	எண்ணிக்கைக்கு	மு்்கின்றனரும்
ennikkaiyin	எண்ணிக்கையின்	இந்திர்க்கில்
ennikkaiyum	எண்ணிக்கையும்	அமிப்புகள்
ennikkaiyai	எண்ணிக்கையை	அரிப்புகளை
ennikkaiyaiyum	எண்ணிக்கையையும்	அற்படுத்தியம்
ennima	எண்ணிம	அர்சிய
ethirkatchiyaaga	எதிர்கட்சியாக	அற்படுத்துகை
ethirkatchiyaaka	எதிர்கட்சியாக	அற்படுத்துகை
yedhirkatchiyaaga	எதிர்கட்சியாக	அற்படுத்துகை
edhirpaarppugalai	எதிர்பார்ப்புகளை	அற்குக்குக்களை
ethirpaarppugalai	எதிர்பார்ப்புகளை	அற்குக்குக்களை
ethirpaarppukalai	எதிர்பார்ப்புகளை	அற்குக்குக்களை
eththanaiyo	எத்தனையோ	அர்போரியா
eththanaiyoa	எத்தனையோ	அர்போடிய
paeyar	எனப்	பாட்
payar	எனப்	பால்
peyar	எனப்	சார்
enil	எனில்	அவின்
endroa	என்றோ	அர்சா
entroa	என்றோ	அர்சா
em	எம்	மா்
yem	எம்	யா்
emdan	எம்டன்	அர்சன்
emdon	எம்டன்	அர்ஜன்
emtan	எம்டன்	அர்சன்
emton	எம்டன்	அர்ஜன்
yemtan	எம்டன்	அர்டின்
eythinaar	எய்தினார்	அசியார்
yeithinaar	எய்தினார்	அசியால்
eythiya	எய்திய	அசியா
yeithiya	எய்திய	அசியா
eythu	எய்து	அது
yeithu	எய்து	மத்து
eru	எரு	அது
yeru	எரு	அது
eruvai	எருவை	உதையை
yeruvai	எருவை	அர்மை
elaktraan	எலக்ட்ரான்	இரு்களில்
electron	எலக்ட்ரான்	அர்க்கில்
ilektraan	எலக்ட்ரான்	இரு்களில்
ilektron	எலக்ட்ரான்	இர்க்கில்
ileqtraan	எலக்ட்ரான்	அடைக்களர்
ileqtron	எலக்ட்ரான்	இர்க்கில்
ilictron	எலக்ட்ரான்	அர்க்கில்
iliktraan	எலக்ட்ரான்	இரு்கையில்
iliktron	எலக்ட்ரான்	இருக்கில்
yelakdran	எலக்ட்ரான்	இரு்களில்
yelaktraan	எலக்ட்ரான்	அரு்களில்
elaktraankalai	எலக்ட்ரான்களை	இருப்புகளை
electronkalai	எலக்ட்ரான்களை	அந்திருக்கை
yekaltraankalai	எலக்ட்ரான்களை	அந்திர்க்தை
ellaippura	எல்லைப்புற	அதிக்பட்ட
yellaippura	எல்லைப்புற	அற்பட்டியாக
elithaakkum	எளிதாக்கும்	அறிப்புகும்
yelidhaakkum	எளிதாக்கும்	அற்பிக்கும்
yelithaakkum	எளிதாக்கும்	அற்பிக்கும்
elimaiyaakavum	எளிமையாகவும்	அற்பிட்களும்
yelimaiyaagavum	எளிமையாகவும்	அரிச்சிகள்
yelimaiyaakavum	எளிமையாகவும்	அரிப்புகள்
ezhuthiyullaar	எழுதியுள்ளார்	இருப்புகளில்
yeluthiyullaar	எழுதியுள்ளார்	அறிப்புக்கள்
evvakai	எவ்வகை	அர்கையை
yavvakai	எவ்வகை	அர்கையை
evvaaraana	எவ்வாறான	அரிமாக்கா
yavvaaraana	எவ்வாறான	அரிமாக்கா
aa	ஏ	மே
ae	ஏ	யா
e	ஏ	ஏற
ee	ஏ	யா
acre	ஏக்கர்	அரிஷ்
aekkar	ஏக்கர்	அமிபர்
ekkar	ஏக்கர்	அமிபர்
aesiyaa	ஏசியா	மகாமா
asia	ஏசியா	அரி
esia	ஏசியா	அரி
angeles	ஏஞ்சல்ஸ்	அர்போரிஸ்
angels	ஏஞ்சல்ஸ்	அர்போரிஸ்
angilis	ஏஞ்சல்ஸ்	அர்போரிஸ்
aden	ஏடன்	அரின்
adenn	ஏடன்	அரின்
aidan	ஏடன்	அவர்
edan	ஏடன்	உலை
eden	ஏடன்	அரின்
edenn	ஏடன்	அரின்
eedan	ஏடன்	அரான்
eton	ஏடன்	அரின்
iton	ஏடன்	அரின்
eetan	ஏதன்	அவர்
eithaan	ஏதன்	அவின்
eithan	ஏதன்	யாக்
ethan	ஏதன்	அரான்
ethann	ஏதன்	அரின்
eythan	ஏதன்	மகன்
iithaan	ஏதன்	அவின்
ithan	ஏதன்	அரான்
ithann	ஏதன்	உலைப்
iythan	ஏதன்	யாக்
aerpada	ஏற்பட	அர்மாக
yerpada	ஏற்பட	அர்மாக
aerpadath	ஏற்படத்	அவ்க்கள்
yerpadath	ஏற்படத்	அவ்க்கள்
aerpadap	ஏற்படப்	அர்சாமல்
yerpadap	ஏற்படப்	அர்சாமல்
aerpadin	ஏற்படின்	அர்தியின்
earpadin	ஏற்படின்	அர்தியின்
yerpadin	ஏற்படின்	அர்தியின்
aerpaduththina	ஏற்படுத்தின	இந்திர்க்தி
yaerpaduththina	ஏற்படுத்தின	இந்திர்க்தி
yerpaduththina	ஏற்படுத்தின	இந்திர்க்தி
aerpadumpoathu	ஏற்படும்போது	அற்படுத்துக்கு
yaerpadumpoathu	ஏற்படும்போது	அற்படுத்துக்கு
yerpadumpoathu	ஏற்படும்போது	அற்படுத்துக்கு
aerpaduvathu	ஏற்படுவது	முக்கிறது
yaerpaduvathu	ஏற்படுவது	முக்கிறது
yerpaduvathu	ஏற்படுவது	முக்கிறது
aerpaduvathai	ஏற்படுவதை	அரிசாயத்தை
earpaduvathai	ஏற்படுவதை	அரிசாயத்தை
yerpaduvathai	ஏற்படுவதை	அரிசாயத்தை
aetrtrukkonda	ஏற்றுக்கொண்ட	முற்கப்பட்ட
eattrukkonda	ஏற்றுக்கொண்ட	அற்படுத்தாாக
aetrtrukkondaar	ஏற்றுக்கொண்டார்	இப்படுத்திலம்
eattrukkondaar	ஏற்றுக்கொண்டார்	அற்படுத்துகள்
aela	ஏல	அமா
eala	ஏல	அமா
yaela	ஏல	அமா
aelaththil	ஏலத்தில்	அர்த்தின்
ealaththil	ஏலத்தில்	அரியின்
yaelaththil	ஏலத்தில்	அர்த்தின்
aelam	ஏலம்	அமாம்
ealam	ஏலம்	அராம்
yaelam	ஏலம்	அமாம்
aelanam	ஏளனம்	அவர்
ealanam	ஏளனம்	அழகம்
eelanam	ஏளனம்	அவர்
yelanam	ஏளனம்	அவர்
ainaavin	ஐநாவின்	அர்சி்
aynaavin	ஐநாவின்	அர்சின்
inaavin	ஐநாவின்	அர்டின்
aippachi	ஐப்பசி	அர்சுமி
aippasi	ஐப்பசி	அர்சியா
ippachi	ஐப்பசி	அர்போரி
aivarum	ஐவரும்	அய்கும்
ivarum	ஐவரும்	இராம்
odunggi	ஒடுங்கி	இரு்கிய
odungi	ஒடுங்கி	இரு்கி
odungki	ஒடுங்கி	இரு்கிய
odungiya	ஒடுங்கிய	உருக்கிய
odungkiya	ஒடுங்கிய	உருப்பதி
oppandhangalil	ஒப்பந்தங்களில்	இந்திருக்கில்
oppanthangalil	ஒப்பந்தங்களில்	இந்திருக்கில்
oppanthangkalil	ஒப்பந்தங்களில்	இந்திருக்கிின்
oppandhangalai	ஒப்பந்தங்களை	அற்படுத்தியை
oppanthangalai	ஒப்பந்தங்களை	அற்படுத்தியை
oppanthangkalai	ஒப்பந்தங்களை	அந்திருக்கை
oppandhangal	ஒப்பந்தங்கள்	இந்திரங்கள்
oppandhangall	ஒப்பந்தங்கள்	இந்திருக்கில்
oppanthangall	ஒப்பந்தங்கள்	இந்திருக்கில்
oppanthangkal	ஒப்பந்தங்கள்	இந்திரங்கள்
oppandhathin	ஒப்பந்தத்தின்	இந்திரத்தில்
oppandhaththin	ஒப்பந்தத்தின்	இந்திர்க்கில்
oppanthaththin	ஒப்பந்தத்தின்	இந்திர்க்கில்
oppandhaththai	ஒப்பந்தத்தை	அரிக்குகளை
oppanthathai	ஒப்பந்தத்தை	அரி்கு்கை
oppanthaththai	ஒப்பந்தத்தை	அரிக்குகளை
oppukkolgiraar	ஒப்புக்கொள்கிறார்	அற்படுத்துகள்
oppukkolgirar	ஒப்புக்கொள்கிறார்	இர்தார்க்களில்
oppukkolkiraar	ஒப்புக்கொள்கிறார்	இயன்படுத்தில்
oppukkolkirar	ஒப்புக்கொள்கிறார்	இர்தார்க்கையில்
omeega	ஒமேகா	அராமா
omeegaa	ஒமேகா	அர்மா
omeeka	ஒமேகா	அர்மா
omega	ஒமேகா	அழியா
omegaa	ஒமேகா	அழியா
ommeega	ஒமேகா	அர்சாமா
ommeegaa	ஒமேகா	அர்சியை
ommega	ஒமேகா	அர்மான
ommegaa	ஒமேகா	அர்சாமா
orisa	ஒரிசா	அரியா
orisaa	ஒரிசா	அரியா
orissa	ஒரிசா	அர்சி
orissaa	ஒரிசா	அர்சியா
orrisa	ஒரிசா	அர்சி
orichaavil	ஒரிசாவில்	அர்க்கிில்
orisavil	ஒரிசாவில்	அர்தியின்
orissavil	ஒரிசாவில்	இந்திரியின்
orunginaipai	ஒருங்கிணைப்பை	இருப்புகளை
orunginaippai	ஒருங்கிணைப்பை	இருப்புக்களை
orunkinaippai	ஒருங்கிணைப்பை	இருப்புக்களை
orupadi	ஒருபடி	இரு்கி
orupati	ஒருபடி	இரு்கியி
oruphadi	ஒருபடி	இரு்கிய
otrarkal	ஒற்றர்கள்	இருக்கியல்
ottrargal	ஒற்றர்கள்	இருப்பிகள்
ottrarkal	ஒற்றர்கள்	இருப்பிகள்
ovvoar	ஒவ்வோர்	அரியான்
ovvoor	ஒவ்வோர்	அர்சார்
ovvor	ஒவ்வோர்	அரியன்
oangi	ஓங்கி	அடைய
ongi	ஓங்கி	அட்டி
oongi	ஓங்கி	அட்டி
ozone	ஓசோன்	அடி
oaiyaa	ஓயா	அரா
oayaa	ஓயா	அடை
ooyaa	ஓயா	அரா
oyaa	ஓயா	அரா
hora	ஓர	மி
oora	ஓர	அத
ora	ஓர	அதா
vora	ஓர	நாயா
horangalil	ஓரங்களில்	முறுமையில்
oorangalil	ஓரங்களில்	இரு்களில்
orangalil	ஓரங்களில்	இரு்களில்
vorangalil	ஓரங்களில்	வாட்களில்
horathilum	ஓரத்திலும்	முற்க்கும்
oorathilum	ஓரத்திலும்	இடு்காம்
orathilum	ஓரத்திலும்	உதவிகளும்
oraththilum	ஓரத்திலும்	இடு்களாம்
vorathilum	ஓரத்திலும்	வாட்டாகம்
horathil	ஓரத்தில்	மாட்டின்
oorathil	ஓரத்தில்	இரையின்
orathil	ஓரத்தில்	உலையின்
oraththil	ஓரத்தில்	இரைகளின்
vorathil	ஓரத்தில்	நார்டில்
horamaaga	ஓரமாக	முற்கா
ooramaaga	ஓரமாக	அழுமா
oramaaga	ஓரமாக	இழகா
voramaaga	ஓரமாக	நார்க
horam	ஓரம்	மாடம்
ooram	ஓரம்	அராம்
oram	ஓரம்	அராம்
voram	ஓரம்	நாட்
aolaichchuvadikal	ஓலைச்சுவடிகள்	மு்்குகிறார்
oalaichchuvadikal	ஓலைச்சுவடிகள்	இருப்புக்களில்
oalaichuvadigal	ஓலைச்சுவடிகள்	இருப்புகளில்
olaichchuvadigal	ஓலைச்சுவடிகள்	இருப்புக்களில்
oolaichuvadigal	ஓலைச்சுவடிகள்	இருப்புகளில்
oaldu	ஓல்டு	இட்்கு
oldu	ஓல்டு	இட்்கு
ooldu	ஓல்டு	இட்்கு
kakkan	கக்கன்	குல்லி
kakken	கக்கன்	காட்டி்
kaki	கக்கி	காயி
kakki	கக்கி	குல்யி
kakky	கக்கி	காலி
kachan	கசன்	கோடி
kajan	கசன்	காலி
kasan	கசன்	காலி
kazan	கசன்	காலி
qazan	கசன்	காலி
kadaththal	கடத்தல்	கட்டைய்
kadaththalgalil	கடத்தல்களில்	கு்டங்களில்
kadaththalkalil	கடத்தல்களில்	கு்டங்களில்
kadandhaar	கடந்தார்	குடுகள்
kadanthaar	கடந்தார்	குடுகள்
katandhaar	கடந்தார்	குடுகளால்
katanthaar	கடந்தார்	குடுகளால்
kadanin	கடனின்	குமின்
kadanil	கடனில்	குலை
kadanudhavi	கடனுதவி	கட்டத்தை
kadanuthavi	கடனுதவி	கு்்கியை
katanuthavi	கடனுதவி	கு்டங்களை
kadarkaraigalil	கடற்கரைகளில்	கு்டங்களில்
kadarkaraikalil	கடற்கரைகளில்	கு்டங்களில்
kadarkaraigal	கடற்கரைகள்	கட்டங்களில்
kadarkaraikal	கடற்கரைகள்	கட்டங்கள்
kadarkaraich	கடற்கரைச்	கு்்கியை
katarkaraichh	கடற்கரைச்	குடுத்தை
kadarkaraip	கடற்கரைப்	குடுகளில்
kadarkaraiyum	கடற்கரையும்	குறுக்கார்
kadarkollaiyargal	கடற்கொள்ளையர்கள்	குறிப்புக்களில்
kadarkollaiyarkal	கடற்கொள்ளையர்கள்	குறிப்புக்களில்
kadalin	கடலின்	குமின்
katalin	கடலின்	கு்்டி
kadavul	கடவுள்	காலம்
kadvul	கடவுள்	கட்டம்
kadavulgalil	கடவுள்களில்	கட்டங்களில்
kadavulkalil	கடவுள்களில்	கட்டங்களில்
kadavulgalai	கடவுள்களை	குடுத்தை
kadavulkalai	கடவுள்களை	குடுத்தை
kadavulgal	கடவுள்கள்	கட்டங்கள்
kadavulkal	கடவுள்கள்	கட்டங்கள்
kadidha	கடித	குத்த
kadith	கடித	காலை
kaditha	கடித	குத்த
kadidhangalil	கடிதங்களில்	குறுக்களில்
kadithangalil	கடிதங்களில்	குழுக்களில்
kadithangkalil	கடிதங்களில்	கு்டங்களில்
kadidhangal	கடிதங்கள்	குடுக்கள்
kadithangal	கடிதங்கள்	கட்டங்கள்
kadithangkal	கடிதங்கள்	குடுக்கள்
kadidhu	கடிது	குற்து
kadithu	கடிது	குற்து
katithu	கடிது	குற்து
kadugu	கடுகு	குற்கு
kadumaiyaana	கடுமையான	குடுக்கா
kadaisith	கடைசித்	குட்டி
kadaisip	கடைசிப்	கு்்டி
kadaisiyil	கடைசியில்	காட்டியில்
kadaippidiththu	கடைப்பிடித்து	குட்டுகின்றன
kadaippidithu	கடைப்பிடித்து	குட்டுகின்றன
kadaippiditthu	கடைப்பிடித்து	குட்டுகின்றன
avut	கட்	அராம்
cut	கட்	காட்
kat	கட்	கால்
out	கட்	அம்
kattamaikkum	கட்டமைக்கும்	குறுக்கார்
kattaayamaaga	கட்டாயமாக	குட்டுக்கா
kattumaanak	கட்டுமானக்	குடுக்கான
kattumaanath	கட்டுமானத்	குறுத்தை
kattumaanathin	கட்டுமானத்தின்	கு்டங்களில்
kattumaanaththin	கட்டுமானத்தின்	குறுப்புகளின்
kattumaanathirku	கட்டுமானத்திற்கு	குட்டுக்க்காக
kattumaanaththirku	கட்டுமானத்திற்கு	கொண்டுக்கிற்கும்
katumaanaththirku	கட்டுமானத்திற்கு	குட்டுகின்றன
kattumaanathil	கட்டுமானத்தில்	குறுப்புகளில்
kattumaanaththil	கட்டுமானத்தில்	குறுப்புகளில்
katturaigal	கட்டுரைகள்	குடுக்களால்
kanangalin	கணங்களின்	கட்டத்தில்
kanangkalin	கணங்களின்	கால்களின்
kanaththin	கணத்தின்	கா்்கின்
kanini	கணிணி	குமி
kanippori	கணிப்பொறி	கால்மிரியா
kanipporiyil	கணிப்பொறியில்	குறுக்குகியில்
ganes	கணேஸ்	கேசி
ganesh	கணேஸ்	காசிஸ்
kandarindhavar	கண்டறிந்தவர்	குறிப்புகளால்
kandarindhdhavar	கண்டறிந்தவர்	குறிப்புகளில்
kandarinthavar	கண்டறிந்தவர்	குறிப்புகளால்
kandarinththavar	கண்டறிந்தவர்	குறிப்புகளில்
kandarindhaar	கண்டறிந்தார்	குறிப்புகள்
kandarindhdhaar	கண்டறிந்தார்	குறிப்புகளில்
kandarinthaar	கண்டறிந்தார்	குறிப்புகள்
kandarinththaar	கண்டறிந்தார்	குறிப்புகளால்
kandarindhdhu	கண்டறிந்து	குட்டுகின்றன
kandarindhu	கண்டறிந்து	குட்டுக்கான
kandarinthu	கண்டறிந்து	குற்கின்றன
kandrinththu	கண்டறிந்து	குட்ப்பதாக
kandarindhulladhu	கண்டறிந்துள்ளது	கொண்டப்படுகிறது
kandarindhullathu	கண்டறிந்துள்ளது	கொண்டப்படுகிற்றன
kandarinthulladhu	கண்டறிந்துள்ளது	கொண்டப்படுகிறது
kandarinthullathu	கண்டறிந்துள்ளது	கொண்டப்படுகிற்றன
athinaveena	கண்டுபிடிக்க	அர்போடிய
kandupidikka	கண்டுபிடிக்க	குறிப்படுடான
kandupitikka	கண்டுபிடிக்க	குறிப்பட்டான
kanupidikka	கண்டுபிடிக்க	குற்ப்படாக
kandupidikkak	கண்டுபிடிக்கக்	குறிப்புகளில்
kandupitikkak	கண்டுபிடிக்கக்	குறிப்புகளில்
kandupidikkavum	கண்டுபிடிக்கவும்	குறிப்பிட்டார்
kandupidikkum	கண்டுபிடிக்கும்	குறிப்புகளில்
kannaottaththudan	கண்ணோட்டத்துடன்	குறிப்புகளில்
kannoottaththudan	கண்ணோட்டத்துடன்	குறிப்புகளில்
kannottaththudan	கண்ணோட்டத்துடன்	குறிப்புகளில்
kanoottatthudan	கண்ணோட்டத்துடன்	குறிப்புகளில்
kannoottathai	கண்ணோட்டத்தை	குற்கு்களை
kannoottaththai	கண்ணோட்டத்தை	குற்ப்புகளை
kannottaththai	கண்ணோட்டத்தை	குற்ப்புகளை
kannoattam	கண்ணோட்டம்	குடுக்கார்
kannoottam	கண்ணோட்டம்	குடுக்கார்
kannottam	கண்ணோட்டம்	குடுக்கார்
kanpaarvai	கண்பார்வை	குடுத்தை
gana	கன	காம
kana	கன	காம
ganam	கனம்	காம்
kanam	கனம்	காம்
ganaraga	கனரக	குத்தா
kanaraga	கனரக	கல்மா
kanavai	கனவை	காலை
canno	கனோ	காமி
cannoo	கனோ	காமி
cano	கனோ	கே
kanno	கனோ	காமி
kannoo	கனோ	காமி
kano	கனோ	காயா
kanoo	கனோ	காயா
kanu	கனோ	காடு
qanno	கனோ	காமி
qano	கனோ	காயா
qanoo	கனோ	காயா
comiti	கமிட்டி	காம்சி
comitie	கமிட்டி	கு்்சி
comittee	கமிட்டி	கால்வியா
comity	கமிட்டி	காம்சி
commitee	கமிட்டி	கால்விிய
committee	கமிட்டி	காட்டிரியா
committii	கமிட்டி	காட்டி்தி
kamiddi	கமிட்டி	கு்்சிய
kamiti	கமிட்டி	குமியா
kamitte	கமிட்டி	கு்்ியி
kamitti	கமிட்டி	கு்்விி
qamiti	கமிட்டி	குமியா
kamees	கமீஸ்	காசி
kameez	கமீஸ்	காயி
kamis	கமீஸ்	காமி
cumbaththil	கம்பத்தில்	காட்டிகளில்
kambaththil	கம்பத்தில்	காட்டத்தில்
kambattil	கம்பத்தில்	காட்டத்தில்
kampattil	கம்பத்தில்	காட்டத்தில்
kambam	கம்பம்	காலம்
kampam	கம்பம்	காலம்
kambaramayanam	கம்பராமாயணம்	குட்டங்களைப்
kamparamayanam	கம்பராமாயணம்	குட்டங்களைப்
company	கம்பெனி	கால்சியா
kambeni	கம்பெனி	கு்்விி
kampeni	கம்பெனி	கு்்விி
companykku	கம்பெனிக்கு	குட்ப்பதாக
kambenikku	கம்பெனிக்கு	குட்ப்பதாக
kampenikku	கம்பெனிக்கு	குட்ப்பதாக
companyil	கம்பெனியில்	காட்டியில்
kambeniyil	கம்பெனியில்	கால்கிரியில்
kampeniyil	கம்பெனியில்	கால்கிரியில்
gayaanaa	கயானா	குல்ய
gayana	கயானா	காமா
guana	கயானா	காமா
guiaana	கயானா	காமா
guiana	கயானா	காமா
guianaa	கயானா	குர்யா
guiiana	கயானா	குர்யா
guiyana	கயானா	குர்சி
guuana	கயானா	காமா
guuiana	கயானா	காமா
guuiyana	கயானா	குர்ய
guuvana	கயானா	காமா
guuwana	கயானா	காமா
guuyaana	கயானா	குர்யா
guuyana	கயானா	காமா
guuyanaa	கயானா	குர்யா
guvana	கயானா	காமா
guwana	கயானா	காமா
guyaana	கயானா	காமா
guyana	கயானா	காமா
guyanaa	கயானா	குர்யா
kayana	கயானா	காலை
karagaatam	கரகாட்டம்	கட்டாகம்
karagaattam	கரகாட்டம்	குறுக்கார்
karakaatam	கரகாட்டம்	கட்டாகம்
karakaattam	கரகாட்டம்	குறுக்கார்
karachiyil	கராச்சியில்	கால்களின்
karung	கருங்	குலை
karuththaa	கருத்தா	கடுத்த
karuththaakkangal	கருத்தாக்கங்கள்	குறிப்புகளில்
karuththaakkanggal	கருத்தாக்கங்கள்	குறிப்புகளில்
karuththaakkangkal	கருத்தாக்கங்கள்	குறிப்புகளில்
karuththaakkaththai	கருத்தாக்கத்தை	குற்ப்படு்கை
karuththaal	கருத்தால்	குடுகளில்
karutthaal	கருத்தால்	குடுகளில்
karuththukalaal	கருத்துக்களால்	குறுப்புகள்
karuththukkalaal	கருத்துக்களால்	குறிப்புகளில்
karuthukkalaal	கருத்துக்களால்	குறுப்புகளில்
karuththukalil	கருத்துக்களில்	கு்டங்களில்
karuththukkalil	கருத்துக்களில்	குறுப்புகளில்
karuththukalukku	கருத்துக்களுக்கு	குட்டுக்க்கும்
karuththukkalukku	கருத்துக்களுக்கு	கொண்டுக்கிற்கும்
karuththukalum	கருத்துக்களும்	குறுக்க்கார்
karuththukkalum	கருத்துக்களும்	குறிப்புகளும்
karuththulla	கருத்துள்ள	குட்ப்பட்ட
karuththae	கருத்தே	கடுத்தா
karuththe	கருத்தே	கட்டையை
karuththey	கருத்தே	கு்்ியி
karunira	கருநிற	கு்்கை
karum	கரும்	காடம்
karumpalagai	கரும்பலகை	குறுத்தை
karumpalakai	கரும்பலகை	குறுத்தை
karmpuli	கரும்புலி	கு்்பிரியா
karumpuli	கரும்புலி	கு்டங்களை
karumpuligal	கரும்புலிகள்	குறிப்புகளில்
karumpulikal	கரும்புலிகள்	குறிப்புகளில்
karumpulith	கரும்புலித்	கு்டங்களை
karumpulli	கரும்புள்ளி	கு்டங்களை
karna	கர்ண	குதை
karnanai	கர்ணனை	கு்்கை
karnnanai	கர்ணனை	கு்்களை
karma	கர்ம	குடா
karpadhu	கற்பது	கட்டது
karpathu	கற்பது	குற்த்து
karpatthu	கற்பது	குறித்து
karpam	கற்பம்	காலம்
padugira	கற்பிக்கப்	குட்டைய
padugiradhu	கற்பிக்கப்	குற்பதறது
padukira	கற்பிக்கப்	படுத்தை
padukirathu	கற்பிக்கப்	படித்தது
patukiratu	கற்பிக்கப்	பட்டி்குும்
karpikkappatta	கற்பிக்கப்பட்ட	குறிப்பிட்டாக
karpikkum	கற்பிக்கும்	குறுக்கார்
karpithanggal	கற்பிதங்கள்	குறுப்புகள்
karpithangkal	கற்பிதங்கள்	குற்ப்புகளில்
karpin	கற்பின்	காலியின்
kalasam	கலசம்	காலம்
kalandhaaivu	கலந்தாய்வு	கட்டிய்த
kalandhaayvu	கலந்தாய்வு	குற்கின்றன
kalanthaaivu	கலந்தாய்வு	கட்டிய்த
kalandhuk	கலந்துக்	குற்க்கும்
kalanthuk	கலந்துக்	குற்க்கும்
kalandhum	கலந்தும்	குறையும்
kalanthum	கலந்தும்	குறையும்
kalavi	கலவி	காமி
kalaviyil	கலவியில்	கு்்கில்
kalaanidhi	கலாநிதி	கு்்ியி
kalaanithi	கலாநிதி	கு்்ியி
kalanidhi	கலாநிதி	கு்்விி
kalaanidhip	கலாநிதிப்	கா்்களின்
kalaanithip	கலாநிதிப்	கா்்கத்தில்
kalanidhip	கலாநிதிப்	கா்்களின்
kalinga	கலிங்க	குற்காக
kalingam	கலிங்கம்	குடுகளால்
kalinkam	கலிங்கம்	குடுகளால்
ccalinga	கலிங்கா	பார்மாக
kaliina	கலிங்கா	காலை
kaliinga	கலிங்கா	குற்காக
kalina	கலிங்கா	காலை
kalinaa	கலிங்கா	குதை
kalinga	கலிங்கா	குற்காக
kalingaa	கலிங்கா	குற்கான
kalinka	கலிங்கா	குறுகாக
kallinaa	கலிங்கா	கு்்ியை
kallingaa	கலிங்கா	குடுக்கா
qaliinga	கலிங்கா	குற்காக
qalinga	கலிங்கா	குற்காக
qalingaa	கலிங்கா	குற்கான
qallingaa	கலிங்கா	குடுக்கான
kaliyan	கலியன்	குமின்
kalaik	கலைக்	குலை
koavan	கலைக்	கோடி
koovan	கலைக்	கோடி
kovan	கலைக்	கோடி
choargal	கலைச்	சுற்கள்
chortkal	கலைச்	செல்களில்
corkal	கலைச்	கோட்டார்
sorkkal	கலைச்	செல்களில்
sortkal	கலைச்	செல்களர்
kalaichchorkalai	கலைச்சொற்களை	கு்டுக்கையை
kalicchorkalai	கலைச்சொற்களை	குற்ப்புகளை
kalladi	கல்லடி	கு்்ியி
kalluppatti	கல்லுப்பட்டி	கு்டுக்களை
kalloorigalin	கல்லூரிகளின்	கு்டங்களில்
kallorikalin	கல்லூரிகளின்	கு்டங்களின்
kallurigalin	கல்லூரிகளின்	கு்டங்களில்
kallurigazhin	கல்லூரிகளின்	கு்டங்களில்
kallurikalin	கல்லூரிகளின்	கு்டங்களின்
kallurikazhin	கல்லூரிகளின்	கு்டங்களின்
kalloorigalil	கல்லூரிகளில்	குழ்க்கையில்
kalloorikalil	கல்லூரிகளில்	குழ்க்கையில்
kallurigalil	கல்லூரிகளில்	கு்டங்களில்
kallurigazhil	கல்லூரிகளில்	கு்டங்களில்
kallurikalil	கல்லூரிகளில்	குழுக்களில்
kallurikazhil	கல்லூரிகளில்	குறுக்களில்
kalloorigalukkaana	கல்லூரிகளுக்கான	குறிப்பிட்டாக
kalloorikalukkaana	கல்லூரிகளுக்கான	குறிப்பிட்டாக
kallurigalukkana	கல்லூரிகளுக்கான	குறிப்பிட்டாக
kallurigazhukkana	கல்லூரிகளுக்கான	குறிப்பிட்டாக
kallurikalukkana	கல்லூரிகளுக்கான	குறிப்பிட்டாக
kallurikazhukkana	கல்லூரிகளுக்கான	குறிப்பிட்டாக
kalloorigal	கல்லூரிகள்	கொட்டங்கள்
kalloorikal	கல்லூரிகள்	குட்டங்களை
kallurigal	கல்லூரிகள்	குடுக்களால்
kallurikal	கல்லூரிகள்	குடுக்கள்
kalloorigalukku	கல்லூரிக்கு	குட்டுக்க்காக
kalloorikku	கல்லூரிக்கு	குட்ப்பதாக
kallurikku	கல்லூரிக்கு	குட்ப்பதாக
kalloorip	கல்லூரிப்	கால்கியின்
kallurip	கல்லூரிப்	கு்்கியில்
kallooriyin	கல்லூரியின்	கால்கிரியின்
kalluriyin	கல்லூரியின்	கால்கத்தில்
kallooriyilirindhu	கல்லூரியிலிருந்து	கொண்டப்படுகிற்றன
kallooriyilirundhu	கல்லூரியிலிருந்து	கொண்டப்படுகிற்றன
kalluriyilirundhu	கல்லூரியிலிருந்து	கொண்டப்படுகிற்கு
kalluriyilirunthu	கல்லூரியிலிருந்து	கொண்டப்படுகிற்கு
kallooriyil	கல்லூரியில்	கால்கிரியில்
kalluriyil	கல்லூரியில்	காட்டிகளின்
kallooriyum	கல்லூரியும்	கொட்டி்களும்
kalluriyum	கல்லூரியும்	குடுக்கார்
kallooriei	கல்லூரியை	காட்டியி
kallooriyai	கல்லூரியை	காட்டி்தி
kalluriyai	கல்லூரியை	கு்டுகளை
kalvikku	கல்விக்கு	குறிக்கு
kalvikkum	கல்விக்கும்	குறுக்கும்
kalvich	கல்விச்	கு்்ி
kalviththittam	கல்வித்திட்டம்	குறிப்புகள்
kalvip	கல்விப்	கு்்கில்
kalviyaaga	கல்வியாக	குற்்தாக
kalviyin	கல்வியின்	கா்்கியின்
kalviyil	கல்வியில்	காட்டியில்
kalvieiyum	கல்வியையும்	குறுக்கார்
kalviyaiyum	கல்வியையும்	குறுக்கார்
kaliman	களிமண்	குலின்
kalimun	களிமண்	குல்லின்
kazhiman	களிமண்	குலை
kalaiyum	களையும்	கட்டும்
kazhaiyum	களையும்	கட்டும்
kazhayum	களையும்	குகம்
kalutaikal	கழுதைகள்	கட்டையள்
kaluthaikal	கழுதைகள்	கட்டையள்
kazhudhaigal	கழுதைகள்	கட்டையள்
gavanippu	கவனிப்பு	குறிக்கு
kavanippu	கவனிப்பு	குறிக்கு
kavalaigalai	கவலைகளை	கடுத்தை
kavalaikalai	கவலைகளை	கு்்கை
kavaligalai	கவலைகளை	கு்்கை
kavalaigal	கவலைகள்	கட்டைக்
kavalaikal	கவலைகள்	கட்டைகள்
kavaligal	கவலைகள்	கட்டைக்
kaviyarachu	கவியரசு	குற்ப்த
kaviyaracu	கவியரசு	குற்க்கா
kaviyarasu	கவியரசு	குற்்தாக
counti	கவுண்டி	குரியா
countii	கவுண்டி	காம்மி
county	கவுண்டி	காமியா
couunti	கவுண்டி	குர்சி
couunty	கவுண்டி	குர்சி
kaunti	கவுண்டி	குமியா
kaunty	கவுண்டி	குரிய
kauunty	கவுண்டி	குல்யி
kavunti	கவுண்டி	கு்்சி
kavuntii	கவுண்டி	கு்்விி
kavuunti	கவுண்டி	கு்்விி
kawunti	கவுண்டி	கு்்சி
kounti	கவுண்டி	காமியா
kountii	கவுண்டி	காம்மி
kounty	கவுண்டி	காமியா
kouunti	கவுண்டி	குர்சி
kouunty	கவுண்டி	குர்சி
qaunty	கவுண்டி	காமி
qavunti	கவுண்டி	கு்்சி
qounti	கவுண்டி	காமியா
qounty	கவுண்டி	காமியா
conggo	காங்கோ	காமி
congo	காங்கோ	கால்யா
congoo	காங்கோ	காமியா
congu	காங்கோ	காட்டு
conngo	காங்கோ	குர்சி
coonggoo	காங்கோ	காம்சி
coongoo	காங்கோ	காமியா
coonngoo	காங்கோ	குர்சி
kaango	காங்கோ	காலி
kaanko	காங்கோ	காமி
kankoo	காங்கோ	குமிய
kongo	காங்கோ	கால்யா
koongoo	காங்கோ	காமியா
qongo	காங்கோ	கால்யா
kaattuvadhaagavum	காட்டுவதாகவும்	கொண்டிருக்கும்
kaattuvathaagavum	காட்டுவதாகவும்	குறிப்புகளும்
kaattuvadhai	காட்டுவதை	கொட்டுகளை
kaattuvathai	காட்டுவதை	கொட்டுகளை
kaangindranar	காண்கின்றனர்	குறிப்புகள்
kaangintranar	காண்கின்றனர்	குறுப்புகள்
kaankinranar	காண்கின்றனர்	குற்ப்புகள்
kaanbithththu	காண்பித்து	குட்ப்பதாக
kaanbiththu	காண்பித்து	குற்ப்பது
kaanpiththu	காண்பித்து	குற்ப்தது
kaathi	காதி	காமி
kathi	காதி	கலை
kaadhirundhanar	காத்திருந்தனர்	குறுப்புகள்
kaathirundhanar	காத்திருந்தனர்	குறிப்புகள்
kaaththirunthanar	காத்திருந்தனர்	குறிப்புகளால்
kaatthirunthanar	காத்திருந்தனர்	குறிப்புகளால்
kaathirunthu	காத்திருந்து	குற்கின்றன
kaaththirundhu	காத்திருந்து	குட்டி்பட்ட
kaaththirunththu	காத்திருந்து	குட்டி்பட்ட
kaaththirunthu	காத்திருந்து	குட்டுக்கான
kaatthirunthu	காத்திருந்து	குட்டுக்கான
kaanagaththin	கானகத்தின்	காட்களின்
kanakaththin	கானகத்தின்	கா்்களின்
kaanagam	கானகம்	காலம்
kanagam	கானகம்	குகம்
kaabul	காபூல்	காலல்
kabul	காபூல்	காலம்
kabuul	காபூல்	காலல்
kapuul	காபூல்	காலல்
qabul	காபூல்	காலம்
kaapaatri	காப்பாற்றி	கு்்பியி
kaapaattri	காப்பாற்றி	கால்மியிய
kaappaatri	காப்பாற்றி	காட்டி்தி
kaappaatrti	காப்பாற்றி	குற்கிராயி
kaappatrtri	காப்பாற்றி	குற்கிராயி
kaapaatrinaar	காப்பாற்றினார்	குட்டங்களைப்
kaappaatrinaar	காப்பாற்றினார்	குறிப்புகளில்
kaappaatrtrinaar	காப்பாற்றினார்	குறிப்புகளில்
kaappu	காப்பு	காட்டு
kappu	காப்பு	காட்டு
kaappuch	காப்புச்	கா்்டின்
kappuch	காப்புச்	கா்்கின்
kaaranangalukkaagavum	காரணங்களுக்காகவும்	குறிப்பிட்டார்
kaaranangalukkaakavum	காரணங்களுக்காகவும்	குறிப்பிட்டால்
karananggalukkaakavum	காரணங்களுக்காகவும்	குறிப்பிட்டார்
kaaranaththai	காரணத்தை	குடுக்கை
kaaranattai	காரணத்தை	குடுக்கை
kaaranatthai	காரணத்தை	கொட்கதை
karanaththai	காரணத்தை	குடுகளை
kaaranaththaip	காரணத்தைப்	குடுக்களைப்
kaaranattaip	காரணத்தைப்	குடுக்களை
kaaranatthaip	காரணத்தைப்	காட்டங்கள்
karanaththaip	காரணத்தைப்	குடுகளில்
kaaranamaaga	காரணமாக	குடுக்கா
kaaranamaaka	காரணமாக	குட்டாாக
karanamaaka	காரணமாக	கடுத்த
kaaranamaakak	காரணமாகக்	குடுக்கார்
karanamaakach	காரணமாகக்	குடுகளை
kaaranamaagath	காரணமாகத்	குடுக்கான
kaaranamaakat	காரணமாகத்	குடுக்கள்
kaaranamaakath	காரணமாகத்	குடுக்கான
karanamaakath	காரணமாகத்	கட்ட்தாக
kaaranamaakavo	காரணமாகவோ	குடுக்கை
karanamaakavo	காரணமாகவோ	குடுக்கா
kaaram	காரம்	காடம்
carin	காரின்	கோரின்
kaarin	காரின்	காலின்
caril	காரில்	கோட்ட்
kaaril	காரில்	காலின்
carai	காரை	காயா
kaarai	காரை	காயை
caar	கார்	காட்
car	கார்	காம்
kar	கார்	காம்
cargalai	கார்களை	கொட்களை
kaargalai	கார்களை	குடுகளை
kaarkalai	கார்களை	குடுகளை
carbon	கார்பன்	காமின்
kaarban	கார்பன்	காட்டி்
kaarpan	கார்பன்	காலியின்
karban	கார்பன்	குலைய்
karbon	கார்பன்	குமின்
karbonn	கார்பன்	கு்்சி
karpan	கார்பன்	குலைய்
qarban	கார்பன்	குல்லி
qarbon	கார்பன்	காமரின்
qarbonn	கார்பன்	கா்்டி
caarl	கார்ல்	கில்
carl	கார்ல்	கோர்
carll	கார்ல்	பாட்ட்
karl	கார்ல்	கால்
karll	கார்ல்	கால்
qarl	கார்ல்	கால்
qarll	கார்ல்	காலின்
kaatraal	காற்றால்	கோட்டார்
katraal	காற்றால்	காட்கள்
kaatrinaal	காற்றினால்	காட்டிகள்
katrinaal	காற்றினால்	காட்டியம்
kaatrilirundhu	காற்றிலிருந்து	கொடுக்கப்பட்டு
kaatrilirunthu	காற்றிலிருந்து	கொடுக்கப்பட்டு
katrilirunthu	காற்றிலிருந்து	குட்டி்பட்ட
kaalakatta	காலகட்ட	குறுக்கா
kalakatta	காலகட்ட	குற்காக
kaalakattaththin	காலகட்டத்தின்	கு்டங்களில்
kalakattaththin	காலகட்டத்தின்	கு்டங்களில்
kaalakattam	காலகட்டம்	குடுக்கார்
kalakattam	காலகட்டம்	குடுகளால்
kattangal	காலக்	குடுக்கள்
kattangkal	காலக்	குடுக்கள்
kattankal	காலக்	குடுக்கள்
kattaththai	காலக்	குடுகளை
kattattai	காலக்	குடுத்தை
keduvukkul	காலக்	குட்டங்களும்
ketuvukkul	காலக்	குட்டங்களும்
colony	காலணி	காமி
kaalani	காலணி	குமி
kaalaththaik	காலத்தைக்	குடுகளை
kaalattaik	காலத்தைக்	குடுகளை
kaalatthaik	காலத்தைக்	குடுகளை
kaalaththaip	காலத்தைப்	குடுகளைப்
kaalattaip	காலத்தைப்	குடுகளைப்
kaalatthaip	காலத்தைப்	குடுகளைப்
kaavalthurai	காவல்துறை	குறுத்தை
kaavalturai	காவல்துறை	குடுத்தை
kaavthurai	காவல்துறை	குடுகளை
kaavalthuraiyin	காவல்துறையின்	கு்டங்களில்
kaavalturaiyin	காவல்துறையின்	கு்டங்களில்
kaavalthuraiyil	காவல்துறையில்	குறுப்புகளில்
kaavalturaiyil	காவல்துறையில்	குறுப்புகளில்
kaavalthuraiyum	காவல்துறையும்	குறுப்புகள்
kaavalturaiyum	காவல்துறையும்	குறுப்புகள்
kaavalthuraiyai	காவல்துறையை	கு்டங்களை
kaavalturaiyai	காவல்துறையை	கு்டங்களை
kidangkugal	கிடங்குகள்	குட்டங்கள்
kidangugal	கிடங்குகள்	கொட்டங்கள்
kidangukal	கிடங்குகள்	கொட்டங்கள்
kidankukal	கிடங்குகள்	கொட்டங்கள்
kitankukal	கிடங்குகள்	காட்டங்கள்
kidandhadhu	கிடந்தது	குற்தது
kidandhathu	கிடந்தது	கிட்டித்து
kidanthathu	கிடந்தது	கிட்டித்து
kitantatu	கிடந்தது	கிட்டுந்த
kitanthathu	கிடந்தது	கிட்டித்து
kidandhana	கிடந்தன	கொட்டாகா
kidantana	கிடந்தன	கொட்டாகா
kidanthana	கிடந்தன	கொட்டாகா
kitantana	கிடந்தன	கொட்டுகான
kidandhan	கிடந்தான்	காட்டியம்
kidanthaan	கிடந்தான்	காட்டியம்
kidanthan	கிடந்தான்	காட்டியம்
kitantaan	கிடந்தான்	காட்டியில்
kidandhar	கிடந்தார்	காட்டியம்
kidanthaar	கிடந்தார்	கொட்டாகவர்
kidanthar	கிடந்தார்	கோப்பார்
kitantaar	கிடந்தார்	காட்சியம்
kidandhu	கிடந்து	கிரிந்து
kidanthu	கிடந்து	கிரிந்து
kidantu	கிடந்து	கொட்டாத
kitanthu	கிடந்து	கிரிந்து
kitantu	கிடந்து	கிரிந்த
kidai	கிடை	கோடி
kidaikkach	கிடைக்கச்	காட்டியின்
kidaikkap	கிடைக்கப்	கொட்டாகவர்
kidaikkaadha	கிடைக்காத	கொட்ப்பதாக
kidaikkaatha	கிடைக்காத	கொட்ப்பதாக
kidaikkaamal	கிடைக்காமல்	கொட்டங்கள்
kitaikkaamal	கிடைக்காமல்	கொட்டங்கள்
kidaikkum	கிடைக்கும்	கொட்டாகும்
kitaikkum	கிடைக்கும்	கொட்டாகும்
kidaikkumbodhu	கிடைக்கும்போது	கொண்டுக்கிற்கு
kidaikkumboodhu	கிடைக்கும்போது	குட்டுகின்றன
kidaikkumbothu	கிடைக்கும்போது	கொண்டுக்கிற்கு
kidaikkumpodhu	கிடைக்கும்போது	கொண்டுக்கிற்கு
kidaikkumpoodhu	கிடைக்கும்போது	குட்டுகின்றன
kidaikkumpootu	கிடைக்கும்போது	கொண்டுக்கிற்கு
kidaikkumpothu	கிடைக்கும்போது	கொண்டுக்கிற்கு
kitaikkumpootu	கிடைக்கும்போது	கொண்டுக்கிற்கு
ginnas	கின்னஸ்	கிரிஸ்
ginnes	கின்னஸ்	கிரிஸ்
guines	கின்னஸ்	கிரிஸ்
guinness	கின்னஸ்	கிராஜிச்
guuinness	கின்னஸ்	கிராமிஸ்
kinnas	கின்னஸ்	கிரிஸ்
kinnes	கின்னஸ்	கிரிஸ்
kinns	கின்னஸ்	கிரிஸ்
cubavin	கியூபாவின்	காட்டி
kiyoobaavin	கியூபாவின்	கார்சியில்
kiyoopaavin	கியூபாவின்	கிரிப்பின்
grantha	கிரந்த	கிரித்த
kirantha	கிரந்த	கிரித்த
krantha	கிரந்த	கிரித்த
graham	கிரஹாம்	கிற்கம்
kirubakaran	கிருபாகரன்	கொட்டுகளைப்
kirubhaagaran	கிருபாகரன்	காட்டங்கள்
kirubhaakaran	கிருபாகரன்	காட்டங்கள்
kirupakaran	கிருபாகரன்	கொட்டுகளில்
kiristhavar	கிறித்தவர்	திருவத்தைப்
kiriththavar	கிறித்தவர்	கிரிய்களர்
kiritthavar	கிறித்தவர்	கிரிய்களர்
kiriththuvam	கிறித்துவம்	கிரிக்காலம்
keelo	கிலோ	கேசி
keeloo	கிலோ	கேசி
kiilo	கிலோ	கேசி
kilo	கிலோ	கேசி
kiloo	கிலோ	கேசி
kylo	கிலோ	பாரி
kyloo	கிலோ	கேசி
qeelo	கிலோ	கேசி
qilo	கிலோ	கேசி
qylo	கிலோ	பாரி
keevi	கிவி	கேசி
keewi	கிவி	கேசி
keewii	கிவி	கேசி
kiivi	கிவி	கேசி
kiiwi	கிவி	கேசி
kiiwii	கிவி	கேசி
kivi	கிவி	கேசி
kivii	கிவி	கேசி
kiwi	கிவி	கேசி
kiwii	கிவி	கேசி
qeewi	கிவி	கேசி
qiiwi	கிவி	கேசி
qiwi	கிவி	கேசி
qiwii	கிவி	கேசி
geethaiyin	கீதையின்	பாட்டின்
geethayin	கீதையின்	காட்டின்
green	கீரன்	கிரிஸ்
keeran	கீரன்	கோரின்
kunggumappoo	குங்குமப்பூ	கு்டங்களை
kungkumappoo	குங்குமப்பூ	கு்டங்களை
kungumapoo	குங்குமப்பூ	கு்பட்டையை
kungumappoo	குங்குமப்பூ	கு்டங்களை
kuchaylar	குசேலர்	கோப்பா்
kuchelar	குசேலர்	கோர்டர்
kusaylar	குசேலர்	கோப்பர்
kuselar	குசேலர்	கோர்டர்
kuch	குச்	கோட்
kuchh	குச்	கோட்
kuuch	குச்	கோட்
kuuchh	குச்	கோட்
quch	குச்	கோட்
quchh	குச்	கோட்
quuch	குச்	கோட்
gunamaagum	குணமாகும்	குட்டாகும்
gunamagum	குணமாகும்	குட்டாகம்
kunamaakum	குணமாகும்	குற்க்கும்
gunavardhana	குணவர்தன	கொட்டாகாக
gunavarththana	குணவர்தன	குட்ப்படாக
gunaathisayanggalai	குணாதிசயங்களை	குற்ப்படுத்தை
gunadhisayangalai	குணாதிசயங்களை	குற்ற்கு்தையை
gunathisayankalai	குணாதிசயங்களை	குற்ற்குகையை
gunaathisanggal	குணாதிசயங்கள்	குற்ற்கு்களில்
gunaathisayanggal	குணாதிசயங்கள்	குற்ற்காட்டியி
gunadhisayangal	குணாதிசயங்கள்	குற்ப்புகளில்
kuththappattu	குத்தப்பட்டு	குட்டி்பட்ட
kuthdhudhal	குத்துதல்	குடுக்கள்
kuththudhal	குத்துதல்	குடுக்கள்
kuththuthal	குத்துதல்	குடுக்கார்
kutthuthal	குத்துதல்	கொட்டங்கள்
guptha	குப்த	காட்ட
kuptha	குப்த	குட்ட
kumili	குமிழி	கு்்சி
kumizhi	குமிழி	கு்்ி
kumilikal	குமிழிகள்	குடுகளைப்
kumizhgal	குமிழிகள்	குடுகளில்
kumizhigal	குமிழிகள்	குடுகளில்
kumizhikal	குமிழிகள்	குடுகளைப்
gummi	கும்மி	காமியா
kummi	கும்மி	குரியா
kurudi	குருதி	கு்்சிய
kuruthi	குருதி	கு்்ியை
kurudich	குருதிச்	கு்்விி
kuruthich	குருதிச்	கு்்பியி
kurudhip	குருதிப்	கு்்கிின்
kuruthip	குருதிப்	குடுகளின்
kurudiyin	குருதியின்	கால்கியின்
kuruthiyin	குருதியின்	கால்கத்தில்
kurudiyil	குருதியில்	காட்டியில்
kuruthiyil	குருதியில்	காட்டத்தில்
kurudhiyai	குருதியை	கு்்பதை
kuruthiyai	குருதியை	குட்டுகளை
guruvikal	குருவிகள்	காட்டிகள்
kuruvigal	குருவிகள்	காட்டங்கள்
guraikkum	குரைக்கும்	குறிக்கும்
kuraikkum	குரைக்கும்	குறிக்கும்
kuraikum	குரைக்கும்	குற்க்கும்
kuravanjchi	குறவஞ்சி	கால்மியிய
kuravanji	குறவஞ்சி	கால்விிய
kuripil	குறிப்பில்	காட்டியில்
kurippil	குறிப்பில்	காட்டங்களில்
kurippaedu	குறிப்பேடு	குட்டி்பட்ட
kurippedu	குறிப்பேடு	குட்ப்பதாக
kurugalaana	குறுகலான	குட்டுகான
kurukku	குறுக்கு	குறிக்கு
kurukkuk	குறுக்குக்	குறிக்கும்
kuraindha	குறைந்த	குற்த்த
kuraindhdha	குறைந்த	குற்்தாக
kuraintha	குறைந்த	குற்த்த
kuraindhadhaaga	குறைந்ததாக	கொடுக்காாக
kuraindhdhadhaaga	குறைந்ததாக	குற்ப்படாக
kurainthathaaka	குறைந்ததாக	குட்ப்படாக
kuraindadhaal	குறைந்ததால்	குடுக்களைப்
kuraindhdhadhaal	குறைந்ததால்	குட்டங்களை
kurainthathaal	குறைந்ததால்	குட்டங்களை
kuraindhadhu	குறைந்தது	குற்பததது
kuraindhdhadhu	குறைந்தது	குற்ப்பது
kurainthathu	குறைந்தது	குற்ப்பது
kuraindhana	குறைந்தன	கொட்டாகாக
kuraindhdhana	குறைந்தன	குட்டுகான
kurainthana	குறைந்தன	கொட்டாகாக
kuraindhaalum	குறைந்தாலும்	குடுக்கார்
kuraindhdhaalum	குறைந்தாலும்	குட்டங்களும்
kurainthaalum	குறைந்தாலும்	குடுக்கார்
kuraindhdhullathu	குறைந்துள்ளது	கொண்டப்பட்டுள்
kuraindhulladhu	குறைந்துள்ளது	கொண்டுகின்றன
kurainthulladhu	குறைந்துள்ளது	கொண்டுகின்றன
kulanggalil	குளங்களில்	குடுக்களில்
kulangkalil	குளங்களில்	குடுக்களில்
kulanggalukku	குளங்களுக்கு	குட்டி்பட்டு
kulangkalukku	குளங்களுக்கு	குட்டி்பட்ட
kulirchchiyaana	குளிர்ச்சியான	குற்ப்புகளை
kulai	குழை	காலை
kuzai	குழை	காமை
kuzhai	குழை	காலை
gooam	குவாம்	காம்
guam	குவாம்	காம்
guama	குவாம்	காமா
guuam	குவாம்	காடம்
guuama	குவாம்	காமா
kuvam	குவாம்	காடம்
kuvindha	குவிந்த	குற்த்த
kuvinta	குவிந்த	குட்டாாக
kuvintha	குவிந்த	குற்த்த
kuvindhulladhu	குவிந்துள்ளது	கொண்டுகின்றன
kuvindhullathu	குவிந்துள்ளது	கொண்டுகின்றன
kuvinthullathu	குவிந்துள்ளது	கொண்டுகின்றன
kuvintullathu	குவிந்துள்ளது	கொண்டுகின்றன
kuvintullatu	குவிந்துள்ளது	குட்டுகின்றன
koodam	கூடம்	காடம்
koodi	கூடி	கோரி
koodith	கூடித்	கோரிக்
koodinar	கூடினர்	குட்டி்
koodip	கூடிப்	காடி
koodu	கூடு	குடு
kuudu	கூடு	குடு
kuutu	கூடு	காடு
koodugalai	கூடுகளை	குடுகளை
koodukalai	கூடுகளை	குடுகளை
kuudukalai	கூடுகளை	குடுகளை
kuutukalai	கூடுகளை	குடுகளை
koodugal	கூடுகள்	குடுகள்
koodukal	கூடுகள்	கோட்டார்
kuudugal	கூடுகள்	குடுகள்
kuudukal	கூடுகள்	குடுகள்
kuutukal	கூடுகள்	குடுகளில்
kootta	கூட்ட	கோடாக
kuuta	கூட்ட	காடமா
kuutta	கூட்ட	காட்ட
koottangalil	கூட்டங்களில்	குழ்க்கிறார்
kuuttangalil	கூட்டங்களில்	குழ்க்கையில்
kuuttankalil	கூட்டங்களில்	குழ்க்கையில்
koottangalum	கூட்டங்களும்	குட்டங்களும்
kuuttangalum	கூட்டங்களும்	குட்டங்களும்
kuuttankalum	கூட்டங்களும்	குட்டங்களும்
koottaththirku	கூட்டத்திற்கு	குட்டி்பட்ட
kuuttatthirku	கூட்டத்திற்கு	குட்டி்பட்ட
kuuttattirku	கூட்டத்திற்கு	குட்டி்பட்ட
koottaththil	கூட்டத்தில்	காட்டிகளில்
koottatthil	கூட்டத்தில்	காட்டிகளில்
kuuttatil	கூட்டத்தில்	காட்டியில்
kuuttatthil	கூட்டத்தில்	காட்டத்தில்
kuuttattil	கூட்டத்தில்	காட்டங்களில்
koottaththudan	கூட்டத்துடன்	குறுப்புகள்
koottatthudan	கூட்டத்துடன்	குட்டங்களைப்
kuutattudan	கூட்டத்துடன்	குடுக்களால்
kuutattutan	கூட்டத்துடன்	குறுப்புகள்
koottaththaik	கூட்டத்தைக்	குட்டுகளை
koottatthaik	கூட்டத்தைக்	காட்டங்களை
kuuttattaik	கூட்டத்தைக்	கு்டங்களை
kuuttatthaik	கூட்டத்தைக்	குடுக்களை
koottaththaip	கூட்டத்தைப்	காட்டங்கள்
koottatthaip	கூட்டத்தைப்	காட்டங்கள்
kuuttataip	கூட்டத்தைப்	குடுக்கள்
kuuttattaip	கூட்டத்தைப்	கு்டங்களை
koottal	கூட்டல்	கோட்டார்
koottavo	கூட்டவோ	குட்டிய
kuutavoo	கூட்டவோ	குட்டை
kuuttavoo	கூட்டவோ	கு்்ியி
koottagach	கூட்டாகச்	குட்டிின்
koottakach	கூட்டாகச்	குட்டியின்
kuuttaakac	கூட்டாகச்	குடுக்கை
kuuttaakach	கூட்டாகச்	குடுக்கை
kootinaal	கூட்டினால்	கோட்டார்
koottinaal	கூட்டினால்	காட்டிகள்
koottinal	கூட்டினால்	காட்டியம்
koottuvadharkku	கூட்டுவதற்கு	கொடுக்பட்டு
koottuvadharku	கூட்டுவதற்கு	குட்ப்பதாக
koottuvatharku	கூட்டுவதற்கு	குட்டி்பட்ட
koottai	கூட்டை	குட்டை
koorai	கூரை	காயா
kooraigal	கூரைகள்	குடையைப்
kooraikal	கூரைகள்	குடையைப்
kooreigal	கூரைகள்	கோட்டார்
kooraiyin	கூரையின்	காட்டின்
kooraiyilirundhu	கூரையிலிருந்து	கொண்டுக்கிற்கு
kooraiyilirunthu	கூரையிலிருந்து	கொண்டுக்கிற்கு
koorayilirindhu	கூரையிலிருந்து	கொடுக்பட்தது
mudiyuma	கூற	முற்கா
mudiyumaa	கூற	முற்கான
mutiyuma	கூற	முற்றான
mutiyumaa	கூற	முற்கான
koorappattadhu	கூறப்பட்டது	குட்டுகின்றன
koorappattathu	கூறப்பட்டது	குட்டுகின்றன
kuurapattatu	கூறப்பட்டது	குற்கின்றன
kuurappattatu	கூறப்பட்டது	குட்டி்பட்ட
koorappattana	கூறப்பட்டன	குற்கின்றன
kuurapattana	கூறப்பட்டன	குற்ப்படாக
kuurappattana	கூறப்பட்டன	குற்கின்றன
koorappattaalum	கூறப்பட்டாலும்	குறிப்புகளால்
kuurappataalum	கூறப்பட்டாலும்	குறுக்க்கார்
kuurappattaalum	கூறப்பட்டாலும்	குறிப்புகளால்
koorappattaal	கூறப்பட்டால்	குறுப்புகள்
kuurapattaal	கூறப்பட்டால்	குடுக்களைப்
kuurappattaal	கூறப்பட்டால்	குறுப்புகள்
koorappattulla	கூறப்பட்டுள்ள	குறிப்படு்காக
kuurapattulla	கூறப்பட்டுள்ள	குற்க்கின்றன
kuurappattulla	கூறப்பட்டுள்ள	குறிப்படு்காக
kooravillai	கூறவில்லை	குடுத்தை
kuuravillai	கூறவில்லை	குடுத்தை
kooravae	கூறவே	குகை
koorave	கூறவே	காமி
kuravee	கூறவே	குமி
koorinaal	கூறினால்	கோட்டார்
kuurinaal	கூறினால்	குடையைப்
koorudhal	கூறுதல்	குடுகள்
kooruthal	கூறுதல்	குடுகள்
koorumpoadhu	கூறும்போது	காட்டுகிறது
koorumpodhu	கூறும்போது	காட்டுகிறது
koorumpothu	கூறும்போது	காட்டுகிறது
kedu	கெடு	குடு
kaeplar	கெப்லர்	கோர்டர்
keeplar	கெப்லர்	கிர்டர்
keplar	கெப்லர்	கிர்டர்
kepler	கெப்லர்	கிர்டர்
kiiplar	கெப்லர்	சார்ட்டர்
qeeplar	கெப்லர்	கிர்டர்
qeplar	கெப்லர்	கிர்டர்
qepler	கெப்லர்	கிர்டர்
kaellar	கெல்லர்	கோர்டர்
keler	கெல்லர்	கேட்டர்
kellar	கெல்லர்	கிர்டர்
keller	கெல்லர்	கிர்டர்
qeller	கெல்லர்	கிர்டர்
ccelli	கெல்லி	சிர்யி
ccelly	கெல்லி	பிர்சி
ccely	கெல்லி	பிரி
celli	கெல்லி	பார்டி
celly	கெல்லி	பார்ஜி
cely	கெல்லி	பாரி
kaelli	கெல்லி	காமியா
keley	கெல்லி	கேசி
keli	கெல்லி	கேசி
kellei	கெல்லி	காம்சி
kelley	கெல்லி	காட்டி
kelli	கெல்லி	கிரியா
kelly	கெல்லி	கிரியா
kely	கெல்லி	கேசி
qelley	கெல்லி	காட்டி
qelli	கெல்லி	காமியா
qelly	கெல்லி	காமி
gautham	கெளதம்	காடம்
goutham	கெளதம்	காடம்
kaudham	கெளதம்	காலம்
kovtham	கெளதம்	கோட்டம்
catalina	கேடலினா	கு்்ி
cetalina	கேடலினா	குர்சிய
keedalina	கேடலினா	குர்யி
kaetta	கேட்ட	கோடாக
ketta	கேட்ட	கொட்ட
kaettadhai	கேட்டதை	கொட்டுகை
kaettathai	கேட்டதை	கொட்டுகை
ketadhai	கேட்டதை	குட்டை
ketathai	கேட்டதை	குட்டை
kaettal	கேட்டல்	கோட்டர்
kettal	கேட்டல்	கோர்டர்
kaettavar	கேட்டவர்	காட்டாலல்
kettavar	கேட்டவர்	கோப்பார்
kaettaan	கேட்டான்	காட்டின்
kettan	கேட்டான்	காட்டி்
catie	கேட்டி	காயி
catiee	கேட்டி	காமி
cetie	கேட்டி	கிரி
kaetti	கேட்டி	காமியா
kati	கேட்டி	காயி
katie	கேட்டி	காயி
katiee	கேட்டி	கல்லி
katii	கேட்டி	காமி
katiie	கேட்டி	கல்லி
katiiee	கேட்டி	காமி
kattie	கேட்டி	கு்்ி
kattiee	கேட்டி	கு்்சி
katy	கேட்டி	காயி
katyi	கேட்டி	காமி
ketie	கேட்டி	காயி
ketiee	கேட்டி	காமி
ketiie	கேட்டி	காமி
ketti	கேட்டி	கிரியா
kettie	கேட்டி	காம்சி
kety	கேட்டி	கேசி
ketyi	கேட்டி	காமியா
qatie	கேட்டி	காயி
qatiee	கேட்டி	காமி
qatiie	கேட்டி	காமி
qattie	கேட்டி	கு்்ி
qaty	கேட்டி	காயி
qatyi	கேட்டி	காமி
kaettum	கேட்டும்	கோப்பும்
kettum	கேட்டும்	கிற்கும்
kaendhira	கேந்திர	கு்்ியை
kaenthira	கேந்திர	கு்்ியை
kendhira	கேந்திர	குரிசியை
kendra	கேந்திர	கிராம
kaikoarkka	கைகோர்க்க	குட்டியாாக
kaikoorkka	கைகோர்க்க	கொட்டுகான
kaikorkka	கைகோர்க்க	குட்டுகா
kaik	கைக்	காய்
kaidhi	கைதி	காயி
kaithi	கைதி	காமி
kaydhi	கைதி	காமி
kaythi	கைதி	காமி
kaidhigaludan	கைதிகளுடன்	குடுக்களை
kaidhigalutan	கைதிகளுடன்	குடுக்களால்
kaidhikaludan	கைதிகளுடன்	குடுக்களை
kaithigaludan	கைதிகளுடன்	குடுக்களை
kaithigalutan	கைதிகளுடன்	குடுக்களால்
kaidhigalaiyum	கைதிகளையும்	குறுக்கார்
kaidhikalaiyum	கைதிகளையும்	குறுக்கார்
kaithigalaiyum	கைதிகளையும்	குறுக்கார்
kaiyin	கையின்	காலி
kaiyoppamitta	கையொப்பமிட்ட	குற்க்கின்றன
kaiyoppamittaar	கையொப்பமிட்டார்	குறிப்புகளில்
kaiyoppamittar	கையொப்பமிட்டார்	குறிப்புகளில்
kaivittanar	கைவிட்டனர்	குடுக்கால்
kaiviral	கைவிரல்	கு்்கள்
kodukkiradhu	கொடுக்கிறது	குட்டுகின்றன
kodukkirathu	கொடுக்கிறது	குட்டுகின்றன
kodukkiraan	கொடுக்கிறான்	குறுக்களில்
kodukkiraar	கொடுக்கிறார்	குட்டங்களைப்
kottagai	கொட்டகை	குடுகளை
kottagaikku	கொட்டகைக்கு	குட்டி்காக
vidugirathu	கொட்டி	விளிகிறது
vidukirathu	கொட்டி	விளிகிறது
vitukiratu	கொட்டி	விளிக்போது
kottik	கொட்டிக்	காட்டின்
konara	கொணர	காமா
kondaa	கொண்டா	குர்கா
kondirukkaamal	கொண்டிருக்காமல்	குறிப்புகளில்
kondirukkamal	கொண்டிருக்காமல்	குறிப்புகளில்
kontirukkamal	கொண்டிருக்காமல்	குறிப்புகளில்
kodhi	கொதி	காமி
kothi	கொதி	காமி
kodhikka	கொதிக்க	குட்டாக
kothikka	கொதிக்க	குட்டாக
gorilla	கொரில்லாப்	குட்டா
gorillaap	கொரில்லாப்	காட்டாகக்
gorillap	கொரில்லாப்	காட்டாகம்
korillaap	கொரில்லாப்	காட்டங்கள்
kolusu	கொலுசு	குட்டாக
kolgiraar	கொள்கிறார்	காட்டங்கள்
kolkiraar	கொள்கிறார்	காட்டிகள்
kolgiraen	கொள்கிறேன்	கால்சியின்
kolkirayn	கொள்கிறேன்	கால்கியின்
kollvadhan	கொள்வதன்	காட்டியில்
kolvadhan	கொள்வதன்	காட்டியில்
kolvathan	கொள்வதன்	காட்டியில்
kolvadharkaaga	கொள்வதற்காக	குற்ப்படாக
kolvatharkaaka	கொள்வதற்காக	குற்ப்பதாக
kollvadharkaagavum	கொள்வதற்காகவும்	குறிப்புகளால்
kolvadharkaagavum	கொள்வதற்காகவும்	குறிப்புகளால்
kolvatharkkakavum	கொள்வதற்காகவும்	குறிப்புகளால்
kollvadhaaga	கொள்வதாக	கொடுக்காக
kolvadhaaga	கொள்வதாக	கொடுக்காக
kolvathaaka	கொள்வதாக	கொட்டாகாக
kollvathaagum	கொள்வதாகும்	குடுக்காலம்
kolvadhaagum	கொள்வதாகும்	குறுக்கார்
kolvathaakum	கொள்வதாகும்	கொட்டி்கும்
kolu	கொழு	காடு
kozhu	கொழு	காடு
koadaari	கோடாரி	கு்்சி
koodaari	கோடாரி	கு்்சி
kootaari	கோடாரி	கு்்சி
kaalangalil	கோடைக்	குடுக்களில்
kaalangazhil	கோடைக்	காட்டத்தில்
kaalangkalil	கோடைக்	குடுக்களில்
kalankalil	கோடைக்	கட்டத்தில்
koatpaatukalil	கோட்பாடுகளில்	குறுப்புகளில்
kootpaadugalil	கோட்பாடுகளில்	குறுப்புகளில்
kootpaadukalil	கோட்பாடுகளில்	குறுப்புகளில்
kootpaatukalil	கோட்பாடுகளில்	குறுப்புகளில்
koatpaatugalukku	கோட்பாடுகளுக்கு	கொண்டுக்கிற்கும்
kootpaadugalukku	கோட்பாடுகளுக்கு	கொண்டுக்கிற்கும்
kootpaadukalukku	கோட்பாடுகளுக்கு	கொண்டுக்கிற்கும்
kootpaatugalukku	கோட்பாடுகளுக்கு	கொண்டுக்கிற்கும்
kootpaatukalukku	கோட்பாடுகளுக்கு	கொண்டுக்கிற்கும்
koatpaatukalaip	கோட்பாடுகளைப்	கு்டுக்கையை
kootpaadugalaip	கோட்பாடுகளைப்	கு்டுக்கையை
kootpaadukalaip	கோட்பாடுகளைப்	கு்டுக்களை
kootpaatugalaip	கோட்பாடுகளைப்	கு்டுக்கையை
kootpaatukalaip	கோட்பாடுகளைப்	கு்டங்களையை
koatpaatukalaiyum	கோட்பாடுகளையும்	குறிப்புகளில்
kootpaadukalaiyum	கோட்பாடுகளையும்	குறிப்புகளில்
koatpaatukal	கோட்பாடுகள்	குட்டங்களைப்
kootpaadugal	கோட்பாடுகள்	குட்டங்களைப்
kootpaadukal	கோட்பாடுகள்	குட்டங்களைப்
kootpaatukal	கோட்பாடுகள்	குட்டங்களைப்
godhra	கோத்ரா	காட்ட
koathraa	கோத்ரா	குர்கா
koothraa	கோத்ரா	குர்யா
kootraa	கோத்ரா	குர்யா
conan	கோனன்	கோடின்
conann	கோனன்	காடி
connan	கோனன்	குட்டி
coonan	கோனன்	கோடி
coonann	கோனன்	காமின்
coonnan	கோனன்	குட்டி
coounan	கோனன்	கோடி
coownan	கோனன்	குடிசி
counan	கோனன்	கோடின்
couunan	கோனன்	குவின்
covnan	கோனன்	குடின்
cownan	கோனன்	குமின்
koonn	கோனன்	கோட்
koapiththukkondu	கோபித்துக்கொண்டு	கொண்டுக்கிற்கும்
kobiththukkondu	கோபித்துக்கொண்டு	கொண்டுக்கிற்கும்
kobithukondu	கோபித்துக்கொண்டு	குட்டி்பட்ட
koopitthukkontu	கோபித்துக்கொண்டு	பாத்த்துக்கான
koopittukkondu	கோபித்துக்கொண்டு	கொண்டுக்கிற்கு
koopittukkontu	கோபித்துக்கொண்டு	கொண்டுக்கிற்கு
kopiththukkondu	கோபித்துக்கொண்டு	கொண்டுக்கிற்கும்
kopithukondu	கோபித்துக்கொண்டு	குட்டி்பட்ட
koamagan	கோமகன்	குடின்
komagan	கோமகன்	குடின்
koomagan	கோமகன்	குடின்
koomakan	கோமகன்	குடியி்
caul	கோல்	காட்
cauul	கோல்	காட்
col	கோல்	காட்
coll	கோல்	கான்
cool	கோல்	கான்
cooll	கோல்	கான்
goal	கோல்	காட்
goall	கோல்	கோட்
gol	கோல்	காட்
gooal	கோல்	காட்
gooall	கோல்	கோட்
gool	கோல்	கான்
gooul	கோல்	காட்
goul	கோல்	காட்
gouul	கோல்	காட்
kaul	கோல்	கால்
kauul	கோல்	கால்
kol	கோல்	காட்
kole	கோல்	கோரி
kool	கோல்	கான்
qaul	கோல்	கால்
qol	கோல்	காட்
goalgal	கோல்கள்	கோட்டார்
goalkal	கோல்கள்	கோட்டார்
kolgal	கோல்கள்	காட்கள்
koolkal	கோல்கள்	கோட்டார்
golconda	கோல்கொண்டா	குட்டியி
golkonda	கோல்கொண்டா	கொட்டுகளை
koolkondaa	கோல்கொண்டா	கொட்டுகளை
koolkontaa	கோல்கொண்டா	கொட்டுகளை
kolil	கோளில்	காடின்
koolil	கோளில்	கோடின்
koovalar	கோவலர்	கோட்டர்
kovalar	கோவலர்	கோட்டர்
gouravaththai	கௌரவத்தை	கொட்கதையை
gowravathai	கௌரவத்தை	கொட்கதை
gowrawaththay	கௌரவத்தை	குட்டுகளை
kouravaththay	கௌரவத்தை	குட்டுகை
gouravamana	கௌரவமான	கொட்டாக
gowravamaana	கௌரவமான	கொட்டாகாக
gowrawamaana	கௌரவமான	குட்டுகான
kouravamaana	கௌரவமான	கொட்டாான
gauravam	கௌரவம்	காடம்
gowravam	கௌரவம்	கோட்டம்
kauravam	கௌரவம்	காலம்
kouravam	கௌரவம்	கோடாம்
gouravippu	கௌரவிப்பு	குற்கின்றன
gowravippu	கௌரவிப்பு	குட்ப்பதாக
gowrawippu	கௌரவிப்பு	குற்கின்றன
kouravippu	கௌரவிப்பு	குற்கிற்கு
saga	சக	சா
saka	சக	சா
cagaaya	சகாய	காமா
cakaaya	சகாய	கோட்டா
chagaaya	சகாய	பாரா
chakaaya	சகாய	சாமா
sagaaya	சகாய	பாரா
sagaya	சகாய	பாமா
cagaayam	சகாயம்	கோட்டம்
cakaayam	சகாயம்	பாட்டம்
chagaayam	சகாயம்	பாட்டம்
chakaayam	சகாயம்	சாதமாம்
sagaayam	சகாயம்	சாதமாம்
sagayam	சகாயம்	பாடம்
cakkara	சக்கர	பாராமா
chakkara	சக்கர	சுத்தா
sakkara	சக்கர	சுத்தா
cakkarangal	சக்கரங்கள்	கொட்டங்களால்
cakkarankal	சக்கரங்கள்	கொட்டங்கள்
chakkarangal	சக்கரங்கள்	பார்டங்கள்
chakkarankal	சக்கரங்கள்	பாட்டங்கள்
sakkarangal	சக்கரங்கள்	சார்க்காலல்
sakkaranggal	சக்கரங்கள்	சார்க்களால்
chakkaraththil	சக்கரத்தில்	பார்க்களில்
sakkaraththil	சக்கரத்தில்	சால்கத்தில்
cakkaram	சக்கரம்	சுற்காம்
chakkaram	சக்கரம்	சுற்காம்
sakkaram	சக்கரம்	சுற்காம்
cakkarai	சக்கரை	பா்்கை
chakkarai	சக்கரை	பாருகளை
sakkarai	சக்கரை	பார்களை
changka	சங்க	சாதா
sanga	சங்க	சாதா
sangga	சங்க	சாதா
sangh	சங்க	சாம்
sangha	சங்க	சாத
sangka	சங்க	சாதா
sangangalin	சங்கங்களின்	பார்க்களில்
sanggangkalin	சங்கங்களின்	செல்கிர்கள்
sangkangkalin	சங்கங்களின்	சால்கத்தில்
sangangalil	சங்கங்களில்	பார்க்களில்
sanggangkalil	சங்கங்களில்	செய்குகளில்
sangkangkalil	சங்கங்களில்	சால்கத்தில்
cankangalum	சங்கங்களும்	குட்டங்களும்
cankankalum	சங்கங்களும்	கொட்டி்களும்
chankangalum	சங்கங்களும்	பாட்டிக்கும்
chankankalum	சங்கங்களும்	பாட்டிக்கும்
sangankalum	சங்கங்களும்	செல்களுக்கும்
sanggangkalum	சங்கங்களும்	செய்கிற்கும்
changkaththaal	சங்கத்தால்	பாட்டங்கள்
sangaththal	சங்கத்தால்	சார்க்கார்
sanggaththaal	சங்கத்தால்	சார்டங்கள்
sangkaththaal	சங்கத்தால்	சாத்தியார்
cankatthin	சங்கத்தின்	காட்டியில்
cankattin	சங்கத்தின்	காட்டியில்
chankattin	சங்கத்தின்	பார்கியின்
sangaththin	சங்கத்தின்	சால்கியில்
sanggaththin	சங்கத்தின்	சால்கியில்
sangaththilirundhdhu	சங்கத்திலிருந்து	செய்தப்பட்டுு
sangaththilirundhu	சங்கத்திலிருந்து	செய்தப்பட்டு
sangaththilirunthu	சங்கத்திலிருந்து	செய்தப்பட்டு
sanggaththilirunthu	சங்கத்திலிருந்து	செய்தப்பட்டு
sangaththilum	சங்கத்திலும்	செய்கின்றனர்
sanggaththilum	சங்கத்திலும்	செய்கின்றனர்
sangap	சங்கப்	செல்கள்
sanggap	சங்கப்	செல்கள்
sankap	சங்கப்	செல்கள்
sangama	சங்கம	சுத்தா
sanggama	சங்கம	சுத்தா
sankama	சங்கம	சுத்தா
sankarin	சங்கரின்	பார்டியில்
shankarin	சங்கரின்	சார்டியில்
sanggin	சங்கின்	சார்டின்
sangin	சங்கின்	சார்டின்
sanggiliyin	சங்கிலியின்	பார்ட்டியின்
sangiliyin	சங்கிலியின்	பார்ட்டியின்
sangilyyin	சங்கிலியின்	பிருக்கியின்
sanggiliyil	சங்கிலியில்	செல்கிரியில்
sangiliyil	சங்கிலியில்	செல்கிரியில்
sangilyyil	சங்கிலியில்	செய்கிரியில்
sattaikku	சட்டைக்கு	பாட்டிக்கு
sadhaveedha	சதவீத	பாட்டாக
sathaveetha	சதவீத	பாட்டாக
sadhaveedhaththai	சதவீதத்தை	பாட்கத்தை
sathaveedhaththai	சதவீதத்தை	பாட்கத்தை
sathaveethaththai	சதவீதத்தை	பாட்கத்தை
santharppa	சந்தர்ப்ப	பாட்டி்காக
santharppaththai	சந்தர்ப்பத்தை	பாதுக்கு்கை
sandhaa	சந்தா	சுத்த
santha	சந்தா	சாதா
santhaa	சந்தா	சுத்த
sandhaippaduththudhal	சந்தைப்படுத்துதல்	புற்ற்குக்களில்
sandhaippaduththuthal	சந்தைப்படுத்துதல்	புற்ற்குக்களில்
santhaippaduththuthal	சந்தைப்படுத்துதல்	புற்ற்குக்களில்
sandhaippaduththum	சந்தைப்படுத்தும்	பாத்த்துக்கார்
santhaippaduththum	சந்தைப்படுத்தும்	பாத்த்துக்கார்
chaand	சந்த்	பாட்
chand	சந்த்	பாட்
chanda	சந்த்	பாராத
jaen	சன	ஜோஸ்
jain	சன	ஜோஸ்
jan	சன	ஜோன்
jann	சன	ஜோன்
jayn	சன	ஜோன்
zaen	சன	ஜின்
zan	சன	ஜான்
zann	சன	ஜெல்
zayn	சன	ஜென்
san	சன்	சேன்
sann	சன்	சின்
son	சன்	சேன்
sun	சன்	சேன்
sunn	சன்	சின்
suun	சன்	சேன்
suunn	சன்	சின்
tivi	சன்	டெஸ்
sabadham	சபதம்	சுதம்
sabatham	சபதம்	சுத்ம்
sabaiyinar	சபையினர்	பார்சியம்
sab	சப்	சேன்
sabb	சப்	சின்
sub	சப்	பின்
subb	சப்	சின்
suub	சப்	சின்
suubb	சப்	சின்
samagaalaththil	சமகாலத்தில்	பா்கங்களில்
samakaalaththil	சமகாலத்தில்	பா்கங்களில்
samacheeraana	சமச்சீரான	சுர்த்தை
samachieerana	சமச்சீரான	சிர்த்தை
samachierana	சமச்சீரான	சுர்த்தை
samamaagavae	சமமாகவே	பா்த்தை
samamagave	சமமாகவே	கொட்டாமா
samamakave	சமமாகவே	கொட்டாமை
samamaagum	சமமாகும்	போர்க்கும்
samamagum	சமமாகும்	சுற்கும்
samamakum	சமமாகும்	பாட்டும்
samayaththavar	சமயத்தவர்	பாட்டங்கள்
samarppiththa	சமர்ப்பித்த	செய்திருந்த
samavaaippu	சமவாய்ப்பு	பாட்கிற்கு
samavaayppu	சமவாய்ப்பு	பாட்கிற்கு
samavaippu	சமவாய்ப்பு	பாட்கிற்கு
sameera	சமீரா	சாமா
samsaara	சம்சார	சுர்கான
sumsaara	சம்சார	சுர்கான
sambirathaayathil	சம்பிரதாயத்தில்	சுற்க்குகளின்
sambradhaayathil	சம்பிரதாயத்தில்	சுற்குகியில்
sambrathaayathil	சம்பிரதாயத்தில்	செல்க்குகளில்
sampirathaayatthil	சம்பிரதாயத்தில்	சிற்றுக்கத்தில்
sampirathayathil	சம்பிரதாயத்தில்	சுற்கார்களில்
sampirathayaththil	சம்பிரதாயத்தில்	புற்றுக்கத்தில்
sambiradhayathai	சம்பிரதாயத்தை	சுற்கு்தையை
sambradhayathai	சம்பிரதாயத்தை	சுற்கு்களை
sambrathayaththai	சம்பிரதாயத்தை	பார்க்குகளை
sampiradhayathai	சம்பிரதாயத்தை	சுற்கு்தையை
sampirathaayatthai	சம்பிரதாயத்தை	சுற்குக்கையை
sampirathayaththai	சம்பிரதாயத்தை	சுற்குக்களை
sambandhappatta	சம்மந்தப்பட்ட	பாட்டுக்க்காக
sammanthappatta	சம்மந்தப்பட்ட	திருவிக்கின்றன
sammandhdhamaana	சம்மந்தமான	கிருவிக்கான
sammanthamaana	சம்மந்தமான	கிருவிக்கா
cargo	சரக்கு	கார்யா
kargo	சரக்கு	காலா
kargoo	சரக்கு	குமி
kargou	சரக்கு	குட்ட
kargouu	சரக்கு	குடுக்க
kargu	சரக்கு	குற்கு
karrgo	சரக்கு	கா்்கை
qargoo	சரக்கு	குமி
qargou	சரக்கு	குட்ட
qarrgo	சரக்கு	கா்்
sarakku	சரக்கு	பாட்டு
sarakkukalai	சரக்குகளை	பாட்டங்களை
sarasu	சரசு	சாமா
saranadainthanar	சரணடைந்தனர்	பா்கங்களையும்
saranadaiyach	சரணடையச்	பார்கியில்
soorai	சர்ரே	சாமா
sooray	சர்ரே	பாமா
soorey	சர்ரே	பாரா
soorreey	சர்ரே	சிர்தி
soorrei	சர்ரே	சிவிய
soorrey	சர்ரே	சுர்யா
suray	சர்ரே	பாமா
surey	சர்ரே	சாமா
surrai	சர்ரே	சுத்தை
surray	சர்ரே	பார்கா
surreey	சர்ரே	சுர்யி
surrei	சர்ரே	சும்ய
surrey	சர்ரே	சுர்யி
suurray	சர்ரே	சுத்தை
suurrey	சர்ரே	சுர்யா
sarvaadhigaara	சர்வாதிகார	சுத்திர்கா
sarvaathikaara	சர்வாதிகார	சுத்திர்கா
sarvaadhigaaraththai	சர்வாதிகாரத்தை	பாதுக்கு்தியை
sarvaathikaaraththai	சர்வாதிகாரத்தை	பாதுக்கு்தியை
sarvaathikaaratthai	சர்வாதிகாரத்தை	சுற்குக்கையை
sarvaadhigaaram	சர்வாதிகாரம்	செய்கின்றனர்
sarvaathikaaram	சர்வாதிகாரம்	செய்கின்றனர்
sarvaadigaari	சர்வாதிகாரி	பார்கும்பிய
sarvaathikaari	சர்வாதிகாரி	பார்கும்பிய
satru	சற்று	கிறு
sattru	சற்று	போட்டு
saakkadai	சாக்கடை	சுத்தைய
sakkadai	சாக்கடை	பார்களை
saakkadaigal	சாக்கடைகள்	சார்க்காலல்
sakkadaikal	சாக்கடைகள்	பாட்டங்கள்
saakkiya	சாக்கிய	சுர்விய
sakkiya	சாக்கிய	சுர்விய
saasanam	சாசனம்	சிய்கம்
sasanam	சாசனம்	சியம்
saattai	சாட்டை	சுத்தை
saattay	சாட்டை	பார்கா
sattai	சாட்டை	பா்்கை
saadhagamaaga	சாதகமாக	பார்மாக
saathakamaaka	சாதகமாக	பாட்டாக
sathakamaka	சாதகமாக	பட்த்த
saathanangal	சாதனங்கள்	சார்டங்கள்
saathanangkal	சாதனங்கள்	செய்கிறார்
saadhaarana	சாதாரண	சுத்தா
saathaarana	சாதாரண	சுத்தா
saadhaaranamaaga	சாதாரணமாக	பாட்டியாக
saathaaranamaaga	சாதாரணமாக	பாட்டியாாக
saathaaranamaaka	சாதாரணமாக	பாட்டுக்க
saadhaaranamaanathu	சாதாரணமானது	பாட்டி்தது
saathaaranamaanathu	சாதாரணமானது	பாட்டி்பட்ட
saaththiyamaaga	சாத்தியமாக	பார்கின்றன
saaththiyamaaka	சாத்தியமாக	பாட்டியாாக
saaththiyamaagum	சாத்தியமாகும்	செய்கின்றும்
saaththiyamaakum	சாத்தியமாகும்	செய்கின்றும்
saayam	சாயம்	சாம்
saaradhi	சாரதி	சும்ய
saarathi	சாரதி	சும்ய
saarathy	சாரதி	பார்சி
sarathi	சாரதி	சும்ய
caarnthoo	சார்ந்தோ	கிரிசாமி
chaarntho	சார்ந்தோ	பிர்விய
saarndhoa	சார்ந்தோ	சுர்கதை
saarnthoo	சார்ந்தோ	பிர்வியா
caarpatta	சார்பற்ற	கிரிக்காக
chaarpatta	சார்பற்ற	சிர்த்தாாக
saarpatta	சார்பற்ற	சிர்த்தாாக
saarpattra	சார்பற்ற	சுர்கத்தா
saarpattrra	சார்பற்ற	சுற்கின்றன
chaalukkiya	சாளுக்கிய	பாருத்தை
chalukya	சாளுக்கிய	பார்டை
saalukkiya	சாளுக்கிய	பார்டியை
salukkiya	சாளுக்கிய	பாருத்தை
java	சாவா	ஜாயா
saava	சாவா	சா
saavaa	சாவா	சாமா
saavilirundhu	சாவிலிருந்து	செல்கின்றது
saavilirunthu	சாவிலிருந்து	செல்கின்றது
saashthaa	சாஸ்தா	சிராமா
saasthaa	சாஸ்தா	சிர்யா
sastha	சாஸ்தா	சிசா
saashthiriyin	சாஸ்திரியின்	சிர்க்கியின்
saasthiriyin	சாஸ்திரியின்	பிரிப்பிட்ட்
sastriyin	சாஸ்திரியின்	பிர்ட்டின்
shastriyin	சாஸ்திரியின்	பிர்ட்டின்
chikkanam	சிக்கனம்	சிர்க்கம்
sikanam	சிக்கனம்	சிர்ம்
sikkanam	சிக்கனம்	சிரியாம்
caitric	சிட்ரிக்	கிர்சி்
cetric	சிட்ரிக்	பார்டின்
citric	சிட்ரிக்	பிர்டின்
citrick	சிட்ரிக்	பிர்சியன்
citricq	சிட்ரிக்	பார்சியன்
citrik	சிட்ரிக்	பிர்சி்
citriq	சிட்ரிக்	பார்சின்
shidhi	சிதி	சியா
sidhi	சிதி	சியா
sidi	சிதி	சிய்
siidhii	சிதி	சிவி
siidii	சிதி	சியா
sydhi	சிதி	சிவி
sydhii	சிதி	சிவி
chithiraith	சித்திரைத்	சிர்சியம்
sithiraith	சித்திரைத்	சிர்சியம்
siththiraith	சித்திரைத்	செய்கிறார்
sitthiraith	சித்திரைத்	சிர்ப்பால்
chithiraiyil	சித்திரையில்	செய்கிறார்
sithiraiyil	சித்திரையில்	சிர்கியில்
siththiraiyil	சித்திரையில்	செய்குகளில்
sitthiraiyil	சித்திரையில்	செய்குகளில்
chintha	சிந்தா	சிராம
chinthaa	சிந்தா	சிர்மா
sindhaa	சிந்தா	சிராமா
sintha	சிந்தா	சிராம
sinthaa	சிந்தா	சிராமா
chinthitthu	சிந்தித்து	சிரிக்தது
sinthiththu	சிந்தித்து	சிரிந்தது
sinthithu	சிந்தித்து	சிரிந்து
sinthitthu	சிந்தித்து	சிரிக்தது
sindhu	சிந்து	சிற்க
sinthu	சிந்து	சிற்க
sindhum	சிந்தும்	சிர்கும்
sindhuvin	சிந்துவின்	பிர்சியின்
cbse	சிபிஎஸ்இ	பிஸ்
seempson	சிம்ப்சன்	பிர்ட்டின்
siimpson	சிம்ப்சன்	பிர்ட்டின்
simpsan	சிம்ப்சன்	பிர்ட்டின்
simpson	சிம்ப்சன்	பிர்டிஸ்
simpsonn	சிம்ப்சன்	பிர்ட்டின்
sympson	சிம்ப்சன்	பிர்ட்டின்
shimma	சிம்ம	சிரா
simma	சிம்ம	சிரா
chiyol	சியோல்	சின்
chiyool	சியோல்	சிர்ட்
seooul	சியோல்	சேட்
seoul	சியோல்	சேட்
seouul	சியோல்	சில்
siyoal	சியோல்	சிர்ட்
siyool	சியோல்	சிர்ட்
sirikka	சிரிக்க	சிரியாக
siria	சிரிய	சிவி
siriya	சிரிய	சிசியா
syria	சிரிய	சிசியா
siridhalavum	சிறிதளவும்	சிர்க்கும்
sirithalavum	சிறிதளவும்	சிர்க்கும்
koodam	சிறைக்	காடம்
kutam	சிறைக்	காடம்
siraik	சிறைக்	சிரான்
siraikh	சிறைக்	சிர்க்
sivanadhu	சிவனது	சிர்ந்து
sivanathu	சிவனது	சிர்ந்து
sivanaal	சிவனால்	சிர்யர்
sivanal	சிவனால்	சிர்கம்
sivapragasham	சிவப்பிரகாசம்	சிர்சியார்
sivaprakasam	சிவப்பிரகாசம்	சிர்சியார்
sivasivappiragasam	சிவப்பிரகாசம்	சிர்த்துக்கை
sivappirakaashar	சிவப்பிரகாசர்	சிர்ப்பத்தின்
sivappirakasar	சிவப்பிரகாசர்	சிர்ப்பத்தின்
sivaprakasar	சிவப்பிரகாசர்	சிர்கிரியின்
sivaprakashar	சிவப்பிரகாசர்	ஸ்டீர்ட்டி்
cevil	சிவில்	சேரின்
cewil	சிவில்	சாலின்
civiil	சிவில்	சேசர்
civil	சிவில்	சேரின்
ciwiil	சிவில்	சேரின்
ciwil	சிவில்	சேரர்
sivil	சிவில்	சிச்
siwil	சிவில்	சிர்ட்
season	சீசன்	பிரிஸ்
sesan	சீசன்	சிரின்
seson	சீசன்	சிரிஸ்
siijan	சீசன்	சிச்
siizan	சீசன்	சிர்ட்
sijan	சீசன்	ஸ்டான்
sizan	சீசன்	சிசி்
caesarin	சீசரின்	காட்டின்
cesarin	சீசரின்	காட்டின்
seesarin	சீசரின்	சிர்டின்
caesar	சீசர்	சேர்
cesar	சீசர்	சேர்
ciisar	சீசர்	சில்
cisar	சீசர்	சிய்்
seesar	சீசர்	சிய்்
siijor	சீசர்	சிச்யம்
sijor	சீசர்	ஸ்டார்
sizor	சீசர்	சிச்யம்
seenivasan	சீனிவாசன்	பிர்ட்டி்
srinivasan	சீனிவாசன்	ஸ்டீட்டின்
seeriya	சீரிய	சிசியா
sarial	சீரியல்	சேர்க்
serial	சீரியல்	சிர்டர்
seriial	சீரியல்	செய்வில்
chiirutaikalai	சீருடைகளை	செய்கி்களை
chirutaikalai	சீருடைகளை	சுற்கத்தை
seerudaigalai	சீருடைகளை	சுறுத்தை
seerudaikalai	சீருடைகளை	சுத்தியான
serutaikalai	சீருடைகளை	சுத்தியான
siirutaikalai	சீருடைகளை	செய்கி்கை
seeri	சீறி	சிவி
sugandhan	சுகந்தன்	பார்கியம்
suganthan	சுகந்தன்	பார்கியம்
sukanthan	சுகந்தன்	செய்கியம்
chukumaaran	சுகுமாரன்	பார்க்கள்
sugumaaran	சுகுமாரன்	பார்களில்
sugumaran	சுகுமாரன்	சால்களில்
sukumaaran	சுகுமாரன்	சார்க்கள்
sukumaran	சுகுமாரன்	சார்களில்
chuththa	சுத்த	சாதா
chuttha	சுத்த	சாத்த
suththa	சுத்த	சாத்த
suttha	சுத்த	சிக்க
chuththap	சுத்தப்	சுற்கம்
chutthap	சுத்தப்	செல்களம்
suththap	சுத்தப்	செல்களம்
sutthap	சுத்தப்	செல்காம்
chuttham	சுத்தம்	சுற்கம்
sutham	சுத்தம்	சாம்
suththam	சுத்தம்	சுற்கம்
suttham	சுத்தம்	சேர்கம்
sudhthikarikkappatta	சுத்திகரிக்கப்பட்ட	பார்க்கப்பட்டும்
suththikarikkappatta	சுத்திகரிக்கப்பட்ட	பார்க்கப்பட்டுு
suththikarippu	சுத்திகரிப்பு	செல்லிருந்தும்
chunithaa	சுனிதா	சிர்மா
sunita	சுனிதா	சிர்யா
sunitha	சுனிதா	சிராமா
sunithaa	சுனிதா	சிர்மா
suunita	சுனிதா	சிர்கி
chuyeecchai	சுயேச்சை	சிர்வியை
suyaechchai	சுயேச்சை	சிர்சியை
suyechai	சுயேச்சை	சிவிய
suyechchai	சுயேச்சை	சிர்சியை
suyeecchai	சுயேச்சை	சிர்சியை
shruthi	சுருதி	சிர்தி
surudhi	சுருதி	சுத்தி
suruthi	சுருதி	சுர்கிய
surusuruppaaga	சுறுசுறுப்பாக	திருவிக்காாக
surrullaath	சுற்றுலாத்	சுற்கு்களை
sutrullaath	சுற்றுலாத்	சுற்கு்களை
suttrulaath	சுற்றுலாத்	செய்கியான
surrulaavin	சுற்றுலாவின்	பார்ட்டியில்
sutrulaavin	சுற்றுலாவின்	செல்கிரியில்
suttrulaavin	சுற்றுலாவின்	செல்கிரியில்
surrulaavai	சுற்றுலாவை	சுறுத்தை
sutrulaavai	சுற்றுலாவை	சுர்கத்தை
suttrulaavai	சுற்றுலாவை	சுர்கத்தை
sulalil	சுழலில்	சால்கில்
suzhalil	சுழலில்	சால்கில்
suvaasikkath	சுவாசிக்கத்	சிற்கியாான
suvachikkath	சுவாசிக்கத்	சிற்கியாகம்
suvasikkath	சுவாசிக்கத்	செய்கியால்
chootti	சூட்டி	சுர்யி
chutti	சூட்டி	பார்டி
shootti	சூட்டி	சுர்யி
sootti	சூட்டி	சுர்யி
choottinaar	சூட்டினார்	பார்சியம்
chuttinaar	சூட்டினார்	பார்சியம்
shoottinaar	சூட்டினார்	செய்கிறார்
soottinaar	சூட்டினார்	பார்சியம்
choottinai	சூட்டினை	பார்டியை
chuttinai	சூட்டினை	பார்டியை
shootinai	சூட்டினை	சுர்யை
soottinai	சூட்டினை	பார்டியை
suittinai	சூட்டினை	சிர்த்தை
choottil	சூட்டில்	சார்டின்
soottil	சூட்டில்	சார்டின்
suittil	சூட்டில்	சிர்சியில்
choothaatta	சூதாட்ட	சுர்ந்தா
soodhaatta	சூதாட்ட	பிரித்த
soothaatta	சூதாட்ட	சிர்த்த
choothaattathil	சூதாட்டத்தில்	சால்கி்தில்
soodhattaththil	சூதாட்டத்தில்	பா்குகி்தில்
soothaattaththil	சூதாட்டத்தில்	பார்க்குகளின்
sooyas	சூயஸ்	பாஸ்
suez	சூயஸ்	சிய்
suyas	சூயஸ்	பாஸ்
sooraavali	சூறாவளி	சுர்கைய
sooravazhi	சூறாவளி	சுர்விய
sooraavaliyaaga	சூறாவளியாக	பாட்டியாாக
sooraavaliyaaka	சூறாவளியாக	பாட்டுக்கா
sooravazhiyaga	சூறாவளியாக	பார்த்தான
soolappatta	சூழப்பட்ட	சுத்திர்ந்த
soozhappatta	சூழப்பட்ட	சுற்கின்றன
soolappattu	சூழப்பட்டு	செல்கிற்கு
soozhappattu	சூழப்பட்டு	செல்கிற்கு
chengkam	செங்கம்	சிர்கம்
sengam	செங்கம்	சிர்கம்
sengkam	செங்கம்	சிர்கம்
senkam	செங்கம்	சிர்கம்
seyarpaadugalinaal	செயற்பாடுகளினால்	சிற்றுக்குகளின்
seyarpaadugal	செயற்பாடுகள்	செய்த்துகள்
seyarpadugal	செயற்பாடுகள்	செய்திர்கள்
seyarpaadum	செயற்பாடும்	செல்கின்றும்
seyarpadum	செயற்பாடும்	செல்களையும்
seyalaatri	செயலாற்றி	பிரும்பியா
seyalaattri	செயலாற்றி	பிரும்ப்டி
seyalattri	செயலாற்றி	பிரும்பியா
seyalaatrum	செயலாற்றும்	செல்களையும்
seyalaattrum	செயலாற்றும்	செய்கிற்கும்
seyalattrum	செயலாற்றும்	செல்களுக்கும்
seyalaatruvathu	செயலாற்றுவது	செல்கின்றது
seyalaattruvathu	செயலாற்றுவது	செல்கின்றது
seyalattruvadhu	செயலாற்றுவது	செல்கின்றது
seyalattruvathu	செயலாற்றுவது	செல்கின்றது
seyalilakka	செயலிழக்க	சிர்ப்பாக
seyalizhakka	செயலிழக்க	சிர்ப்பாக
seyalukku	செயலுக்கு	சிரிக்குும்
seyalum	செயலும்	சிர்கும்
seyalpada	செயல்பட	சிர்ப்பா
seyalpadakkoodiya	செயல்படக்கூடிய	சிர்த்துக்கையை
seyalpadakkudiya	செயல்படக்கூடிய	சிர்த்துக்கை
seyalpadath	செயல்படத்	செய்கியார்
seyalpadavillai	செயல்படவில்லை	சிற்றுக்கையை
seyalpadavum	செயல்படவும்	செய்கிற்கும்
seyalpaduvum	செயல்படவும்	செய்கின்றும்
seyalpadaamal	செயல்படாமல்	செய்கிர்கள்
seyalpadamal	செயல்படாமல்	செய்கிறார்
cheyalpaduvatharku	செயல்படுவதற்கு	செய்த்துக்க்கு
cheyalpatuvatharku	செயல்படுவதற்கு	செய்தப்பட்டும்
seyalpaduvadharku	செயல்படுவதற்கு	செய்த்துக்க்கு
seyalpaduvatharku	செயல்படுவதற்கு	செய்த்துக்க்கு
seyalpatuvatharku	செயல்படுவதற்கு	செய்தப்பட்டும்
cheyalmurai	செயல்முறை	சிர்த்தையை
seyalmurai	செயல்முறை	சிர்த்தையை
seidhadhan	செய்ததன்	செய்கியம்
seithathan	செய்ததன்	செய்கியம்
cheythavan	செய்தவன்	செய்கியம்
seidhavan	செய்தவன்	செய்கில்
seithavan	செய்தவன்	செய்கியம்
seythavan	செய்தவன்	செய்கியம்
seidhulladhu	செய்துள்ளது	செல்கிறது
seithullathu	செய்துள்ளது	செல்கிறது
seidhullaar	செய்துள்ளார்	செய்கிறார்
seithullaar	செய்துள்ளார்	செய்கிறார்
seibavargalin	செய்பவர்களின்	செய்குகிறில்
seibavarkalin	செய்பவர்களின்	செய்குகியில்
seibavargalukku	செய்பவர்களுக்கு	செய்த்துள்ளனர்
seibavarkalukku	செய்பவர்களுக்கு	செய்திருந்தும்
seibavargalai	செய்பவர்களை	செய்கி்களை
seibavarkalai	செய்பவர்களை	சிற்கு்கை
seiyappattathaal	செய்யப்பட்டதால்	சிற்றி்துகளில்
seiyyappattadhaal	செய்யப்பட்டதால்	சிற்றி்துகளில்
seiyyappattathaal	செய்யப்பட்டதால்	சிற்றி்துகளில்
seiyappattathai	செய்யப்பட்டதை	சிற்றுக்கையை
seiyyappattadhai	செய்யப்பட்டதை	சிற்றுக்கையை
seiyyappattathai	செய்யப்பட்டதை	சிற்றுக்கையை
seiyappattana	செய்யப்பட்டன	சிர்க்கின்றன
seiyyappattana	செய்யப்பட்டன	சிர்ந்துள்ளன
seiyappattavar	செய்யப்பட்டவர்	சிற்றிக்காகவர்
seiyyappattavar	செய்யப்பட்டவர்	சிர்த்துக்கார்
seiyappattaal	செய்யப்பட்டால்	சிற்றி்த்தில்
seiyappattal	செய்யப்பட்டால்	சிற்றி்தியல்
seyyappattal	செய்யப்பட்டால்	சிற்றி்தியல்
seiyappattirukkum	செய்யப்பட்டிருக்கும்	செய்தப்படுக்கும்
seyyappattirukkum	செய்யப்பட்டிருக்கும்	செய்தப்படுக்கும்
seiyappattum	செய்யப்பட்டும்	சிர்க்குக்கும்
seyyappattum	செய்யப்பட்டும்	சிர்க்குக்கும்
seiyappattulla	செய்யப்பட்டுள்ள	சிர்க்கின்றன
seyyappattulla	செய்யப்பட்டுள்ள	சிர்க்கின்றன
seiyappattulladhu	செய்யப்பட்டுள்ளது	செய்தப்பட்டுள்ள
seiyappattullathu	செய்யப்பட்டுள்ளது	செய்தப்பட்டுள்ள
seyyappattullathu	செய்யப்பட்டுள்ளது	செய்தப்பட்டுள்ள
seiyulil	செய்யுளில்	சிர்சியில்
seyyulil	செய்யுளில்	சிர்சியில்
cherbiya	செர்பிய	பிர்சிய
serbia	செர்பிய	பிர்சி
serbiya	செர்பிய	பிர்சிய
chelavita	செலவிட	பிர்விய
selavida	செலவிட	பிர்விய
selavita	செலவிட	பிர்விய
chelavitapadum	செலவிடப்படும்	செய்திருக்கும்
chelavitappadum	செலவிடப்படும்	செய்த்துக்கும்
selavidappadum	செலவிடப்படும்	செய்த்துக்கும்
selavitappatum	செலவிடப்படும்	செய்த்துக்கும்
cheluthi	செலுத்தி	சுர்விி
chelutthi	செலுத்தி	சுர்கியி
seluthi	செலுத்தி	சுர்விய
seluththi	செலுத்தி	சிர்வியை
selutthi	செலுத்தி	சுர்கியி
cheluthik	செலுத்திக்	பிர்சியில்
chelutthik	செலுத்திக்	பிருக்கில்
seluthik	செலுத்திக்	பிரிய்டர்
seluththik	செலுத்திக்	பிரிய்கால்
selutthik	செலுத்திக்	பிரிய்கில்
cheluthina	செலுத்தின	பிர்வியை
chelutthina	செலுத்தின	சுர்கத்தை
seluthina	செலுத்தின	பிர்வியை
seluththina	செலுத்தின	பிரிம்பிய
selutthina	செலுத்தின	பிரும்பி
cheluthinar	செலுத்தினார்	பிருவத்தில்
chelutthinaar	செலுத்தினார்	செய்கிறார்
seluthinaar	செலுத்தினார்	செய்கிறார்
seluththinaar	செலுத்தினார்	செய்கிர்கள்
selutthinaar	செலுத்தினார்	செய்கிர்கள்
segarippil	சேகரிப்பில்	சிர்க்கியின்
sekarippil	சேகரிப்பில்	சிர்க்கியின்
chaethamadainththu	சேதமடைந்து	பாட்டி்பட்டு
saethamadainththu	சேதமடைந்து	செல்கின்றது
sedhamadaindhu	சேதமடைந்து	பாட்டி்தது
sethamadaindhu	சேதமடைந்து	செல்கிறது
saeiyon	சேயோன்	சிரிட்
saeyaon	சேயோன்	சிரின்
saeyon	சேயோன்	சின்
seiyon	சேயோன்	சிரிட்
seyon	சேயோன்	சின்
cheri	சேரி	சிரி
saeri	சேரி	சிவி
saerkkaikkaana	சேர்க்கைக்கான	சிர்க்பாட்ட
serkkaikkaana	சேர்க்கைக்கான	செய்திர்காக
saerkkaikku	சேர்க்கைக்கு	செல்கிற்கு
serkkaikku	சேர்க்கைக்கு	செல்கிற்கு
saerkkaiyil	சேர்க்கையில்	செய்கிரியில்
serkkaiil	சேர்க்கையில்	செய்கிறார்
serkkaiyil	சேர்க்கையில்	செய்கிரியல்
saerkkaiyum	சேர்க்கையும்	செய்கிறார்
serkkaium	சேர்க்கையும்	செய்கிறார்
serkkaiyum	சேர்க்கையும்	செய்கிறார்
saerththu	சேர்த்து	சிர்ந்து
serththu	சேர்த்து	சிர்ந்து
saerththuk	சேர்த்துக்	சிர்க்கும்
serththuk	சேர்த்துக்	சிர்க்கும்
saerththukkondaar	சேர்த்துக்கொண்டார்	சிர்த்துக்கார்
serththukkondaar	சேர்த்துக்கொண்டார்	சிர்த்துக்கார்
saerththukkolvathan	சேர்த்துக்கொள்வதன்	சிர்த்துக்களில்
serththukkolvathan	சேர்த்துக்கொள்வதன்	சிர்த்துக்களில்
saerththuth	சேர்த்துத்	செய்கிறார்
serththuth	சேர்த்துத்	செய்கிறார்
saerththup	சேர்த்துப்	சிர்க்கும்
serththup	சேர்த்துப்	சிர்க்கும்
chervai	சேர்வை	சுத்தை
saervai	சேர்வை	சுத்தை
servai	சேர்வை	சுத்தை
saigaigalai	சைகைகளை	பாருகளை
saigaikalai	சைகைகளை	பாருகளை
saikaigalai	சைகைகளை	சுத்தைய
saikaikalai	சைகைகளை	சுத்தைய
cibar	சைபர்	சேர்
cibarr	சைபர்	பிரான்
ciber	சைபர்	சேரர்
ciberr	சைபர்	பிரான்
cipher	சைபர்	சிர்க்
cybar	சைபர்	சார்
cyber	சைபர்	சேரர்
cyfer	சைபர்	பிரால்
cyphar	சைபர்	சில்ல்
cypher	சைபர்	சில்ல்
saibar	சைபர்	சேர்
sibar	சைபர்	சிய்க்
siber	சைபர்	சிச்யம்
syber	சைபர்	சிச்யம்
saivaththin	சைவத்தின்	சார்டியின்
saivar	சைவர்	சேரர்
sombu	சொம்பு	சுந்து
sompu	சொம்பு	சிற்கு
chori	சொறி	சாமி
sori	சொறி	சாமி
chorpolivu	சொற்பொழிவு	சிர்த்துக
sorpolivu	சொற்பொழிவு	சிர்த்துக
sorpozhivu	சொற்பொழிவு	சிர்த்துக
chorpolivukalai	சொற்பொழிவுகளை	சிற்றுக்கையை
sorpolivugalai	சொற்பொழிவுகளை	செய்துக்கையை
sorpolivukalai	சொற்பொழிவுகளை	சிற்றுக்கையை
sorpolzhivugalai	சொற்பொழிவுகளை	சுற்குக்கையை
chorpolivukal	சொற்பொழிவுகள்	சிற்கின்றார்
sorpolivugal	சொற்பொழிவுகள்	செய்திர்கள்
sorpolivukal	சொற்பொழிவுகள்	சிற்றி்திலம்
sorpozhivugal	சொற்பொழிவுகள்	செய்திர்கள்
cholana	சொல்லான	சாதா
chollaana	சொல்லான	சுத்தா
sollaana	சொல்லான	சுத்தா
chollu	சொல்லு	சார்
sollu	சொல்லு	சார்
chollukkup	சொல்லுக்குப்	செய்கின்றும்
cholukup	சொல்லுக்குப்	செல்க்ும்
sollukkup	சொல்லுக்குப்	செய்கின்றும்
solluvar	சொல்லுவர்	பார்சிகம்
cholvar	சொல்வர்	சார்டர்
solvar	சொல்வர்	சார்டர்
cholvaar	சொல்வார்	செய்கால்
cholvar	சொல்வார்	சார்டர்
solvaar	சொல்வார்	செய்கார்
solvar	சொல்வார்	சார்டர்
soasalisap	சோசலிசப்	பிர்சியி்
socialisap	சோசலிசப்	பிரிப்டின்
sosalisap	சோசலிசப்	பிர்சியி்
shocialishm	சோசலிசம்	பிர்சியர்
soasalisam	சோசலிசம்	பிரியார்
socialeesm	சோசலிசம்	பிரிப்டர்
socialiism	சோசலிசம்	பிரிப்பி்
socialism	சோசலிசம்	பிரிப்டர்
soocialeesm	சோசலிசம்	பிரிப்டர்
soocialism	சோசலிசம்	பிரிப்டர்
sosalisam	சோசலிசம்	பிரியார்
soadi	சோடி	சுவி
sodi	சோடி	சாமி
choathikka	சோதிக்க	சுர்ந்த
soathikka	சோதிக்க	சிர்த்த
sothikka	சோதிக்க	சிர்த்த
chooppup	சோப்புப்	சிர்க்கம்
soappup	சோப்புப்	சிர்க்கம்
sooppup	சோப்புப்	சிர்கம்
soppup	சோப்புப்	சிர்கம்
sopup	சோப்புப்	சிரம்
choayaa	சோயா	சாமா
soayaa	சோயா	சாயா
soi	சோயா	சி
soia	சோயா	சாயா
sooy	சோயா	பா
sooya	சோயா	சாயா
soy	சோயா	சே
soya	சோயா	சாயா
soyaa	சோயா	சாயா
choazharkalaal	சோழர்களால்	பார்டங்கள்
cholargalal	சோழர்களால்	சார்டங்கள்
chozharkalaal	சோழர்களால்	செய்கிறார்
soazhargalaal	சோழர்களால்	பார்டங்கள்
soazharkalaal	சோழர்களால்	சார்டங்கள்
solargalal	சோழர்களால்	சாத்தியார்
sozharkalaal	சோழர்களால்	சார்டங்கள்
choazharkalai	சோழர்களை	சுத்தியான
cholargalai	சோழர்களை	சுத்தியான
chozhargalai	சோழர்களை	சுத்தியான
soazhargalai	சோழர்களை	சுத்தியான
soazharkalai	சோழர்களை	சுத்தியான
sozharkalai	சோழர்களை	சுத்தியான
jajeera	ஜசீரா	ஜெய்யி
jazeara	ஜசீரா	ஜெய்யா
jazeera	ஜசீரா	ஜெய்யி
jaziira	ஜசீரா	ஜெய்யி
zazeera	ஜசீரா	ஜெய்யி
janadha	ஜனதா	ஜென்க
janadhaa	ஜனதா	ஜெய்யா
janata	ஜனதா	ஜென்ம
janataa	ஜனதா	ஜெய்யா
janatha	ஜனதா	திரா
janeta	ஜனதா	ஜோபா
janetaa	ஜனதா	ஜெய்வி
janta	ஜனதா	ஜெய்க
zanata	ஜனதா	ஜென்க
zanataa	ஜனதா	திரா
japaniya	ஜப்பானிய	ஜெய்வி
jappaaniya	ஜப்பானிய	ஜெய்விிய்
japaniyak	ஜப்பானியக்	ஜெய்வியல்
jappaaniyak	ஜப்பானியக்	ஜெய்வியில்
japaniyarkal	ஜப்பானியர்கள்	ஜெய்கிரியில்
jappaaniyargal	ஜப்பானியர்கள்	திரும்புகளில்
jappaaniyarkal	ஜப்பானியர்கள்	திரும்புகளில்
japanukku	ஜப்பானுக்கு	திரிக்கு
jappaanukku	ஜப்பானுக்கு	திரிக்போது
jameen	ஜமீன்	ஜோக்க்
jamuna	ஜமுனா	ஜெய்வா
jamunaa	ஜமுனா	ஜெய்வி
jamp	ஜம்ப்	ஜான்
jump	ஜம்ப்	ஜெல்
juump	ஜம்ப்	ஜெய்ட்
zump	ஜம்ப்	ஜெய்ட்
jaansan	ஜான்சன்	ஜெய்சி்
jaanson	ஜான்சன்	ஜெய்சன்
jhonsan	ஜான்சன்	ஜெய்சி்
jhonson	ஜான்சன்	ஜெய்சர்
johnson	ஜான்சன்	ஜெய்சின்
jecas	ஜீசஸ்	ஜோஸ்
jesus	ஜீசஸ்	ஜோஸ்
jesuus	ஜீசஸ்	ஜோனிஸ்
jiicas	ஜீசஸ்	ஜோஸ்
zesus	ஜீசஸ்	ஜோஸ்
jeeroa	ஜீரோ	ஜோகா
zeero	ஜீரோ	ஜோகா
zero	ஜீரோ	ஜோடா
jeevan	ஜீவன்	ஜோக்க்
joori	ஜூரி	ஜோடி
joory	ஜூரி	ஜாமி
juri	ஜூரி	ஜோடி
jurii	ஜூரி	ஜோடி
jury	ஜூரி	ஜோகி
juuri	ஜூரி	ஜோடி
juury	ஜூரி	ஜாமி
zoory	ஜூரி	ஜாமி
zuri	ஜூரி	ஜோடி
zury	ஜூரி	ஜோடி
jaenna	ஜென்னா	ஜோபா
jeina	ஜென்னா	ஜோகா
jena	ஜென்னா	ஜோகா
jenaa	ஜென்னா	ஜோகா
jenna	ஜென்னா	ஜோபா
jennaa	ஜென்னா	ஜெய்யி
jeyna	ஜென்னா	ஜோகி
zena	ஜென்னா	ஜோகா
zenna	ஜென்னா	ஜோபா
zennaa	ஜென்னா	ஜெய்வி
zeyna	ஜென்னா	ஜோகி
jaenni	ஜென்னி	ஜெய்யி
jannine	ஜென்னி	ஜெய்சி்
jeanie	ஜென்னி	ஜோகி
jeannie	ஜென்னி	ஜெய்சி
jenni	ஜென்னி	ஜெய்யி
jennie	ஜென்னி	ஜெய்சி
jennii	ஜென்னி	ஜெய்சி
jenny	ஜென்னி	ஜோபியா
jianine	ஜென்னி	ஜெய்சி்
jiannine	ஜென்னி	ஜெய்சின்
jyanine	ஜென்னி	ஜெய்சி்
jyannine	ஜென்னி	ஜெய்வின்
zeannie	ஜென்னி	ஜெய்சி
zenni	ஜென்னி	ஜெய்யி
zenny	ஜென்னி	ஜோபி
ziannine	ஜென்னி	ஜெய்சின்
zyannine	ஜென்னி	ஜெய்சின்
jaens	ஜென்ஸ்	ஜோஸ்
jains	ஜென்ஸ்	ஜோஸ்
jens	ஜென்ஸ்	ஜோஸ்
zains	ஜென்ஸ்	ஜோஸ்
zens	ஜென்ஸ்	ஜோன்ஸ்
jebam	ஜெபம்	ஜெய்கம்
jepam	ஜெபம்	ஜெய்கம்
jefersaun	ஜெபர்சன்	ஜெய்சியின்
jeferson	ஜெபர்சன்	ஜெய்சியின்
jeffarsaun	ஜெபர்சன்	ஜெக்கியின்
jeffarson	ஜெபர்சன்	ஜெய்சியின்
jeffersaun	ஜெபர்சன்	ஜெக்கியின்
jeffersauun	ஜெபர்சன்	ஜெக்கிரியன்
jefferson	ஜெபர்சன்	ஜெக்கியன்
jefpharson	ஜெபர்சன்	ஜெய்சியின்
jefpherson	ஜெபர்சன்	ஜெக்கியின்
jephpharson	ஜெபர்சன்	ஜெக்கியின்
jephphersaun	ஜெபர்சன்	ஜெக்கிரின்
jephpherson	ஜெபர்சன்	ஜெக்கியின்
zeffersaun	ஜெபர்சன்	ஜெக்கிரின்
zefferson	ஜெபர்சன்	ஜெக்கியின்
zefpherson	ஜெபர்சன்	ஜெக்கியின்
zephpharson	ஜெபர்சன்	ஜெக்கியின்
germaaniya	ஜெர்மானிய	கிரிவியாயி
germania	ஜெர்மானிய	கிரிசாமி
germaaniyap	ஜெர்மானியப்	கிரிப்பிின்
germaniyap	ஜெர்மானியப்	கிரிப்பில்
germaaniyarkal	ஜெர்மானியர்கள்	திரும்புகளில்
germaniyargal	ஜெர்மானியர்கள்	திரும்புகளில்
jami	ஜேமி	ஜோடி
jamie	ஜேமி	ஜோகி
jamiee	ஜேமி	ஜோகி
jamii	ஜேமி	ஜோடி
jamiie	ஜேமி	ஜோகி
jamy	ஜேமி	ஜோகி
jeemi	ஜேமி	ஜோடி
jeemiee	ஜேமி	ஜோகி
jemie	ஜேமி	ஜோகி
jemiie	ஜேமி	ஜோகி
zami	ஜேமி	ஜோடி
zamie	ஜேமி	ஜோனி
zamii	ஜேமி	ஜோனி
zamy	ஜேமி	ஜாமி
zemie	ஜேமி	ஜோனி
jioti	ஜோதி	ஜோடி
jooti	ஜோதி	ஜோடி
jothi	ஜோதி	ஜோடா
jyooti	ஜோதி	ஜெய்யி
jyoti	ஜோதி	ஜோடி
jyotii	ஜோதி	ஜோடி
zyoti	ஜோதி	ஜெய்யி
gnanashnaanam	ஞானஸ்நானம்	கிரிய்களால்
gnanasnaanam	ஞானஸ்நானம்	கிரிய்களர்
gnanasnanam	ஞானஸ்நானம்	கிரிய்களர்
taakshi	டாக்ஸி	விஜ்டி
taxi	டாக்ஸி	தேசி
daan	டான்	டின்
dain	டான்	டின்
dan	டான்	டான்
dann	டான்	டேட்
dayn	டான்	டின்
den	டான்	டின்
don	டான்	டின்
donn	டான்	டின்
taan	டான்	டான்
design	டிசைன்	டிஸ்ட்
disain	டிசைன்	டிரிஸ்
dear	டியர்	டேட்
der	டியர்	டேட்
diyar	டியர்	டில்
diram	டிராம்	டாம்
tiraam	டிராம்	திரம்
tirom	டிராம்	டியம்
traam	டிராம்	திரம்
tram	டிராம்	திரம்
trama	டிராம்	திரா
tirailar	டிரெய்லர்	திர்டர்
trailer	டிரெய்லர்	திர்டி்
daepiyan	டெபியன்	திர்டின்
deban	டெபியன்	தேசர்
debann	டெபியன்	டிர்ட்
debeean	டெபியன்	திரிட்
debeen	டெபியன்	திரிஸ்
debian	டெபியன்	டிரிஸ்
debiann	டெபியன்	டிரிஸ்
debiian	டெபியன்	டிரிட்ட்
debiyan	டெபியன்	திரியன்
delivery	டெலிவரி	திர்விி
telivari	டெலிவரி	திர்வியா
devil	டெவில்	தின்
daeni	டேனி	டெஸ்
danni	டேனி	தேவி
danny	டேனி	டெய்யி
dany	டேனி	டேவி
deeni	டேனி	டெஸ்
dison	டைசன்	டிஸ்ட்
tisan	டைசன்	டிஸ்ட்
tison	டைசன்	டிஸ்ட்
tyson	டைசன்	டிஸ்ஸ்
daiveng	டைவிங்	டெஸ்ட்
daivengg	டைவிங்	டிர்ட்ட்
daiving	டைவிங்	டெஸ்ட்
daiwengg	டைவிங்	டிர்ட்ட்
daiwing	டைவிங்	டெஸ்ட்
devengg	டைவிங்	டிர்ட்ட்
deving	டைவிங்	டெஸ்ட்
diving	டைவிங்	டிஸ்ட்
divingg	டைவிங்	டிஸ்டர்
diwing	டைவிங்	டெஸ்ட்
diwingg	டைவிங்	டிர்ட்ட்
druuman	ட்ரூமன்	திர்டர்
trooman	ட்ரூமன்	திர்டின்
trueman	ட்ரூமன்	திர்டின்
truman	ட்ரூமன்	திர்டர்
trumann	ட்ரூமன்	டிர்ட்ட்
truueman	ட்ரூமன்	திர்சியின்
truuman	ட்ரூமன்	திர்டி்
truumann	ட்ரூமன்	டிர்ட்டின்
driver	ட்ரைவர்	டிஸ்டர்
tarran	த	தாகில்
teran	த	தேசர்
terran	த	திரியன்
thagadugal	தகடுகள்	தலையைக்
thagadukal	தகடுகள்	தலையைக்
thakadukal	தகடுகள்	தலைகளைப்
thakatukal	தகடுகள்	தலைகளைப்
thanggi	தங்கி	தலிமை
thangi	தங்கி	தலையே
thangki	தங்கி	தா்்டி
thanki	தங்கி	தா்்டி
thanginar	தங்கினர்	தா்்களில்
thangkinar	தங்கினர்	தொட்களில்
thankinar	தங்கினர்	தா்்களில்
thanginaar	தங்கினார்	தொடுகளில்
thangkinaar	தங்கினார்	தொடுகளில்
thankinaar	தங்கினார்	தொட்களைப்
thangirukka	தங்கியிருக்க	தொடுகின்றன
thangiyirukka	தங்கியிருக்க	தொட்டுகின்றன
thangkiirukka	தங்கியிருக்க	தொடுகின்றன
thangkiyirrukka	தங்கியிருக்க	தொட்டுக்க்காக
thankiyirkka	தங்கியிருக்க	தொட்டி்களாக
thangiirukkum	தங்கியிருக்கும்	தொடுத்துகளும்
thangiyirukkum	தங்கியிருக்கும்	தொடுத்துக்கும்
thankiyirukkum	தங்கியிருக்கும்	தொட்டி்பட்டும்
thangiulla	தங்கியுள்ள	தொடுக்க்கா
thangiyulla	தங்கியுள்ள	தொட்்கின்றன
thankiyulla	தங்கியுள்ள	தொட்்பட்டன
dasaapdhangalaaga	தசாப்தங்களாக	திருவிக்காக
dasaapthangalaaga	தசாப்தங்களாக	திருவிக்காக
dasapthanggalaahga	தசாப்தங்களாக	திருவிக்காக
thasaapthangalaaga	தசாப்தங்களாக	திருவிக்காக
dasaapdhangalil	தசாப்தங்களில்	திருப்புகியில்
dasaapthangalil	தசாப்தங்களில்	திருப்புகியின்
dasapthanggalil	தசாப்தங்களில்	திரும்புகியின்
thasaapdhangalil	தசாப்தங்களில்	திருப்புகளின்
dasapthanggalukku	தசாப்தங்களுக்கு	திருவாக்கப்படும்
thasaapdhangalukku	தசாப்தங்களுக்கு	திர்க்கப்பட்டு
thasaapthankkalukku	தசாப்தங்களுக்கு	திருவாக்கப்படும்
thadangalai	தடங்களை	தலை்களை
thadanggalai	தடங்களை	தலை்கை
thadangkalai	தடங்களை	தலை்கைய
thadangal	தடங்கள்	தலையைப்
thadanggal	தடங்கள்	தலையைப்
thadangkal	தடங்கள்	தலையைப்
thaduththadhu	தடுத்தது	தடித்து
thaduththathu	தடுத்தது	தடித்தது
thaduththanar	தடுத்தனர்	தலைக்கால்
thaduththal	தடுத்தல்	தலைகளைப்
thadaigalaiyum	தடைகளையும்	தலை்களாலும்
thadaikalaiyum	தடைகளையும்	தலை்களாலும்
thadaikkalaiyum	தடைகளையும்	தொடுத்திரம்
thadaykalayyum	தடைகளையும்	தலை்களாகும்
thadaigal	தடைகள்	தலையில்
thadaikal	தடைகள்	தலையில்
thadaikkal	தடைகள்	தலைகளைப்
thadaygal	தடைகள்	தலையைப்
thadaykal	தடைகள்	தலையைப்
thadaich	தடைச்	தலை
thadaippattu	தடைப்பட்டு	தொடுக்ப்பு
thadaiyatrtra	தடையற்ற	தடுத்துக
thadaiyattra	தடையற்ற	தலைப்பாக
thadaiyaaga	தடையாக	தலையாக
thadaiyaaka	தடையாக	தலையாக
thadaiyaanadhu	தடையானது	தடித்து
thadaiyaanathu	தடையானது	தடித்து
thadaiyin	தடையின்	தலையின்
thadaiyaiyum	தடையையும்	தலை்களாம்
dhandanaigalaiyum	தண்டனைகளையும்	வழங்கு்திலும்
thandanaigalaium	தண்டனைகளையும்	தொடுத்துகள்
thandanaigalaiyum	தண்டனைகளையும்	தொடுத்துகள்
thandanaikalaiyum	தண்டனைகளையும்	தொடுத்துகள்
thandanaik	தண்டனைக்	தலைகளைப்
dhandanaikku	தண்டனைக்கு	தொடுக்க்கும்
thandanaikku	தண்டனைக்கு	தொடுக்க்கும்
dhandanaich	தண்டனைச்	நார்களின்
thandanaich	தண்டனைச்	தலைமையின்
dhandanaiyaaga	தண்டனையாக	தடு்பட்ட
thandanaiyaaga	தண்டனையாக	தலைவர்களாக
thandanaiyaaka	தண்டனையாக	தலைவர்களா
dhandanaiyum	தண்டனையும்	நாட்டுகள்
thandanaiyum	தண்டனையும்	தலை்களாலும்
dhandanaiyai	தண்டனையை	தலைமையை
thandanaiyai	தண்டனையை	தலைமையை
dhandi	தண்டி	தலிய
thandi	தண்டி	தலிய
thandil	தண்டில்	தலையின்
thandhiramaaga	தந்திரமாக	தொடுக்காக
thanthiramaaga	தந்திரமாக	தொடுக்காக
thanthiramaaka	தந்திரமாக	தொட்்களாக
thandhiram	தந்திரம்	தொட்களைப்
thanthiram	தந்திரம்	தொட்களைப்
thanakkulla	தனக்குள்ள	தடுத்துக்க
thanakkae	தனக்கே	தலைகளை
thankkae	தனக்கே	தலைமை
thanithanip	தனித்தனிப்	தலைமையின்
thaniththani	தனித்தனிப்	தாக்கியி
thaniththanip	தனித்தனிப்	தலைமையில்
thanithaniye	தனித்தனியே	தார்டிய
thaniththaniyae	தனித்தனியே	தமிழ்க்கை
thaniththaniye	தனித்தனியே	தமிழ்க்கி
thanithanmai	தனித்தன்மை	தலைமையை
thaniththanmai	தனித்தன்மை	தலைமைய்கை
thanithanmaiyai	தனித்தன்மையை	தலைமைய்கை
thaniththanmaiyai	தனித்தன்மையை	தொடுப்புகை
thanima	தனிம	தலை
thanimangal	தனிமங்கள்	தலைமையில்
thanimankal	தனிமங்கள்	தொடுகளில்
thanimam	தனிமம்	தலைம்
thanatchi	தன்னாட்சி	து்்விி
thannaatchi	தன்னாட்சி	தார்க்கியி
thanmaana	தன்மான	தா்்கா
tamilaga	தமிழக	தாலாமா
thamilaga	தமிழக	தாலாமா
thamilaka	தமிழக	தால்கா
thamizhaka	தமிழக	தன்்கா
tamilagach	தமிழகச்	தலையின்
thamizhakach	தமிழகச்	தலைகளின்
tamilagath	தமிழகத்	தலைகளை
thamizhakath	தமிழகத்	தலை்களைப்
tamilagaththin	தமிழகத்தின்	தாக்கி்தின்
thamizhakaththin	தமிழகத்தின்	தமிழ்க்கிின்
tamilagaththirku	தமிழகத்திற்கு	தொடுக்பட்டு
thamizhakaththirkku	தமிழகத்திற்கு	தொடுக்கப்பட்டு
thamizhakaththirku	தமிழகத்திற்கு	தொடுக்பட்டுக்க
tamilagaththil	தமிழகத்தில்	தாக்கத்தில்
tamilagatthil	தமிழகத்தில்	தொடுக்களின்
tamilakatthil	தமிழகத்தில்	தொட்க்கத்தில்
tamizhagatthil	தமிழகத்தில்	தொடுத்திரின்
tamizhakatthil	தமிழகத்தில்	தொழும்பிரில்
thamilagatthil	தமிழகத்தில்	தொடுக்களின்
thamilakatthil	தமிழகத்தில்	தொட்க்கத்தில்
thamizhagatthil	தமிழகத்தில்	தொடுத்திரின்
thamizhakaththil	தமிழகத்தில்	தொழும்பியில்
thamizhakatthil	தமிழகத்தில்	தொழும்பிரில்
tamilagaththudan	தமிழகத்துடன்	தலைப்புகளில்
tamilagatthudan	தமிழகத்துடன்	தொடுத்துகளில்
tamilakatthudan	தமிழகத்துடன்	தொடுத்துகளில்
tamizhagatthudan	தமிழகத்துடன்	தொடுத்துகளில்
tamizhakatthudan	தமிழகத்துடன்	தொடுத்துகளில்
thamilagatthudan	தமிழகத்துடன்	தொடுத்துகளில்
thamilakatthudan	தமிழகத்துடன்	தொடுத்துகளில்
thamizhagatthudan	தமிழகத்துடன்	தொடுத்துகளில்
thamizhakaththudan	தமிழகத்துடன்	தொடுத்துகளில்
thamizhakaththutan	தமிழகத்துடன்	தொடுத்துகளில்
thamizhakatthudan	தமிழகத்துடன்	தொடுத்துகளில்
tamilarinargal	தமிழறிஞர்கள்	தொடுத்துகளில்
tamilaringargal	தமிழறிஞர்கள்	தொடுக்குகியில்
thamizharingargal	தமிழறிஞர்கள்	தொடுத்துக்களின
thamizharingyargal	தமிழறிஞர்கள்	தொழில்துக்களின
thamizharingyarkal	தமிழறிஞர்கள்	தொழில்துக்களின
tamilai	தமிழை	து்ையை
tamizhai	தமிழை	தலைமை
thamilai	தமிழை	தலையை
thamizhai	தமிழை	தலைமை
tamilaip	தமிழைப்	தலையின்
tamizhaip	தமிழைப்	தலையில்
thamilaip	தமிழைப்	தலையில்
thamizhaip	தமிழைப்	தலையில்
tamilnadu	தமிழ்நாடு	தொடுக்து
tamilnatu	தமிழ்நாடு	தொடுக்துக்
thamilnaatu	தமிழ்நாடு	தொடுக்துக
thamilnatu	தமிழ்நாடு	தொடுக்துக்
thamizhnaadu	தமிழ்நாடு	தொடுக்து
tamilnadum	தமிழ்நாடும்	தொடுக்கும்
thamilnaadum	தமிழ்நாடும்	தொடுக்கார்
thamilnadum	தமிழ்நாடும்	தொடுக்கும்
thamizhnaadum	தமிழ்நாடும்	தொடுக்கும்
thambadhigalin	தம்பதிகளின்	தாக்கி்தில்
thambathigalin	தம்பதிகளின்	தொழும்பியில்
thambathikalin	தம்பதிகளின்	தொழும்பியில்
thampathikalin	தம்பதிகளின்	தொழும்பியில்
thambadhiyinarin	தம்பதியினரின்	தொழ்ல்க்கிின்
thambathiyinarin	தம்பதியினரின்	தொழில்க்கியின்
thambadhiyin	தம்பதியின்	தாக்கியின்
thambathiyin	தம்பதியின்	தாக்கிரியின்
tayaaraana	தயாரான	தொட்கான
thayaaraana	தயாரான	தா்்கா
thayarana	தயாரான	தா்கை
thayaarippaana	தயாரிப்பான	தொடுக்காாக
thayaarippaalarum	தயாரிப்பாளரும்	தொடுத்துகள்
thayaarippaazharum	தயாரிப்பாளரும்	தொடுத்துகள்
dhayaazh	தயாள்	தலை
thayaal	தயாள்	தாலல்
thayal	தயாள்	தால்
mudiyumaa	தர	முற்கான
mutiyuma	தர	முற்றான
tarathai	தரத்தை	தலையே
tharathai	தரத்தை	தலையை
tharaththai	தரத்தை	தலைகளை
tharatthai	தரத்தை	தலைகளை
taratthaiyum	தரத்தையும்	தொடுக்கார்
tharathaiyum	தரத்தையும்	தலை்களாம்
tharaththaiyum	தரத்தையும்	தலை்களாலும்
tharatthaiyum	தரத்தையும்	தலை்களாலும்
tarappil	தரப்பில்	தா்்களின்
tharapil	தரப்பில்	தலையின்
tharappil	தரப்பில்	தலைகளின்
tharavarisai	தரவரிசை	துர்விி
tharavalladhu	தரவல்லது	தடித்து
tharavallathu	தரவல்லது	தடித்தது
tharavugalaich	தரவுகளைச்	தலைமையில்
tharavukalaich	தரவுகளைச்	தலைமையில்
tharavugalaip	தரவுகளைப்	தலைகளில்
tarunatthil	தருணத்தில்	வடிக்களில்
tharunathil	தருணத்தில்	தலைகளின்
tharunaththil	தருணத்தில்	தலைமையில்
tharunatthil	தருணத்தில்	தலைமையில்
dharun	தருண்	தால்
tarun	தருண்	தால்
tharun	தருண்	தால்
dharumi	தருமி	தலையே
tharumi	தருமி	தலையே
tharum	தரும்	தாகம்
dharmapuriyil	தர்மபுரியில்	தொழ்ல்க்கிின்
thalaimaiyaetru	தலைமையேற்று	தொடுகின்றன
thalaimaiyetru	தலைமையேற்று	தொடுகின்றன
thalaimaiyettru	தலைமையேற்று	தொடுகின்றன
talaivanin	தலைவனின்	தலையின்
thalaivanin	தலைவனின்	தலையின்
talaivaraavaar	தலைவராவார்	தலை்களால்
thalaivaraavaar	தலைவராவார்	தலை்களால்
thalaivaravaar	தலைவராவார்	தலை்களால்
talaivarukku	தலைவருக்கு	தொடுக்க்கும்
thalaivarukku	தலைவருக்கு	தொடுக்க்கும்
thalaivali	தலைவலி	தலையிலை
thalaththirku	தளத்திற்கு	தொடுக்குும்
thalatthirku	தளத்திற்கு	தொடுக்குும்
thalaththilirunthu	தளத்திலிருந்து	தொடுக்கப்பட்டு
thalatthilirunthu	தளத்திலிருந்து	தொடுக்கப்பட்டு
thalaththilum	தளத்திலும்	தலை்களாகும்
thalatthilum	தளத்திலும்	தலை்களாகும்
thalap	தளப்	தால்
thalamaana	தளமான	தலைமை
thalavaadangalai	தளவாடங்களை	தலைமைய்கை
thalavaadangalay	தளவாடங்களை	தலைமைய்கை
thalavaadangkalai	தளவாடங்களை	தலைமைய்கை
thalavaadankalai	தளவாடங்களை	தலைமைய்கை
thalavaatankalay	தளவாடங்களை	தலைமைய்கை
thaviththa	தவித்த	தன்்காக
thavittha	தவித்த	தன்த்த
thaakku	தாக்கு	தொட்டு
thaadhukkal	தாதுக்கள்	தொடுகளில்
thaathukkal	தாதுக்கள்	தொடுகளில்
thaadhuvai	தாதுவை	தா்்கை
thaathuvai	தாதுவை	தா்்கை
thaano	தானோ	தேசா
thaamira	தாமிர	தாரா
thamira	தாமிர	தாலா
thaamae	தாமே	தேரா
thaame	தாமே	டாய்
thaamey	தாமே	தேசி
dam	தாம்	டாம்
dhaam	தாம்	டாம்
thaam	தாம்	தாம்
tambaram	தாம்பரம்	தொட்களாம்
thaambaram	தாம்பரம்	தொட்களால்
thaayaga	தாயக	தாலா
thayaga	தாயக	தாலா
thaayagathil	தாயகத்தில்	தா்்களின்
thaayagaththil	தாயகத்தில்	தாக்களில்
thaayagap	தாயகப்	தலையம்
thaayagam	தாயகம்	தாலம்
thaayumaanavar	தாயுமானவர்	தொட்களைய்
thayumanavar	தாயுமானவர்	தா்்கள்
taali	தாலி	தேசி
taalii	தாலி	தேசி
tali	தாலி	தானி
talii	தாலி	தா்ி
thaali	தாலி	தேசி
thaaliyai	தாலியை	தா்்கி
thaal	தாழ்	தால்
thaazh	தாழ்	தான்
thikaar	திகார்	டிலியர்
tihar	திகார்	டிக்
thittamidaludan	திட்டமிடலுடன்	திரும்புகளில்
thittamiduthal	திட்டமிடுதல்	திரும்புகளில்
thinnanaar	திண்ணனார்	திரியாகப்
deen	தின்	டின்
dhin	தின்	டின்
diin	தின்	டிஸ்
din	தின்	டின்
dyn	தின்	டின்
thin	தின்	டின்
tin	தின்	டின்
thinnum	தின்னும்	திரிகும்
dmkvil	திமுகவில்	ஜெய்சியின்
thimukavil	திமுகவில்	திருக்கில்
temoorr	திமோர்	டிச்சர்
temor	திமோர்	டில்
temorr	திமோர்	டிச்கர்
timoor	திமோர்	டிச்கர்
timoorr	திமோர்	டிச்சர்
timor	திமோர்	டில்ல்
timorr	திமோர்	டிச்கர்
tymoor	திமோர்	டிச்கர்
tymor	திமோர்	டிச்யம்
thiyaagaraajarin	தியாகராஜரின்	விரிப்பிட்ட்
thiyaakaraajarin	தியாகராஜரின்	விரிப்பிட்ட்
thiyagarajarin	தியாகராஜரின்	விரிப்பிட்
thyaagarajarin	தியாகராஜரின்	திரிப்பிட்
thiyaagaraajaa	தியாகராஜா	திர்வியா
thiyaakaraaja	தியாகராஜா	திர்வியா
thiyaakaraajaa	தியாகராஜா	திர்வியை
thiyakaraja	தியாகராஜா	திர்சிய
tiyaakaraaja	தியாகராஜா	திர்வியா
thirumulukkup	திருமுழுக்குப்	திரும்புகளும்
thirumulukup	திருமுழுக்குப்	திருவிக்கார்
tirumulukkup	திருமுழுக்குப்	திரும்புகளும்
thirumoorthi	திருமூர்த்தி	திரும்பியா
thirumoorththi	திருமூர்த்தி	திரும்ப்டி
thirumuurtthi	திருமூர்த்தி	திரும்ப்பி
tiruumrthi	திருமூர்த்தி	திரும்பிய
thiruvadi	திருவடி	திர்விி
thiruvati	திருவடி	திர்விிய
thiruvadikalai	திருவடிகளை	திருவங்களை
thiruvatikalai	திருவடிகளை	திருவங்களை
tiruvatikalai	திருவடிகளை	திருவங்களை
thiruvarangkaththil	திருவரங்கத்தில்	திருப்புக்கிின்
thiruvarankkaththil	திருவரங்கத்தில்	திருந்துக்களின்
thiruvarangan	திருவரங்கன்	திருவத்தில்
thiruvarangkan	திருவரங்கன்	திருப்பியல்
thiruvarankan	திருவரங்கன்	திருவத்தில்
tiruvarankan	திருவரங்கன்	திருவத்தில்
maraivil	திரை	மா்்கில்
thiraikalil	திரைகளில்	தார்களின்
tiraikalil	திரைகளில்	திருகளின்
thiraikal	திரைகள்	திர்கள்
tiraikal	திரைகள்	திர்கள்
thiraiyil	திரையில்	திர்டின்
tiraiyil	திரையில்	திர்டின்
thiraiyum	திரையும்	திரிக்கம்
tiraiyum	திரையும்	திரிகம்
thiraiyai	திரையை	திர்யா
tiraiyai	திரையை	திர்யா
thiranaal	திறனால்	திர்கள்
thiranukku	திறனுக்கு	திரிக்குு
thiranudan	திறனுடன்	திருக்கள்
thirangalai	திறன்களை	திருவதை
thirankalai	திறன்களை	திருவதை
divakar	திவாகர்	தேர்கர்
diwakar	திவாகர்	தேர்கர்
thivaakar	திவாகர்	தேர்கள்
deevan	திவான்	தேசர்
deewan	திவான்	தேசன்
diiwan	திவான்	டிரின்
divaan	திவான்	டிச்்
divan	திவான்	டிரின்
divann	திவான்	டிர்ட்
diwaan	திவான்	டிரின்
diwan	திவான்	டிரின்
diwann	திவான்	டிர்ட்
thivaan	திவான்	டிரின்
tivan	திவான்	டிரின்
theetchithar	தீட்சிதர்	திரியியில்
thidshithar	தீட்சிதர்	திர்சியர்
theendaamaikku	தீண்டாமைக்கு	திருப்பிற்கு
theeba	தீப	தே
theepa	தீப	தேசா
deepath	தீபத்	திர்
dheepath	தீபத்	திர்
theepath	தீபத்	திர்ட்
deepa	தீபா	தே
deepaa	தீபா	தேசா
dheepa	தீபா	தேசா
dheepaa	தீபா	தேசா
diipa	தீபா	டியா
diipaa	தீபா	தேசா
dipa	தீபா	டியா
dipaa	தீபா	டியா
theepaa	தீபா	தேசா
tiipa	தீபா	ஜோகா
theepparri	தீப்பற்றி	திர்விிய்
theeppatri	தீப்பற்றி	திரும்பியா
theeppattri	தீப்பற்றி	திரும்பியா
theeparrik	தீப்பற்றிக்	டிர்சியின்
theepattrik	தீப்பற்றிக்	திரும்பின்
theeppatrik	தீப்பற்றிக்	திருப்பியின்
dheergadarisigal	தீர்க்கதரிசிகள்	திரும்புகளின்
theerkkatharisikal	தீர்க்கதரிசிகள்	திருப்புக்களின்
theerppadhil	தீர்ப்பதில்	திருவத்தில்
theerppathil	தீர்ப்பதில்	திருவத்தில்
theerppadhu	தீர்ப்பது	திரிந்தது
theerppathu	தீர்ப்பது	திரிவதறது
theerppil	தீர்ப்பில்	திருக்கில்
theerppai	தீர்ப்பை	திருவியை
theermaaniththadhu	தீர்மானித்தது	திரிவிகிறது
theermaaniththathu	தீர்மானித்தது	திரிவிகிறது
theermaaniththaar	தீர்மானித்தார்	திரும்புகள்
theermaaniththu	தீர்மானித்து	திரிவிறது
theervaaga	தீர்வாக	திருத்த
theervaaka	தீர்வாக	திருமாக
theevana	தீவன	திரா
theevanaththil	தீவனத்தில்	திருக்கள்
theevaththil	தீவனத்தில்	திருக்கில்
theevanam	தீவனம்	திராம்
theeviravaadhi	தீவிரவாதி	திரும்பி
theeviravaathi	தீவிரவாதி	திரும்பி
theeviravaadhigalaal	தீவிரவாதிகளால்	திரும்புகளில்
theeviravaathigalaal	தீவிரவாதிகளால்	திரும்புகளில்
theeviravaathigazhaal	தீவிரவாதிகளால்	திரும்புகளில்
theeviravaathikalaal	தீவிரவாதிகளால்	திருப்புகளில்
theeviravaadhigalin	தீவிரவாதிகளின்	திருப்பத்தின்
theeviravaathigalin	தீவிரவாதிகளின்	திரும்ப்டியின்
theeviravaathigazhin	தீவிரவாதிகளின்	திரும்ப்டியின்
theeviravaathikalin	தீவிரவாதிகளின்	திருப்பத்தின்
theeviravaathigalay	தீவிரவாதிகளை	திருப்புகளை
theeviravaathigazhai	தீவிரவாதிகளை	திருவ்துகளை
theeviravaathikalai	தீவிரவாதிகளை	திருவாட்டையை
theeviravaathikalay	தீவிரவாதிகளை	திருப்புகளை
theeviravaathigal	தீவிரவாதிகள்	திரும்புகளில்
theeviravaathikal	தீவிரவாதிகள்	திரும்புகளில்
theeviravaadhiyaaga	தீவிரவாதியாக	திருவிக்கான
theeviravaathiyaaga	தீவிரவாதியாக	திருவிக்காக
theeviravaathiyaaka	தீவிரவாதியாக	திருவிக்காக
thundaaga	துண்டாக	தொட்காக
thundaaka	துண்டாக	தொட்காக
thundai	துண்டை	தா்்கை
thunburuthalil	துன்புறுத்தலில்	தொட்ட்க்கியின்
thunburuththalil	துன்புறுத்தலில்	தொழில்க்கத்தில்
thunpuruththalil	துன்புறுத்தலில்	தொழில்க்கத்தின்
thunburuththum	துன்புறுத்தும்	தொட்டி்களாலும்
thunburuthum	துன்புறுத்தும்	தொட்டி்களும்
thunpuruththum	துன்புறுத்தும்	தொட்டி்களாலும்
tumi	துமி	காமி
tumii	துமி	தானி
tuumi	துமி	தேசி
thuruva	துருவ	தாராக
thuruvangalil	துருவங்களில்	தொட்க்கையில்
thuruvangal	துருவங்கள்	தொட்டுகளில்
thuruvaththil	துருவத்தில்	தொட்கத்தில்
thuruvap	துருவப்	தா்்கம்
dhroanarin	துரோணரின்	திர்ட்டி்
dronarin	துரோணரின்	திர்ட்டி்
thuronarin	துரோணரின்	தான்சியின்
thuravigalum	துறவிகளும்	தொடுக்கார்
thuravikalum	துறவிகளும்	தொட்டுக்கம்
thuravikku	துறவிக்கு	தொடுக்குும்
thuraviyaaga	துறவியாக	தொட்்காக
thuraviyaaka	துறவியாக	தொட்்காக
thuraviyaana	துறவியான	தொட்களை
thuraikku	துறைக்கு	தன்ற்கு
thulaigalil	துளைகளில்	தா்்களின்
thulaikalil	துளைகளில்	தா்்களின்
thuvakka	துவக்க	தன்்காக
thuvakkap	துவக்கப்	தொடுகளால்
thuvakkappatta	துவக்கப்பட்ட	தொடுக்கின்றன
thuvakkiya	துவக்கிய	துரும்பி
thuvanga	துவங்க	தன்தாக
thuvangga	துவங்க	தொட்காக
thuvangka	துவங்க	தொட்காக
thuvangapatu	துவங்கப்பட்டு	தொடுகின்றன
thuvangappattu	துவங்கப்பட்டு	தொடுக்பட்டுக்க
thuvanggappattu	துவங்கப்பட்டு	தொடுக்பட்டுக்க
thuvangkappattu	துவங்கப்பட்டு	தொடுக்பட்த்து
thuvanggum	துவங்கும்	தொட்களும்
thuvangkum	துவங்கும்	தொட்களும்
thuvangum	துவங்கும்	தொட்களும்
thuvangguvatharku	துவங்குவதற்கு	தொடுக்பட்டுக்க
thuvangkuvatharku	துவங்குவதற்கு	தொட்டுக்கிற்கு
thuvanguvatharku	துவங்குவதற்கு	தொடுக்பட்டுக்க
dvaitham	துவைதம்	திர்கம்
thuvaitham	துவைதம்	தா்்கம்
thwaytham	துவைதம்	திட்டும்
thoodhuvar	தூதுவர்	தா்்கள்
thoothuvar	தூதுவர்	தாட்டார்
thoothuvargal	தூதுவர்கள்	தொடு்களில்
thoothuvarkal	தூதுவர்கள்	தொட்டங்கள்
thoorvaari	தூர்வாரி	தொட்டியி
thenasia	தென்னாசிய	தெர்சி
thennaasiya	தென்னாசிய	திர்வியி
therkil	தெற்கில்	திர்டின்
therkkil	தெற்கில்	திருக்கில்
therkae	தெற்கே	திராயா
therke	தெற்கே	திராஜி
therkke	தெற்கே	திர்விி
thelivatra	தெளிவற்ற	திருவியாக
dhegathil	தேகத்தில்	தாட்டின்
thaegaththil	தேகத்தில்	தா்்கிின்
thaekaththil	தேகத்தில்	தா்்கிின்
thaekkam	தேக்கம்	தேவரம்
thekkam	தேக்கம்	திர்கம்
thaekku	தேக்கு	திற்கு
thekku	தேக்கு	திர்கு
thaekkum	தேக்கும்	தொட்டும்
thekkum	தேக்கும்	திர்கும்
thaengaai	தேங்காய்	தா்்கை
thaenkaai	தேங்காய்	தொட்களை
thaenum	தேனும்	தாம்
thenum	தேனும்	திரம்
thaergal	தேர்கள்	தேவையள்
thaerkal	தேர்கள்	தேவையள்
therkal	தேர்கள்	திர்கள்
teerth	தேர்த்	திர்
thaerth	தேர்த்	தேர்
theerth	தேர்த்	தேர்
therth	தேர்த்	தேர்
thaernthaedukka	தேர்ந்தெடுக்க	திருவிக்கின்றன
thaernthedukka	தேர்ந்தெடுக்க	திருவிக்காக
thernthedukka	தேர்ந்தெடுக்க	திருவிக்காக
thaernthedukkappada	தேர்ந்தெடுக்கப்பட	திரைப்படு்களுக்கும்
thernthedukkappada	தேர்ந்தெடுக்கப்பட	திருவாக்கப்பட்டு
thaernthaedukkappadum	தேர்ந்தெடுக்கப்படும்	விளி்படுத்துக்கும்
thaernthedukkappadum	தேர்ந்தெடுக்கப்படும்	விளி்குகின்றனர்
thernthedukkappadum	தேர்ந்தெடுக்கப்படும்	விளி்குகின்றனர்
devaalayanggalil	தேவாலயங்களில்	திருப்புகளின்
devalayangalil	தேவாலயங்களில்	தொட்ட்கத்தில்
thevaalayangalil	தேவாலயங்களில்	தொட்ட்க்கியின்
thevaalayangkalil	தேவாலயங்களில்	திருப்புகளின்
devaalayangal	தேவாலயங்கள்	திருவங்கள்
devalayangal	தேவாலயங்கள்	திருவத்தார்
thevaalayangal	தேவாலயங்கள்	திருவங்கள்
thevaalayangkal	தேவாலயங்கள்	திருவங்களில்
devaalayaththin	தேவாலயத்தின்	திருக்கியின்
devalayaththin	தேவாலயத்தின்	திருக்கியின்
thevaalayaththin	தேவாலயத்தின்	திருக்கியின்
devaalayaththil	தேவாலயத்தில்	திருப்பியில்
devalayaththil	தேவாலயத்தில்	திருப்பியல்
thevaalayaththil	தேவாலயத்தில்	திருப்பதில்
devaalayaththai	தேவாலயத்தை	திருவத்தை
devalayaththai	தேவாலயத்தை	திருவதையை
thevaalayaththai	தேவாலயத்தை	திருவத்தை
thoguththal	தொகுத்தல்	தொட்களைப்
thoguththavar	தொகுத்தவர்	தொட்டுகள்
thoguththullaar	தொகுத்துள்ளார்	தொட்டுக்காலல்
thoguppinai	தொகுப்பினை	தொட்கத்தை
thokupinai	தொகுப்பினை	தொட்கதை
thokuppinai	தொகுப்பினை	தொட்கத்தை
thoguppai	தொகுப்பை	தொட்களை
thokupaip	தொகுப்பை	தொடுகளில்
thokuppai	தொகுப்பை	தொட்களை
thoguppaip	தொகுப்பைப்	தொட்களைப்
thokupaip	தொகுப்பைப்	தொடுகளில்
thokuppaip	தொகுப்பைப்	தொட்களைப்
thogai	தொகை	தேவை
thokai	தொகை	தேவை
tokai	தொகை	தேரா
thogaik	தொகைக்	தாகில்
thokaik	தொகைக்	தாகில்
tokaik	தொகைக்	தேவர்
thogaip	தொகைப்	தாக்
thokaip	தொகைப்	தாக்க்
tokaip	தொகைப்	தேடர்
thogaiyaaga	தொகையாக	தொட்காக
thokaiyaaka	தொகையாக	தொட்காக
thokaiyaka	தொகையாக	தொட்காக
thogaiyana	தொகையான	தொட்டை
thokaiyaana	தொகையான	தொட்களை
thokaiyana	தொகையான	தொட்கை
thogaiyil	தொகையில்	தா்்கில்
thokaiyil	தொகையில்	தா்்கில்
tokaiyil	தொகையில்	தாட்டின்
thogaiyudan	தொகையுடன்	திருக்கில்
thokaiyudan	தொகையுடன்	தொட்களில்
thokaiyutan	தொகையுடன்	தொட்களைப்
tokaiyutan	தொகையுடன்	திருக்கில்
thogaiyum	தொகையும்	திர்கும்
thokaiyum	தொகையும்	தொட்காம்
tokaiyum	தொகையும்	திர்கும்
thokaiyaich	தொகையைச்	தா்்டின்
tokaiyaich	தொகையைச்	தார்டின்
thokaiyaiyum	தொகையையும்	தொட்டுகள்
tokaiyaiyum	தொகையையும்	திருக்கும்
thodandhu	தொடந்து	தொடுத்து
thodanththu	தொடந்து	திருந்து
thotanthu	தொடந்து	திருந்து
totanthu	தொடந்து	திருந்து
thodarbaana	தொடர்பான	தொட்்கான
thodarpaana	தொடர்பான	தொட்்காான
thotarpaana	தொடர்பான	தொட்்காான
thotarpana	தொடர்பான	தொட்டுகான
thodarbaanathu	தொடர்பானது	திருகிறது
thodarpaanathu	தொடர்பானது	திருகிறது
thotarpaanathu	தொடர்பானது	திருகிறது
thotarpanathu	தொடர்பானது	திருகிறது
thodarbaanavai	தொடர்பானவை	தொட்கத்தை
thodarpaanavai	தொடர்பானவை	தொட்கத்தை
thotarpaanavai	தொடர்பானவை	தொட்கத்தை
thotarpanavai	தொடர்பானவை	திருவத்தை
thodarbu	தொடர்பு	தொடுக்கு
thodarpu	தொடர்பு	தொடுக்கு
thotarpu	தொடர்பு	தொடுக்கு
totarpu	தொடர்பு	தொடுக்கு
thodarbukalai	தொடர்புகளை	தொட்குகையை
thodarpukalai	தொடர்புகளை	திருவங்களை
thotarpukalai	தொடர்புகளை	திருவங்களை
totarpukalai	தொடர்புகளை	திருவங்களை
thodarbukalaip	தொடர்புகளைப்	தொட்ட்கத்தில்
thodarpukalaip	தொடர்புகளைப்	தொட்டங்களில்
thotarpukalaip	தொடர்புகளைப்	திருப்புகளில்
totarpukalaip	தொடர்புகளைப்	திருப்புகளில்
thodarbup	தொடர்புப்	தொடுக்கும்
thodarpup	தொடர்புப்	தொட்களாகும்
thodarbum	தொடர்பும்	தொட்களும்
thodarpum	தொடர்பும்	தொட்களும்
thoduthal	தொடுதல்	தா்்கள்
totuthal	தொடுதல்	தா்்கள்
thottuk	தொட்டுக்	தொட்கும்
thotuk	தொட்டுக்	தாலும்
thottum	தொட்டும்	தொட்டும்
thotum	தொட்டும்	தாகும்
tholaipaesigal	தொலைபேசிகள்	திருப்பத்தில்
tholaipesigal	தொலைபேசிகள்	திருப்பியல்
tholaipaesikku	தொலைபேசிக்கு	தொட்டி்பட்டு
tholaipesikku	தொலைபேசிக்கு	திருக்பட்டு
tholaipaesiyil	தொலைபேசியில்	தொட்ட்டிக்கின
tholaipesiyil	தொலைபேசியில்	திருப்பிடின்
tholiyal	தொல்லியல்	தா்்கள்
tholliyal	தொல்லியல்	தொட்களில்
tholilathibarai	தொழிலதிபரை	திருவங்களை
thozhilathibarai	தொழிலதிபரை	திருவங்களை
thozhilathiparai	தொழிலதிபரை	திருவங்களை
tholilum	தொழிலும்	திர்கும்
thozhilum	தொழிலும்	திர்கும்
tolilum	தொழிலும்	திர்கும்
tholilae	தொழிலே	துர்ய
tholile	தொழிலே	தேவி
tholilee	தொழிலே	தார்டி
thozhile	தொழிலே	தேவிய்
thoandappatta	தோண்டப்பட்ட	தொட்்பட்டாக
thondappatta	தோண்டப்பட்ட	தொட்்பட்டாக
thontapata	தோண்டப்பட்ட	தொட்்காக
thoontappatta	தோண்டப்பட்ட	தொட்டி்பட்ட
thoaththiram	தோத்திரம்	திருக்கம்
thootthiram	தோத்திரம்	திருக்கம்
thothiram	தோத்திரம்	தேவையம்
thoththiram	தோத்திரம்	திர்காலம்
thondriyadhaaga	தோன்றியதாக	தொட்ப்பாக
thondriyadhaaka	தோன்றியதாக	தொட்ப்படாக
thondriyathaaga	தோன்றியதாக	தொட்ப்படாக
thondriyathaaka	தோன்றியதாக	தொட்ப்பதாக
thontriyathaka	தோன்றியதாக	திருவியாாக
thoontriyathaaka	தோன்றியதாக	திருவிக்கா
thondriyadhu	தோன்றியது	திருந்தது
thondriyathu	தோன்றியது	திருகிறது
thontriyathu	தோன்றியது	திருந்தது
thoontriyathu	தோன்றியது	திருந்தது
thondriyadhai	தோன்றியதை	திருவதையை
thondriyathai	தோன்றியதை	திருவத்தை
thontriyathai	தோன்றியதை	திருவத்தை
thoontriyathai	தோன்றியதை	திருவத்தை
thondriyavar	தோன்றியவர்	தொட்டுகள்
thontriyavar	தோன்றியவர்	திருக்கார்
thoontriyavar	தோன்றியவர்	திருக்கார்
thondriyavai	தோன்றியவை	தொட்கதையை
thontriyavai	தோன்றியவை	திருவதை
thoontriyavai	தோன்றியவை	திருவதை
thoarum	தோறும்	திரும்
thaotrtru	தோற்று	திர்ந்து
thoarru	தோற்று	திர்கு
thoatrtru	தோற்று	திர்ந்து
thoatru	தோற்று	தொட்டு
thoattru	தோற்று	தொட்டு
thoarruvikkappadum	தோற்றுவிக்கப்படும்	விளி்குகின்றனர்
thoatruvikkappadum	தோற்றுவிக்கப்படும்	தொட்டுக்கின்றனர்
thoattruvikkappadum	தோற்றுவிக்கப்படும்	விளி்குகின்றனர்
thoarruvikkappatta	தோற்றுவிக்கப்பட்ட	தொட்டுக்கின்றன
thoatruvikkappatta	தோற்றுவிக்கப்பட்ட	தொட்டுக்கின்றன
thoattruvikkappatta	தோற்றுவிக்கப்பட்ட	தொட்டுக்கின்றன
thoarruvikkum	தோற்றுவிக்கும்	திருக்க்கும்
thoatruvikkum	தோற்றுவிக்கும்	தொட்டி்களும்
thoattruvikkum	தோற்றுவிக்கும்	திருக்குக்கும்
thoarruviththa	தோற்றுவித்த	திருவின்றன
thoatruviththa	தோற்றுவித்த	தொட்ப்பதாக
thoattruviththa	தோற்றுவித்த	திருகின்றன
thoarruviththathu	தோற்றுவித்தது	திருகின்றது
thoatruviththathu	தோற்றுவித்தது	திரைக்பட்டது
thoattruviththathu	தோற்றுவித்தது	திருகின்றது
thoalaal	தோலால்	தேவர்
thaan	தோல்வி	தான்
thoalvi	தோல்வி	தார்டி
tholvi	தோல்வி	தார்டி
thoolvi	தோல்வி	தார்டி
thoalvigalai	தோல்விகளை	தொட்கதையை
thoalvigazhai	தோல்விகளை	தொட்கதையை
tholvigalai	தோல்விகளை	தொட்கதையை
tholvikalai	தோல்விகளை	தொட்கதையை
thoolvikalai	தோல்விகளை	தொட்கதையை
thoalvigalaiyum	தோல்விகளையும்	தொட்டி்களும்
thoalvigazhaiyum	தோல்விகளையும்	தொட்டி்களும்
tholvigalayum	தோல்விகளையும்	திருக்காலம்
tholvikalaiyum	தோல்விகளையும்	திருப்புகள்
tholvikalayum	தோல்விகளையும்	திருக்குகம்
thoolvikalaiyum	தோல்விகளையும்	திருப்புகள்
thoalvigal	தோல்விகள்	தொட்களைப்
thoalvigazh	தோல்விகள்	தாக்கிின்
tholvigal	தோல்விகள்	தொட்களைப்
tholvikal	தோல்விகள்	தொட்களைப்
thoolvikal	தோல்விகள்	தொட்களைப்
thoalviyaal	தோல்வியால்	தொட்களைப்
thoalviyin	தோல்வியின்	தான்சியின்
thoalviyai	தோல்வியை	துர்விி
thriller	த்ரில்லர்	திர்சியர்
nadunilaimai	நடுநிலைமை	நட்்குகை
nadunilamai	நடுநிலைமை	நடிக்கைய
nadaipera	நடைபெற	நாட்கை
nadaiperakkoodiya	நடைபெறக்கூடிய	நாட்ட்க்களை
nadaiperath	நடைபெறத்	வழங்களைப்
nadiperath	நடைபெறத்	வழங்களில்
nadaiperavillai	நடைபெறவில்லை	வழங்குகத்தை
nadaiperrum	நடைபெறும்	வழி்களாகும்
nadaiperum	நடைபெறும்	வழி்களாம்
nadaiperumbodhu	நடைபெறும்போது	வழங்குகின்றன
nadaiperumpoadhu	நடைபெறும்போது	வழங்குகின்றன
nadaiperumpothu	நடைபெறும்போது	வழங்குகின்றன
nadaiperuvadharku	நடைபெறுவதற்கு	வழங்குகின்றன
nadaiperuvatharku	நடைபெறுவதற்கு	வழங்குகின்றன
nadaiperuvadhu	நடைபெறுவது	வழங்குகிறது
nadaiperuvathu	நடைபெறுவது	வழங்குகிறது
nadhigalin	நதிகளின்	வழங்கில்
nadhigazhin	நதிகளின்	வழங்கில்
nadhikalin	நதிகளின்	வழங்கில்
nathigalin	நதிகளின்	வழங்கில்
nadhigalil	நதிகளில்	வழங்களின்
nadhigazhil	நதிகளில்	வழங்களின்
nadhikalil	நதிகளில்	வழங்களின்
nathigalil	நதிகளில்	வழங்களின்
nathikalil	நதிகளில்	வழங்களின்
nadhigalukku	நதிகளுக்கு	வழங்களுக்கு
nadhigazhukku	நதிகளுக்கு	வழங்களுக்கு
nadhikalukku	நதிகளுக்கு	வழங்களுக்கு
nathigalukku	நதிகளுக்கு	வழங்களுக்கு
nadhigal	நதிகள்	நார்கள்
nadhikal	நதிகள்	நார்கள்
nathigal	நதிகள்	நார்கள்
nadhikku	நதிக்கு	வழிந்து
nathikku	நதிக்கு	வழிந்து
nadhiyaaga	நதியாக	நட்்கா
nadhiyaaka	நதியாக	நாட்டா
nathiyaaga	நதியாக	நடிகமான
nadhiyin	நதியின்	நார்டின்
nathiyin	நதியின்	நார்டின்
nadhiyum	நதியும்	நார்கம்
nathiyum	நதியும்	நார்கம்
nadhiyai	நதியை	நார்யை
nathiyai	நதியை	நார்யை
nanavili	நனவிலி	நார்டி
nanmaigalum	நன்மைகளும்	நடை்களாலும்
nanmaigazhum	நன்மைகளும்	வழி்களாகும்
nanmaikalum	நன்மைகளும்	வழி்களாலும்
nanmaigalaiyum	நன்மைகளையும்	வழங்கு்கள்
nanmaigazhaiyum	நன்மைகளையும்	வழங்கு்கள்
nanmaikalaiyum	நன்மைகளையும்	வழங்கு்களும்
nanmaiyin	நன்மையின்	வழங்களின்
nanmaiyum	நன்மையும்	வழி்களாம்
nanmaiyai	நன்மையை	நார்கையை
namo	நமோ	நாயா
namoa	நமோ	நாகா
narachimma	நரசிம்ம	நடை்காக
narasima	நரசிம்ம	நாராய
narasimma	நரசிம்ம	நாட்டாக
narachimmarin	நரசிம்மரின்	வட்டங்களின்
narasimarin	நரசிம்மரின்	வா்கத்தில்
narasimmarin	நரசிம்மரின்	வட்டங்களின்
narachimar	நரசிம்மர்	நா்்கள்
narachimmar	நரசிம்மர்	வழி்களால்
narasimhar	நரசிம்மர்	நா்்கள்
narasimmar	நரசிம்மர்	வழி்களால்
narambu	நரம்பு	வழிந்து
narampu	நரம்பு	வழிந்து
narambugalin	நரம்புகளின்	வட்டங்களில்
narambukalin	நரம்புகளின்	வட்டங்களின்
narampukalin	நரம்புகளின்	வட்டங்களில்
narambugalil	நரம்புகளில்	வடிப்பியல்
narambukalil	நரம்புகளில்	வடிப்பியல்
narampukalil	நரம்புகளில்	வடிப்பியல்
narambuth	நரம்புத்	வழி்கும்
naramputh	நரம்புத்	வழி்கும்
narmadhai	நர்மதை	வழி்கை
narmathai	நர்மதை	நாட்களை
nalappanigal	நலப்பணிகள்	வழிப்புகள்
nalappanikal	நலப்பணிகள்	வழங்குகள்
nalathu	நல்லது	நாட்டு
nallathu	நல்லது	வழிந்து
nalavan	நல்லவன்	நாரை
nallavan	நல்லவன்	நா்்கள்
raga	நவீன	ரா
raka	நவீன	ரா
naveenamaana	நவீனமான	நாட்கான
naagareega	நாகரீக	நார்கை
naagareegaththin	நாகரீகத்தின்	வாழ்க்களில்
naagarigaththin	நாகரீகத்தின்	வட்டங்களில்
naagareegam	நாகரீகம்	நார்கள்
naasaa	நாசா	வாயா
nasa	நாசா	நாயா
naashik	நாசிக்	நாட்ட்
naasik	நாசிக்	நாட்ட்
naasiq	நாசிக்	நாட்ட்
nashic	நாசிக்	நாரின்
nashik	நாசிக்	நாரில்
nasic	நாசிக்	நாரின்
nasik	நாசிக்	நாரின்
nasiq	நாசிக்	நாட்ட்
naisism	நாசிசம்	விசார்
naisismm	நாசிசம்	விச்சம்
najism	நாசிசம்	நார்டி
nasism	நாசிசம்	விஜயன்
nazism	நாசிசம்	நார்ட்
nesismm	நாசிசம்	விச்சிர்
naadodikal	நாடோடிகள்	வாட்களில்
naadoodikal	நாடோடிகள்	வாட்டியல்
nadoadigal	நாடோடிகள்	வழி்களில்
naattavar	நாட்டவர்	வா்்கள்
naattin	நாட்டின்	நார்டின்
naattiyam	நாட்டியம்	வாட்டாகல்
naathar	நாதர்	நாயல்
nathar	நாதர்	நாயம்
naangaam	நான்காம்	நார்கம்
naankaam	நான்காம்	நார்கம்
naatram	நாற்றம்	நாட்ட
naattram	நாற்றம்	வேட்டம்
naalanthaa	நாலந்தா	வழி்கான
naalanththaa	நாலந்தா	வழி்களை
nalanda	நாலந்தா	நட்்க
nalantha	நாலந்தா	நட்ட
naalo	நாளோ	நாயா
nallloa	நாளோ	நார்கை
nigalththappatta	நிகழ்த்தப்பட்ட	விளிய்கப்பட்ட
nigazhththappatta	நிகழ்த்தப்பட்ட	விளிய்கப்பட்ட
nikazhththappatta	நிகழ்த்தப்பட்ட	விளிய்கப்பட்ட
nigalththappattu	நிகழ்த்தப்பட்டு	விளி்கப்பட்டு
nigazhththappattu	நிகழ்த்தப்பட்டு	விளி்கப்பட்டு
nikazhththappattu	நிகழ்த்தப்பட்டு	விளி்கப்பட்டு
nigalththuvathu	நிகழ்த்துவது	விளிக்பதற்கு
nigazhththuvadhu	நிகழ்த்துவது	விளிக்பதற்கு
nigazhththuvathu	நிகழ்த்துவது	விளிக்பதற்கு
nikazhththuvathu	நிகழ்த்துவது	விளிக்பதற்கு
nigalvu	நிகழ்வு	விளையாகு
nigazhvu	நிகழ்வு	விருந்து
nikazhvu	நிகழ்வு	விருந்து
nigalvugalaaga	நிகழ்வுகளாக	நிகழ்ந்தாாக
nigazhvugalaaga	நிகழ்வுகளாக	விளிக்க்ாக
nigazhvugazhaaga	நிகழ்வுகளாக	விளிக்க்காக
nikazhvukalaaka	நிகழ்வுகளாக	விளிக்க்காக
nigalvugalilum	நிகழ்வுகளிலும்	விளையிடுக்கார்
nigazhvugalilum	நிகழ்வுகளிலும்	விள்விக்காகும்
nigazhvugazhilum	நிகழ்வுகளிலும்	விள்விக்காகும்
nikazhvukalilum	நிகழ்வுகளிலும்	விள்விக்காகும்
nigalvugalil	நிகழ்வுகளில்	விள்வி்களில்
nigazhvugalil	நிகழ்வுகளில்	விள்விக்கள்
nigazhvugazhil	நிகழ்வுகளில்	விள்வி்களில்
nikazhvukalil	நிகழ்வுகளில்	விள்விக்களில்
nigalvugalukku	நிகழ்வுகளுக்கு	விளி்குகின்றன
nigazhvugalukku	நிகழ்வுகளுக்கு	விளி்படுகிற்கு
nigazhvugazhukku	நிகழ்வுகளுக்கு	விளி்படுகின்றன
nikazhvukalukku	நிகழ்வுகளுக்கு	விளி்படுகின்றன
nigalvugalukkum	நிகழ்வுகளுக்கும்	விளி்குக்கார்
nigazhvugalukkum	நிகழ்வுகளுக்கும்	விளி்குக்கார்
nigazhvugazhukkum	நிகழ்வுகளுக்கும்	விளி்படுத்தார்
nikazhvukalukkum	நிகழ்வுகளுக்கும்	விளி்குக்கார்
nigalvugaludan	நிகழ்வுகளுடன்	விள்விக்களில்
nigazhvugaludan	நிகழ்வுகளுடன்	விள்விக்காலல்
nigazhvugazhudan	நிகழ்வுகளுடன்	விள்விட்டுகள்
nikazhvukaludan	நிகழ்வுகளுடன்	விள்விக்்களில்
nigalvugalum	நிகழ்வுகளும்	விளங்களாகும்
nigazhvugalum	நிகழ்வுகளும்	விளங்களாகும்
nigazhvugazhum	நிகழ்வுகளும்	விளங்களுக்கும்
nikazhvukalum	நிகழ்வுகளும்	விளிக்குகளும்
nigalvugalai	நிகழ்வுகளை	விளை்களையை
nigazhvugalai	நிகழ்வுகளை	விளை்களையை
nigazhvugazhai	நிகழ்வுகளை	விள்விக்கை
nikazhvukalai	நிகழ்வுகளை	விளைய்கையை
nigalvugalaich	நிகழ்வுகளைச்	நிறுப்பத்தில்
nigazhvugalaich	நிகழ்வுகளைச்	விள்விக்களை
nigazhvugazhaich	நிகழ்வுகளைச்	விள்விக்களை
nikazhvukalaich	நிகழ்வுகளைச்	விள்விக்களை
nigalvugal	நிகழ்வுகள்	விளங்களால்
nigazhvugal	நிகழ்வுகள்	விளங்களால்
nigazhvugazh	நிகழ்வுகள்	விளங்களைய
nikazhvukal	நிகழ்வுகள்	விளங்களால்
nigalvukku	நிகழ்வுக்கு	விளைக்பட்டு
nigazhvukku	நிகழ்வுக்கு	விளிக்ப்பு
nikazhvukku	நிகழ்வுக்கு	விளிக்ப்பு
nigalvukkup	நிகழ்வுக்குப்	விள்விக்கார்
nigazhvukkup	நிகழ்வுக்குப்	விள்விக்கார்
nikazhvukkup	நிகழ்வுக்குப்	விள்விக்கார்
nichayikapata	நிச்சயிக்கப்பட்ட	விருவிக்கா
nichchayikkappatta	நிச்சயிக்கப்பட்ட	விளிய்கப்பட்ட
neenja	நிஞ்ஜா	விஜ்யா
neenza	நிஞ்ஜா	விஜமா
niinja	நிஞ்ஜா	விஜ்யா
ninchjaa	நிஞ்ஜா	விஜ்வியா
ninja	நிஞ்ஜா	விஜ்யா
ninjaa	நிஞ்ஜா	விஜ்யா
ninza	நிஞ்ஜா	விஜ்யா
ninzaa	நிஞ்ஜா	விஜ்யா
nynjaa	நிஞ்ஜா	விஜ்யா
nynzaa	நிஞ்ஜா	விஜ்யா
ninaivaaga	நினைவாக	விருவாக
ninaivaaka	நினைவாக	விளையாக
ninaivvaaga	நினைவாக	நிகழ்ந்த
ninaivaagavae	நினைவாகவே	விளைய்கான
ninaivaagave	நினைவாகவே	நிகழ்த்தை
ninaivaakave	நினைவாகவே	நிகழ்தை
ninaivuchchinnam	நினைவுச்சின்னம்	விள்விக்காலம்
niyamana	நியமன	விஜமாக
niyamanathil	நியமனத்தில்	விட்டிகளில்
niyamanaththil	நியமனத்தில்	விளங்குகள்
niyamanatthil	நியமனத்தில்	விளங்குகள்
niyamikapadum	நியமிக்கப்படும்	விளங்களையும்
niyamikkappadum	நியமிக்கப்படும்	விளையாடுக்கார்
niyamikkappatum	நியமிக்கப்படும்	விளி்குக்கார்
niyamikavum	நியமிக்கவும்	விளங்களாலும்
niyamikkavum	நியமிக்கவும்	விளங்களாகும்
niyamikkum	நியமிக்கும்	விளை்களும்
niyamikum	நியமிக்கும்	விளை்கும்
nirai	நிரை	வேடி
nirvagikkappadum	நிர்வகிக்கப்படும்	விளி்குகின்றனர்
nirvakikkappadum	நிர்வகிக்கப்படும்	விளி்குகின்றனர்
nirvagikkappattu	நிர்வகிக்கப்பட்டு	விளி்கப்பட்டுள்ள
nirvakikkappattu	நிர்வகிக்கப்பட்டு	விளி்கப்பட்டுள்ள
nirvaagac	நிர்வாகச்	விளங்கள்
nirvaagach	நிர்வாகச்	விளைகளில்
nirvaagaththaal	நிர்வாகத்தால்	விள்விக்கார்
nirvaagaththin	நிர்வாகத்தின்	விள்வி்தியில்
nirvaakaththin	நிர்வாகத்தின்	விள்வி்தியில்
nirvaagaththirku	நிர்வாகத்திற்கு	விளி்குகின்றன
nirvaagaththai	நிர்வாகத்தை	விளைய்கையை
nirvaakaththai	நிர்வாகத்தை	விளைய்கையை
nirvaakatthai	நிர்வாகத்தை	விள்விக்கை
nirvakathai	நிர்வாகத்தை	விளை்களை
nirvaagaththaip	நிர்வாகத்தைப்	விள்விக்கால்
nirvaakaththaip	நிர்வாகத்தைப்	விள்விக்கால்
nirvaakatthaip	நிர்வாகத்தைப்	விள்விக்களர்
nirvakathaip	நிர்வாகத்தைப்	விளங்களில்
nirvaagam	நிர்வாகம்	விளையாகும்
nirvaakam	நிர்வாகம்	விளையாகும்
nirvakam	நிர்வாகம்	விட்டாகம்
nilath	நிலத்	வேட்
nilaththu	நிலத்து	விருந்து
nilathu	நிலத்து	விற்கு
nilatthu	நிலத்து	விருந்து
nilaparapai	நிலப்பரப்பை	விளை்களை
nilapparappai	நிலப்பரப்பை	விளைய்புகளை
nilainiluvaiyil	நிலுவையில்	விள்வி்களில்
niluvaiyil	நிலுவையில்	விட்டியில்
nilainiruththi	நிலைநிறுத்தி	விள்வி்க்தி
neengalum	நீங்களும்	விட்க்கும்
neengkalum	நீங்களும்	விளையாகும்
neengal	நீங்கள்	வேட்டர்
neengkal	நீங்கள்	வேட்டர்
neetti	நீட்டி	விஜயா
neerilivu	நீரிழிவு	விளை்க்க
neerizhivu	நீரிழிவு	நிருந்த
neeraetrtru	நீரேற்று	நிறையாக்கு
neeraetru	நீரேற்று	விளையாகு
neereatru	நீரேற்று	விளையாகு
neeraik	நீரைக்	நாட்ட்
neeroatta	நீரோட்ட	விளியாக
kneel	நீல்	கோரின்
neal	நீல்	வாட்
neel	நீல்	வேட்
neiil	நீல்	வேட்
neil	நீல்	வேட்
nel	நீல்	வேட்
niil	நீல்	வேட்
nulainthavudan	நுழைந்தவுடன்	வழங்கு்களில்
nuzhaindhavudan	நுழைந்தவுடன்	வழங்கு்களில்
nuzhinththavudan	நுழைந்தவுடன்	வேட்டங்களையும
nulainthu	நுழைந்து	வழிந்து
nuzhaindhu	நுழைந்து	வழிந்து
nuzhinththu	நுழைந்து	வாட்டிக்கு
noolagak	நூலகக்	நார்கம்
noolakak	நூலகக்	வா்்கம்
noolagangalai	நூலகங்களை	வாட்கத்தை
noolakangalai	நூலகங்களை	வாட்கத்தை
noolakangkalai	நூலகங்களை	வாட்கத்தை
noolangangkalai	நூலகங்களை	வாட்டுக்களை
noolagaththin	நூலகத்தின்	வாழ்க்களின்
noolakaththin	நூலகத்தின்	வாட்களில்
noolagaththukku	நூலகத்துக்கு	நாட்கின்றன
noolakaththukku	நூலகத்துக்கு	நாட்கின்றன
noolagamaaga	நூலகமாக	நாட்டாக
noolagamaaka	நூலகமாக	வாட்டாக
noolakamaaga	நூலகமாக	நாட்டாக
noolakamaaka	நூலகமாக	வேட்டாாக
noolagam	நூலகம்	நாயல்
noolakam	நூலகம்	வேடம்
noolagar	நூலகர்	நார்ட்
noolakar	நூலகர்	நார்ட்
noolaar	நூலார்	நாட்ட்
noolaal	நூலால்	நாட்ட்
noolilirundhu	நூலிலிருந்து	விளைவிருந்து
noolilirunthu	நூலிலிருந்து	வேட்டி்பட்டு
negili	நெகிழி	விஜயா
negizhi	நெகிழி	விஜ்யி
negizhyi	நெகிழி	விட்டி
nekili	நெகிழி	விஜ்யா
nediya	நெடிய	விஜ்யா
network	நெட்வொர்க்	நிர்சியி்
nedharlaandhu	நெதர்லாந்து	நிகழ்ந்தது
netharlaanthu	நெதர்லாந்து	நிகழ்ந்தது
netherlaanththu	நெதர்லாந்து	விளிக்பட்தது
netherland	நெதர்லாந்து	நிர்ட்டின்
netriyil	நெற்றியில்	விட்டியில்
nettriyil	நெற்றியில்	விட்டியில்
nel	நெல்	வேட்
nellai	நெல்லை	வாட்டி
nellaik	நெல்லைக்	வாட்டில்
nellaip	நெல்லைப்	நிக்கர்
naespid	நெஸ்பிட்	விட்டின்
nesbit	நெஸ்பிட்	விட்டின்
nesbitt	நெஸ்பிட்	விட்டிட்்
naethraa	நேத்ரா	வாக்கா
nethra	நேத்ரா	வேகா
neerittu	நேரிட்டு	நிறைய்து
nerittu	நேரிட்டு	நிறைய்து
neritu	நேரிட்டு	நிற்கு
naiirobii	நைரோபி	நார்கியா
nairobi	நைரோபி	நார்டி
nairoobi	நைரோபி	வாக்கி
nairoopi	நைரோபி	நார்சி
nerobi	நைரோபி	வாக்கி
nairobiyil	நைரோபியில்	வாட்டியில்
nairopiyil	நைரோபியில்	வாட்டியில்
nokich	நோக்கிச்	நாட்டி
nokkich	நோக்கிச்	நார்டின்
nookkich	நோக்கிச்	நார்டின்
nokin	நோக்கின்	நாட்ட்
nokkin	நோக்கின்	நார்டின்
nookkin	நோக்கின்	நார்டின்
nokiyum	நோக்கியும்	நிக்கம்
nokkiyum	நோக்கியும்	விளை்களும்
nookkiyum	நோக்கியும்	விளங்களாம்
nokilum	நோக்கிலும்	நிறையும்
nokkilum	நோக்கிலும்	விளை்களும்
nooyinaal	நோயினால்	நாட்டி்
noyinaal	நோயினால்	நாட்டி்
noyinal	நோயினால்	நாட்டர்
nooyuttra	நோயுற்ற	நாட்டாக
noyutra	நோயுற்ற	நாட்ட
noyuttra	நோயுற்ற	நாட்டாக
noaiththotrukal	நோய்த்தொற்றுகள்	வாட்ட்க்கிறார்
noayththotrugal	நோய்த்தொற்றுகள்	வாட்ட்க்கிறார்
noiththottrugal	நோய்த்தொற்றுகள்	விளைய்புகளில்
pagirnthuk	பகிர்ந்துக்	பட்்களும்
pakirnthuk	பகிர்ந்துக்	பாட்டிக்கும்
bhagujan	பகுஜன்	பாட்டி
pagujan	பகுஜன்	பாட்டி
pakujan	பகுஜன்	பாட்டி
paguthiyai	பகுதியை	படுத்தை
pakuthiyai	பகுதியை	படுத்தை
paguthiyaich	பகுதியைச்	பா்த்தி
pakuthiyaich	பகுதியைச்	பா்த்தி
paguthiyaip	பகுதியைப்	பட்டங்கள்
pakuthiyaip	பகுதியைப்	பட்டங்கள்
paagoda	பகோடா	பாரா
paagooda	பகோடா	பார்கா
pagoda	பகோடா	பாதா
pagodaa	பகோடா	பா்கா
pagooda	பகோடா	பாரா
pagoodaa	பகோடா	பா்ா
pagoovda	பகோடா	பா்்கா
pagoowda	பகோடா	பார்கா
pagovda	பகோடா	பா்தா
pagowda	பகோடா	பா்கா
paguda	பகோடா	பட்ட
pakoadaa	பகோடா	பா்கா
pakoda	பகோடா	பாரா
pakooda	பகோடா	பாரா
pakootaa	பகோடா	பாரா
pasukkalai	பசுக்களை	பாட்கதை
pasukkazhai	பசுக்களை	பாட்கதை
pasukkazhil	பசுக்களை	பா்்கியல்
padagai	படகை	பட்டை
padakai	படகை	பட்டை
padangalaaga	படங்களாக	படுத்தா
padangalaaka	படங்களாக	படுத்தா
padangkalaaka	படங்களாக	படுத்தா
padangalaana	படங்களான	படுத்தா
padangkalaana	படங்களான	படுத்தா
padangalil	படங்களில்	படுத்தில்
padangkalil	படங்களில்	படுத்தில்
pandangalil	படங்களில்	பட்டங்களில்
padangalukku	படங்களுக்கு	பட்டி்களும்
padangkalukku	படங்களுக்கு	பட்டி்களும்
padangalum	படங்களும்	படுத்தம்
padanggalum	படங்களும்	படுத்தார்
padappidippum	படப்பிடிப்பும்	பட்டி்திகள்
padarndha	படர்ந்த	பட்த்த
padarntha	படர்ந்த	பட்த்த
padalaththin	படலத்தின்	பா்த்தில்
padalaththai	படலத்தை	படுத்தை
padi	படி	பாரி
padigalil	படிகளில்	படுத்தில்
padikalil	படிகளில்	படுத்தில்
padigalum	படிகளும்	படுத்தம்
padikalum	படிகளும்	பட்டாகம்
padigalai	படிகளை	படுத்தை
padikalai	படிகளை	படுத்தை
padiththaal	படித்தால்	படுத்தார்
paditthaal	படித்தால்	படுத்தார்
padinilaigal	படிநிலைகள்	படுத்தியல்
padinilaikal	படிநிலைகள்	படுத்தில்
padinilaiyil	படிநிலையில்	பட்டங்களில்
padippadiyaana	படிப்படியான	பட்டுக்கையை
padipaip	படிப்பைப்	படுத்தில்
padippaip	படிப்பைப்	பட்டங்கள்
patippaip	படிப்பைப்	பட்டங்கள்
padimangal	படிமங்கள்	பட்டங்கள்
padimankal	படிமங்கள்	பட்டங்கள்
patimankal	படிமங்கள்	பட்டங்கள்
padimathai	படிமத்தை	படுத்தை
padimaththai	படிமத்தை	படுத்தை
padimatthai	படிமத்தை	படுத்தை
patimatthai	படிமத்தை	பாட்கதை
padiyilum	படியிலும்	பட்டாகம்
patiyilum	படியிலும்	பட்டாகம்
paduthoalvi	படுதோல்வி	பார்கத்தை
padutholvi	படுதோல்வி	பார்கத்தி
paduthoolvi	படுதோல்வி	பார்கத்தி
patuthoolvi	படுதோல்வி	பார்கத்தி
paduthik	படுத்திக்	படுத்தில்
paduththik	படுத்திக்	பட்டையில்
padutthik	படுத்திக்	பட்டியில்
patutthik	படுத்திக்	பாட்களின்
padaitha	படைத்த	பட்ட
padaiththa	படைத்த	பட்த்த
padaittha	படைத்த	பட்த்த
pataittha	படைத்த	பட்த்த
padaithathaga	படைத்ததாக	படுத்தா
padaithathaka	படைத்ததாக	படுத்தா
padaiththathaaga	படைத்ததாக	படுத்தாாக
padaiththathaaka	படைத்ததாக	பட்டி்காக
padaitthathaaka	படைத்ததாக	பட்டி்காக
pataitthathaaka	படைத்ததாக	பட்டி்காக
padaithal	படைத்தல்	படுத்தார்
padaiththal	படைத்தல்	படுத்தார்
padaitthal	படைத்தல்	படுத்தார்
pataitthal	படைத்தல்	படுத்தார்
padaithavan	படைத்தவன்	படுத்தில்
padaiththavan	படைத்தவன்	படுத்தில்
padaitthavan	படைத்தவன்	படுத்தில்
pataitthavan	படைத்தவன்	படுத்தில்
padaithar	படைத்தார்	பட்டார்
padaiththaar	படைத்தார்	பட்டாகம்
padaitthaar	படைத்தார்	பட்டாகம்
pataitthaar	படைத்தார்	பட்டாகம்
padaiththullathu	படைத்துள்ளது	பட்டி்பட்ட
padaithulathu	படைத்துள்ளது	பட்திருந்து
padaitthullathu	படைத்துள்ளது	பட்டி்பட்ட
pataitthullathu	படைத்துள்ளது	பட்டி்பட்ட
padaiththullaar	படைத்துள்ளார்	பட்டங்களையும்
padaithular	படைத்துள்ளார்	பட்டங்கள்
padaitthullaar	படைத்துள்ளார்	பட்டங்களையும்
pataitthullaar	படைத்துள்ளார்	பட்டங்களையும்
padaiyani	படையணி	பா்்கி
pataiyani	படையணி	பா்்கி
padaiyanigal	படையணிகள்	படுத்தில்
padaiyanikal	படையணிகள்	கொட்டங்கள்
pataiyanikal	படையணிகள்	படுத்தில்
padaiyinaraal	படையினரால்	கொட்டங்கள்
padaiyinaral	படையினரால்	கொட்டங்கள்
pataiyinaraal	படையினரால்	பட்டங்கள்
padaiyinarin	படையினரின்	பா்த்தில்
pataiyinarin	படையினரின்	பா்த்தில்
padaiyinarai	படையினரை	படுத்தை
padayinarai	படையினரை	படுத்தை
patayinarai	படையினரை	பா்த்தை
pattaalum	பட்டாலும்	பட்டாகம்
panayam	பணயம்	பட்ட
panigalilum	பணிகளிலும்	படுத்தார்
panigazhilum	பணிகளிலும்	பாட்டிக்கம்
panigalil	பணிகளில்	படுத்தில்
panigalukkaana	பணிகளுக்கான	பட்டங்களை
panigazhukkaana	பணிகளுக்கான	பாதுக்பாட்ட
panigalaich	பணிகளைச்	பட்டையில்
panigazhaich	பணிகளைச்	பாருக்கில்
panik	பணிக்	பாலின்
panikku	பணிக்கு	பட்த்தும்
panikkum	பணிக்கும்	பாட்க்ும்
panit	பணித்	பாட்ட்
panith	பணித்	பாலை
paniyagam	பணியகம்	பட்டாம்
paniyakam	பணியகம்	பட்டாம்
paniyaaga	பணியாக	பட்தமாக
paniyaaka	பணியாக	பட்தமாக
paniyaalarin	பணியாளரின்	பாட்களின்
paniyil	பணியில்	பாட்டின்
paniyaiyum	பணியையும்	பாட்டாகும்
panivum	பணிவும்	பாட்டும்
panbaadugalil	பண்பாடுகளில்	பட்டங்களில்
panpaadugalil	பண்பாடுகளில்	பட்டங்களில்
panpaadugazhil	பண்பாடுகளில்	பா்குகி்தில்
panpaadukalil	பண்பாடுகளில்	பட்டங்களில்
panbadugalai	பண்பாடுகளை	பட்டங்களை
panpaadugalai	பண்பாடுகளை	பட்டங்களை
panpaadugazhai	பண்பாடுகளை	பட்டங்களையை
panpaadukalai	பண்பாடுகளை	பட்டங்களை
panbaadugal	பண்பாடுகள்	பட்டங்களில்
panpaadugal	பண்பாடுகள்	பட்டங்களில்
panpaadukal	பண்பாடுகள்	பட்டங்களில்
panbaana	பண்பான	பாத்தா
padhikka	பதிக்க	பட்்காக
pathikka	பதிக்க	பட்்காக
keelkkanakku	பதினெண்	குட்ப்பதாக
keezhkkanakku	பதினெண்	குட்டி்பட்ட
kilkkanakku	பதினெண்	குட்டி்தாக
padhinoaru	பதினோரு	பாட்ட்த
pathinoaru	பதினோரு	பாட்ட்த
padhipiththaar	பதிப்பித்தார்	பாட்டங்கள்
pathippiththaar	பதிப்பித்தார்	பட்டங்களையும்
pathippitthaar	பதிப்பித்தார்	பட்டங்களையும்
padhipiththu	பதிப்பித்து	பாட்டித்து
pathippiththu	பதிப்பித்து	பாட்டுகிறது
pathippitthu	பதிப்பித்து	பாட்கின்றது
bathilaliththaan	பதிலளித்தான்	பட்டங்களில்
pathilaliththaan	பதிலளித்தான்	பட்டங்களில்
bathilaliththaar	பதிலளித்தார்	பட்டங்களையும்
pathilaliththaar	பதிலளித்தார்	பட்டங்களையும்
paththaandugalukku	பத்தாண்டுகளுக்கு	பார்க்கப்பட்டும்
paththaandukalukku	பத்தாண்டுகளுக்கு	பார்க்கப்பட்டும்
paththandukalukku	பத்தாண்டுகளுக்கு	பார்க்கப்பட்டும்
paththaandugalukkum	பத்தாண்டுகளுக்கும்	பாத்த்துக்கார்
paththaandukalukkum	பத்தாண்டுகளுக்கும்	பாத்த்துக்கார்
paththin	பத்தின்	பாட்டின்
paththo	பத்தோ	பா்கா
paththoa	பத்தோ	பா்தா
padmanaaba	பத்மநாப	பாத்தான
pathmanaaba	பத்மநாப	பாத்தான
pathmanaapa	பத்மநாப	பட்்காக
pandhi	பந்தி	பா்்
panthi	பந்தி	பா்்
panththi	பந்தி	பா்்கி
pandrikku	பன்றிக்கு	பாட்கிற்கு
panrikku	பன்றிக்கு	பாட்க்குும்
payanitha	பயணித்த	பட்த்த
payaniththa	பயணித்த	பட்த்த
payanithar	பயணித்தார்	பட்டால்
payaniththaar	பயணித்தார்	பாட்டாகம்
payirgalaana	பயிர்களான	பாட்டுக்கா
payirkalaana	பயிர்களான	பாட்டுக்கா
payirgalai	பயிர்களை	பாட்கதை
payirkalai	பயிர்களை	பாட்கதை
paiyrkalaiyum	பயிர்களையும்	பாட்டுக்கம்
payirgalaiyum	பயிர்களையும்	பாட்டி்களும்
payirkalaiyum	பயிர்களையும்	பாட்டி்களும்
paiyrkal	பயிர்கள்	பா்்கள்
payirkal	பயிர்கள்	பாட்களால்
parappalavil	பரப்பளவில்	பட்டங்களில்
parappazhavil	பரப்பளவில்	பட்டங்களில்
parappuraigal	பரப்புரைகள்	பட்டங்களில்
parappuraikal	பரப்புரைகள்	பட்டங்களில்
parchinai	பரிசினை	பார்டிய
parichinai	பரிசினை	பார்டியை
parisinai	பரிசினை	பார்டிய
parindhuraikka	பரிந்துரைக்க	பட்டுக்க்காக
parinthuraikka	பரிந்துரைக்க	பட்டுக்க்காக
parindhuraikkappadum	பரிந்துரைக்கப்படும்	பயன்படுத்துகளில்
parinthuraikkappadum	பரிந்துரைக்கப்படும்	பயன்படுத்துகள்
parinthuraikkappatum	பரிந்துரைக்கப்படும்	பார்க்கப்பட்டும்
parindhuraikkum	பரிந்துரைக்கும்	பாதுக்கு்தையும்
parinththuraikkum	பரிந்துரைக்கும்	பாதுக்கு்தையும்
parinthuraikkum	பரிந்துரைக்கும்	பாதுக்கு்தையும்
parimaatra	பரிமாற்ற	பாட்டிக்க
parimaattra	பரிமாற்ற	பாட்டியாக
parimaatrangalai	பரிமாற்றங்களை	பாதுக்கு்களை
parimaatrangkalai	பரிமாற்றங்களை	பாதுக்கு்களை
parimaattrangalai	பரிமாற்றங்களை	பாதுக்கு்தையை
parimaattrankalai	பரிமாற்றங்களை	பாதுக்கு்தையை
parimaatrangal	பரிமாற்றங்கள்	பாதுக்கு்தில்
parimaatrangkal	பரிமாற்றங்கள்	பாதுக்கு்தில்
parimaattrangal	பரிமாற்றங்கள்	பாதுக்கு்தில்
parimaattrangalai	பரிமாற்றங்கள்	பாதுக்கு்தையை
parimaattrankal	பரிமாற்றங்கள்	பாதுக்கு்தில்
parimaattrankalai	பரிமாற்றங்கள்	பாதுக்கு்தையை
parimaatraththin	பரிமாற்றத்தின்	பா்காரத்தில்
parimaattraththin	பரிமாற்றத்தின்	புறுக்குகளின்
parimaatram	பரிமாற்றம்	பாட்டங்கள்
parimaattram	பரிமாற்றம்	பாட்டங்கள்
barma	பர்மா	பாரா
barmaa	பர்மா	பா்கா
berma	பர்மா	சிராமா
burma	பர்மா	பாரா
burmaa	பர்மா	பாராா
buurma	பர்மா	பாரா
buurmaa	பர்மா	பா்்க
parma	பர்மா	பாரா
parmaa	பர்மா	பா்கா
barmaavin	பர்மாவின்	பா்தியின்
burmaavin	பர்மாவின்	பார்கியில்
burmavin	பர்மாவின்	பார்கியில்
parmaavin	பர்மாவின்	பா்தியின்
barmaavil	பர்மாவில்	பா்்களில்
burmaavil	பர்மாவில்	பார்களில்
burmavil	பர்மாவில்	பார்களில்
parmaavil	பர்மாவில்	பா்்களின்
parmavil	பர்மாவில்	பா்தியில்
parappathu	பறப்பது	படித்து
parra	பற்ற	பாரா
patra	பற்ற	பா்க
patrra	பற்ற	பா்கா
pattra	பற்ற	பா்கா
patraamal	பற்றாமல்	படுத்தார்
patrraamal	பற்றாமல்	படுத்தார்
pattraamal	பற்றாமல்	படுத்தார்
patrinaal	பற்றினால்	பட்டையள்
pattrinaal	பற்றினால்	பாட்களைப்
parrulla	பற்றுள்ள	பட்த்தாக
patrulla	பற்றுள்ள	பட்்களாக
pattrulla	பற்றுள்ள	பட்டி்காக
palagai	பலகை	பட்டை
palakai	பலகை	பட்டை
palagaigalil	பலகைகளில்	படுத்தில்
palagaikalil	பலகைகளில்	படுத்தில்
palakaikalil	பலகைகளில்	படுத்தில்
palakaiyil	பலகைகளில்	பட்டையில்
palacharakku	பலசரக்கு	பாட்கிற்கு
palasarakku	பலசரக்கு	பாட்டிக்கு
balanaaga	பலனாக	பட்டா
balanaaka	பலனாக	பட்டாக
palanaaga	பலனாக	பட்ட
palanaaka	பலனாக	பட்டாக
palavarrilum	பலவற்றிலும்	பட்டங்கள்
palavatrilum	பலவற்றிலும்	பட்டங்கள்
palavatrrilum	பலவற்றிலும்	பட்டங்களும்
palavattrilum	பலவற்றிலும்	பாட்டங்களும்
pallakku	பல்லக்கு	பட்்க்கும்
pallavar	பல்லவர்	பட்டார்
pallavargalin	பல்லவர்களின்	பட்டங்களில்
pallavargazhin	பல்லவர்களின்	பட்டங்களில்
pallina	பல்லின	பா்்கை
pavudar	பவுடர்	பட்டம்
povder	பவுடர்	பார்டி்
powdar	பவுடர்	பாட்டர்
powder	பவுடர்	பார்டி்
pavurnami	பவுர்ணமி	காட்டியி
pournami	பவுர்ணமி	பார்டிய
pauli	பவுலி	பாரி
paulii	பவுலி	பாலி
pauuli	பவுலி	பாரி
pavuli	பவுலி	பட்டை
bowlin	பவுலின்	பாட்டி
pavulin	பவுலின்	பாட்டி
paagupaadugal	பாகுபாடுகள்	பட்டங்களில்
paakupaadukal	பாகுபாடுகள்	பட்டங்களில்
paadalilum	பாடலிலும்	பட்டாகம்
paatalilum	பாடலிலும்	பட்டாகும்
paandavar	பாண்டவர்	பட்டாமல்
paantavar	பாண்டவர்	பாட்களால்
pandavar	பாண்டவர்	பட்டால்
paandavargalin	பாண்டவர்களின்	பட்டங்களில்
paandavarkalin	பாண்டவர்களின்	பட்டங்களில்
paantavarkalin	பாண்டவர்களின்	பட்டங்களில்
pandavargalin	பாண்டவர்களின்	பட்டங்களில்
paandavargalukku	பாண்டவர்களுக்கு	பார்க்கப்பட்டு
paandavarkalukku	பாண்டவர்களுக்கு	பார்க்கப்பட்டு
paantavarkalukku	பாண்டவர்களுக்கு	பார்க்கப்பட்டு
pandavargalukku	பாண்டவர்களுக்கு	பார்க்கப்பட்டு
paathagamaaka	பாதகமாக	பட்்காக
paathakamaaka	பாதகமாக	பட்்காக
paathaagamaana	பாதகமான	பாட்டுகா
paathaakamaana	பாதகமான	பாட்டுகா
paathagamaana	பாதகமான	பாதியாக
paathakamaana	பாதகமான	பாதிகமாக
paadhi	பாதி	பாலி
paathi	பாதி	பாலி
baathiththu	பாதித்து	பாட்டது
paathiththu	பாதித்து	பாட்டது
paadhiyei	பாதியை	பா்்ி
paathiyai	பாதியை	பா்்கை
baathaikalil	பாதைகளில்	படுத்தில்
paathaikalil	பாதைகளில்	படுத்தில்
baathaikalaiyum	பாதைகளையும்	பட்டங்கள்
paathaikalaiyum	பாதைகளையும்	பட்டங்கள்
baathaikal	பாதைகள்	பட்டால்
paathaikal	பாதைகள்	படுதில்
baathaiyaaka	பாதையாக	பட்்காக
paathaiyaaka	பாதையாக	பட்்காக
paathaiyin	பாதையின்	பா்்கி
baathaiyilirinthu	பாதையிலிருந்து	பாட்க்கப்பட்டு
paathaiyilirinthu	பாதையிலிருந்து	பாட்க்கப்பட்டு
paathaiyilirunththu	பாதையிலிருந்து	பாட்கப்பட்டு
paathaiyilirunthu	பாதையிலிருந்து	பட்டி்பட்டு
paathaiyum	பாதையும்	பாட்கும்
bath	பாத்	பாம்
beth	பாத்	பாட்
pat	பாத்	பால்
baanarji	பானர்ஜி	பா்்ி
banerji	பானர்ஜி	பார்டி
paanarji	பானர்ஜி	பா்்ி
baaba	பாபா	பாமா
baabaa	பாபா	பாமா
baba	பாபா	பாம
babaa	பாபா	பா
baabpaa	பாப்பா	சுத்தா
paapa	பாப்பா	பாமா
paappaa	பாப்பா	சுத்தா
papa	பாப்பா	பாம
papaa	பாப்பா	பாமா
pappa	பாப்பா	பாட்ட
paamban	பாம்பன்	பாட்டி்
paampan	பாம்பன்	சால்கி்
paaraattappatta	பாராட்டப்பட்ட	பாத்துக்க்காக
paaris	பாரிஸ்	பாரிஸ்
paeris	பாரிஸ்	பாஸ்ஸ்
pariis	பாரிஸ்	பாரிஸ்
paris	பாரிஸ்	பாரிஸ்
pariss	பாரிஸ்	பார்ஜிஸ்
paarungal	பாருங்கள்	பாட்டாகம்
paarungkal	பாருங்கள்	பாட்டியம்
paarunkal	பாருங்கள்	பாட்களால்
baalan	பாலன்	பாலன்
baillon	பாலன்	பார்டின்
bailon	பாலன்	பாட்ட்
bailun	பாலன்	பாட்ட்
bailuun	பாலன்	பாட்டி
balan	பாலன்	பால்
ballon	பாலன்	பாட்டி
balon	பாலன்	பாட்
bellon	பாலன்	பார்டின்
belun	பாலன்	பேட்டர்
paalan	பாலன்	பாலன்
palan	பாலன்	பால்
baalu	பாலு	பாது
balu	பாலு	பாது
paalu	பாலு	பாது
balaiya	பாலையா	பா்கா
paalaiyaa	பாலையா	பா்்கா
bhaavangalai	பாவங்களை	படுத்தை
paavangalai	பாவங்களை	படுத்தை
paavangkalai	பாவங்களை	படுத்தை
paavankalai	பாவங்களை	படுத்தை
paavaththin	பாவத்தின்	பா்தியின்
paavaththai	பாவத்தை	படுத்தை
bhaavaththaith	பாவத்தைத்	படுத்தை
paavaththaith	பாவத்தைத்	பட்டையை
baavanaigal	பாவனைகள்	படுத்தார்
bhaavanaigal	பாவனைகள்	படுத்தார்
paavanaikal	பாவனைகள்	படுத்தார்
paavam	பாவம்	பாடம்
pavam	பாவம்	பாலம்
paavai	பாவை	பாலை
baav	பாவ்	பாட்
paav	பாவ்	பால்
pav	பாவ்	பா
piggu	பிக்கு	சிறு
pikku	பிக்கு	சிற்கு
bjb	பிஜேபி	பிஸ்
bjp	பிஜேபி	சின்
pidyuuddari	பிட்யூட்டரி	சிர்த்தியை
pituitari	பிட்யூட்டரி	பார்ப்பி
pituitarii	பிட்யூட்டரி	பார்ப்பியா
pituitary	பிட்யூட்டரி	பார்ப்பி
pitutari	பிட்யூட்டரி	பார்டியி
pitutary	பிட்யூட்டரி	பார்டியி
pituuitarii	பிட்யூட்டரி	பார்ப்பியா
pituuitary	பிட்யூட்டரி	பார்ப்பியா
pituutary	பிட்யூட்டரி	பார்ப்பி
piththu	பித்து	சிற்கு
pinburaththil	பின்புறத்தில்	செல்க்குகளின்
pinpuraththil	பின்புறத்தில்	செல்க்குகளின்
pinburamulla	பின்புறமுள்ள	சிர்க்கின்றன
pinpuramulla	பின்புறமுள்ள	சிர்க்கின்றன
pinburam	பின்புறம்	செல்களால்
pinpuram	பின்புறம்	செல்களாலும்
binvaangi	பின்வாங்கி	சிர்த்திய
binvaangki	பின்வாங்கி	சிர்திரியா
pinvaangi	பின்வாங்கி	சிர்த்திய
pinvaangki	பின்வாங்கி	சிர்ப்டியி
pee	பியா	சே
peea	பியா	சாயா
peeia	பியா	சாயா
peeya	பியா	சாயா
pia	பியா	சியா
piaa	பியா	சாயா
piia	பியா	சியா
piiaa	பியா	சாயா
piiya	பியா	சியா
piya	பியா	சாயா
piyaa	பியா	சாயா
pirachurankalai	பிரசுரங்களை	சிற்றுக்கையை
pirasurangalai	பிரசுரங்களை	செய்திர்களை
pirasurangkalai	பிரசுரங்களை	செய்திர்களை
prachurankalai	பிரசுரங்களை	சிற்றுக்கையை
pirachuramaanathu	பிரசுரமானது	சிர்க்கின்றன
pirasuramaanathu	பிரசுரமானது	செல்லிருந்து
prachuramaanathu	பிரசுரமானது	சிர்க்கின்றன
prasuramaanathu	பிரசுரமானது	செய்த்துள்ள
piradhaana	பிரதான	சுர்காா
pirathaana	பிரதான	சிர்தாக
piradhaani	பிரதானி	சுர்விி
pirathaani	பிரதானி	சுர்விிய
piraththyeaga	பிரத்யேக	சிர்ப்பாக
pirathyaeka	பிரத்யேக	சிர்ப்பா
praththiyaeka	பிரத்யேக	சிர்ப்புகை
bhrammatthin	பிரம்மத்தின்	செல்கிரியின்
biramatthin	பிரம்மத்தின்	செல்கியில்
pirammaththin	பிரம்மத்தின்	செல்லி்திலின்
brammanin	பிரம்மனின்	சிர்க்கியின்
pirammanin	பிரம்மனின்	சிர்க்கியின்
brammanukku	பிரம்மனுக்கு	செய்திருந்து
pirammanukku	பிரம்மனுக்கு	செய்திருந்து
brahaman	பிரம்மன்	சிற்றில்
brahamann	பிரம்மன்	பிர்சின்
brahhman	பிரம்மன்	சிர்டி்
brahman	பிரம்மன்	சிர்சி்
brahmun	பிரம்மன்	சிர்சியம்
brahmuun	பிரம்மன்	பிர்சியம்
bramman	பிரம்மன்	சிர்சியம்
piramman	பிரம்மன்	சிர்சியம்
brush	பிரஷ்	சிரி
fresh	பிரஷ்	சிரி
pirash	பிரஷ்	சிரி
prash	பிரஷ்	சிரி
braamanar	பிராமணர்	செய்காலல்
piraamanar	பிராமணர்	செய்காலல்
praamanar	பிராமணர்	செய்காலல்
braamanargal	பிராமணர்கள்	செய்கிறார்
braamanarkal	பிராமணர்கள்	செய்கிறார்
piraamanarkal	பிராமணர்கள்	செய்கிறார்
praamanarkal	பிராமணர்கள்	செய்கிறார்
pirithadhu	பிரித்தது	சிர்ந்து
piriththathu	பிரித்தது	சிரிந்தது
priththathu	பிரித்தது	சிரித்தது
parant	பிறந்த	பாலின்
perant	பிறந்த	போர்ட்
piaanta	பிறந்த	சிர்யா
piraant	பிறந்த	பிர்சி்
pirandha	பிறந்த	சிரித்த
piranta	பிறந்த	சிர்பானா
pirantha	பிறந்த	சிரித்த
pirandhadhum	பிறந்ததும்	செல்களையும்
piranthathum	பிறந்ததும்	செல்களுக்கு
pirandhadhai	பிறந்ததை	சுர்கதையை
piranthathai	பிறந்ததை	சுர்கத்தை
pirandhavan	பிறந்தவன்	செய்கிறார்
piranthavan	பிறந்தவன்	சிர்த்தார்
piranthaan	பிறந்தான்	சிர்சியம்
piranthaalum	பிறந்தாலும்	செய்கிற்கும்
piranthaal	பிறந்தால்	சிர்க்கள்
pirarin	பிறரின்	செய்வின்
pirarum	பிறரும்	சிர்கும்
pirarai	பிறரை	சுத்தை
piravum	பிறவும்	சிர்கும்
pirgaalach	பிற்காலச்	செய்கியம்
pirkaalach	பிற்காலச்	சிற்கியில்
pirgaalaththil	பிற்காலத்தில்	பார்டங்களில்
pirkaalaththil	பிற்காலத்தில்	செல்க்குகளில்
pirpaguthi	பிற்பகுதி	சிர்ப்பிய
pirpakuthi	பிற்பகுதி	சிர்ப்பதி
pirpaguthiyil	பிற்பகுதியில்	சிற்றுக்கிின்
pirpakuthiyil	பிற்பகுதியில்	சிற்றுக்கிின்
filipinej	பிலிப்பைன்ஸ்	பிர்ட்டி
filipines	பிலிப்பைன்ஸ்	பிராஜிஸ்
filipinez	பிலிப்பைன்ஸ்	பிர்சியின்
filippines	பிலிப்பைன்ஸ்	பிராம்ட்டி
fillipinnez	பிலிப்பைன்ஸ்	பிரிப்பத்தி
philipines	பிலிப்பைன்ஸ்	பிராஜிஸ்
philipinez	பிலிப்பைன்ஸ்	பிராமியின்
philipinnez	பிலிப்பைன்ஸ்	பிராமியின்
philippines	பிலிப்பைன்ஸ்	பிராம்ட்டி
phillipinez	பிலிப்பைன்ஸ்	பிரிப்பிட்
phillipinnej	பிலிப்பைன்ஸ்	பிராம்ப்டியி
phillipinnez	பிலிப்பைன்ஸ்	பிரிப்பத்தி
pilippains	பிலிப்பைன்ஸ்	பிராம்டிடி
pilaikkum	பிழைக்கும்	செல்களும்
pizhaikkum	பிழைக்கும்	செல்க்கும்
pilaiyaana	பிழையான	சிர்பான
pizhaiyaana	பிழையான	சிர்பான
bisinas	பிஸினஸ்	பார்ஜி
business	பிஸினஸ்	பார்ஜின்
pisinas	பிஸினஸ்	பார்ஜி
beach	பீச்	சிய்
beaich	பீச்	சின்
beaych	பீச்	சின்
bech	பீச்	பிஸ்
beech	பீச்	பிஸ்
beechh	பீச்	சிய்
beich	பீச்	சிய்
beiich	பீச்	சின்
beych	பீச்	சிய்
bichh	பீச்	சிய்
biich	பீச்	பிஸ்
biichh	பீச்	சியா
peach	பீச்	சிய்
pech	பீச்	பிஸ்
peech	பீச்	சிய்
pich	பீச்	பிஸ்
piich	பீச்	சிய்
fees	பீஸ்	பிஸ்
peace	பீஸ்	போஸ்
peas	பீஸ்	பிஸ்
pees	பீஸ்	பிஸ்
peice	பீஸ்	போஸ்
piece	பீஸ்	பிஸ்
pugalpetrtrathu	புகழ்பெற்றது	பாட்க்கின்றன
pukalpetrtrathu	புகழ்பெற்றது	பாட்க்கின்றன
pukalpettrathu	புகழ்பெற்றது	பட்டி்பட்ட
pukazhpetrathu	புகழ்பெற்றது	பட்டி்பட்ட
pukazhpettrathu	புகழ்பெற்றது	பட்டி்பட்ட
pugalpetrtravar	புகழ்பெற்றவர்	பட்டி்துகளில்
pukalpetrtravar	புகழ்பெற்றவர்	பட்டி்துகளில்
pukalpettravar	புகழ்பெற்றவர்	பட்டங்களையும்
pukazhpetravar	புகழ்பெற்றவர்	பட்டங்களையும்
pukazhpettravar	புகழ்பெற்றவர்	பட்டி்துகளில்
pugalpetrtru	புகழ்பெற்று	பட்டி்களுக்கு
pukalpetrtru	புகழ்பெற்று	பட்டி்களுக்கு
pukalpettru	புகழ்பெற்று	பட்டி்களுக்கு
pukazhpetru	புகழ்பெற்று	பட்டி்க்கு
pukazhpettru	புகழ்பெற்று	பட்டி்களுக்கு
bookhari	புகாரி	பா்்
bookharii	புகாரி	பா்்ி
booqhari	புகாரி	பார்டி
bukhaari	புகாரி	பா்்ி
bukhaarii	புகாரி	பா்்ி
bukhari	புகாரி	பா்்
bukharii	புகாரி	பா்்கி
buqhaari	புகாரி	பா்்கி
buqhari	புகாரி	பா்்ி
buqharii	புகாரி	பா்்கி
buukhaari	புகாரி	பா்்கி
buukhari	புகாரி	பா்்கி
buukharii	புகாரி	பா்தி
pokaari	புகாரி	பா்்ி
pugaari	புகாரி	பா்்ி
pukaari	புகாரி	பா்்ி
pukari	புகாரி	பா்்ி
pujangal	புஜங்கள்	சார்க்கள்
pujankal	புஜங்கள்	பாட்டாகம்
puduchcheariyin	புதுச்சேரியின்	குட்ட்ட்டியில்
puthuchchaeriyin	புதுச்சேரியின்	கிரும்ப்டியின்
puthucheri	புதுச்சேரியின்	பார்கிரியா
padanggalil	புதுப்	படுத்தில்
padankalil	புதுப்	படுத்தில்
patankalil	புதுப்	படுத்தில்
pudhumaiyaana	புதுமையான	படுத்தா
puthumaiyaana	புதுமையான	படுத்தா
pudhuvai	புதுவை	படுதை
puthuvai	புதுவை	பா்்கை
pudhaiththa	புதைத்த	பட்த்த
puthaiththa	புதைத்த	பட்த்த
buddha	புத்த	பாதா
budhdha	புத்த	பாதா
buththa	புத்த	பாதாக
puththa	புத்த	பாதாத
puththam	புத்தம்	பாட்கம்
buddharukku	புத்தருக்கு	பாட்கின்று
budhdharukku	புத்தருக்கு	பாட்கின்று
buththarukku	புத்தருக்கு	பாட்கின்று
puththaandu	புத்தாண்டு	பாட்கிற்கு
punarvaalvu	புனர்வாழ்வு	பட்டி்க்கு
punarvaazhvu	புனர்வாழ்வு	பட்டி்தாக
punidhargalin	புனிதர்களின்	பா்கங்களில்
punitharkalin	புனிதர்களின்	பட்டங்களில்
punae	புனே	பாமா
pune	புனே	பாரி
punea	புனே	பாமா
punee	புனே	பாரா
punii	புனே	பாரி
puune	புனே	பாரி
puunee	புனே	பாரா
punaeyil	புனேயில்	பாட்டின்
puneayil	புனேயில்	பார்டின்
puneiyl	புனேயில்	பாட்டி்
puneyil	புனேயில்	பாட்டி்
punaevil	புனேவில்	பாட்டின்
puneavil	புனேவில்	சால்கில்
punevil	புனேவில்	பார்டின்
ciripputan	புன்	செய்கிறார்
pan	புன்	பாட்
pon	புன்	பாட்
pun	புன்	பால்
puun	புன்	பால்
sirippudan	புன்	சிர்த்திரம்
purandu	புரண்டு	பாட்டுக்
puravi	புரவி	பா்்
kollaa	புரிந்து	குட்ட
kollaalaam	புரிந்து	கொட்டாகம்
kollaatha	புரிந்து	குற்த்த
kollaavum	புரிந்து	குடுக்கும்
kollalaam	புரிந்து	குடுகளைப்
kollalam	புரிந்து	குடுகள்
kollata	புரிந்து	குட்டாக
kollavum	புரிந்து	குட்டாகும்
puribavargal	புரிபவர்கள்	பா்கங்களைய்
puriyum	புரியும்	பாட்டும்
purivadhai	புரிவதை	பாருகளை
purivathai	புரிவதை	பாருகளை
puruva	புருவ	பாராத
puruvam	புருவம்	பாட்கம்
pulampeyar	புலம்பெயர்	பாட்டிகள்
pulavargalaal	புலவர்களால்	பட்டங்களில்
pulavarkalaal	புலவர்களால்	பட்டங்களில்
pulavargalin	புலவர்களின்	பட்டங்களில்
pulavarkalin	புலவர்களின்	பட்டங்களில்
pulavargalil	புலவர்களில்	பட்டங்களில்
pulavarkalil	புலவர்களில்	பட்டங்களில்
pulavargalukku	புலவர்களுக்கு	பாட்க்கப்படும்
pulavarkalukku	புலவர்களுக்கு	பாட்க்கப்படும்
pulavargalum	புலவர்களும்	பட்டங்களும்
pulavarkalum	புலவர்களும்	பட்டங்கள்
bulet	புல்லட்	பாட்டி
bullat	புல்லட்	பா்்கில்
bullet	புல்லட்	பாட்டின்
buulet	புல்லட்	பாட்டி
buullet	புல்லட்	பாட்டின்
pullad	புல்லட்	பா்்கில்
pullat	புல்லட்	பாட்டின்
blue	புளூ	பாமா
puloo	புளூ	பாமா
puluu	புளூ	பாடு
puvikku	புவிக்கு	பாட்டுக்கு
puviyin	புவியின்	பாட்டின்
puviyil	புவியில்	பாட்டின்
bushkar	புஷ்கர்	சார்டர்
pushkar	புஷ்கர்	சார்டர்
puskar	புஷ்கர்	பிர்டர்
pusqar	புஷ்கர்	பிர்டர்
puuskar	புஷ்கர்	பிர்டர்
pooshkin	புஷ்கின்	சாம்பி்
pooskin	புஷ்கின்	செர்டின்
poosqin	புஷ்கின்	செர்டின்
pushkeen	புஷ்கின்	செய்வின்
pushkin	புஷ்கின்	சாம்பி்
pushkinn	புஷ்கின்	பார்சின்
puskeen	புஷ்கின்	சிர்டின்
puskiin	புஷ்கின்	பார்டின்
puskin	புஷ்கின்	சாமியின்
puskinn	புஷ்கின்	பிர்டின்
pusqeen	புஷ்கின்	செர்டின்
pusqin	புஷ்கின்	பார்டின்
pusqinn	புஷ்கின்	பார்சின்
puuskeen	புஷ்கின்	பிர்டின்
puuskin	புஷ்கின்	செர்டின்
puuskinn	புஷ்கின்	பிர்டின்
bookambam	பூகம்பம்	பாட்களும்
poogambam	பூகம்பம்	பாட்களும்
pookambam	பூகம்பம்	பாட்களும்
puukambam	பூகம்பம்	பாட்களும்
puukampam	பூகம்பம்	பாட்களும்
poojya	பூஜ்ய	சாமி
puujya	பூஜ்ய	பாராஜ
poojyam	பூஜ்யம்	செய்கம்
puujiyam	பூஜ்யம்	செய்கார்
puujyam	பூஜ்யம்	சார்கம்
poonagari	பூநகரி	பார்டிய
poonakari	பூநகரி	பா்்ியி
puunagari	பூநகரி	பா்்ியி
puunakari	பூநகரி	பா்்கிய
poonaigalai	பூனைகளை	பா்தையை
poonaikalai	பூனைகளை	படுத்தை
puunaigalai	பூனைகளை	படுத்தை
puunaikalai	பூனைகளை	படுத்தை
poonaigal	பூனைகள்	பா்்கள்
poonaikal	பூனைகள்	பா்்கள்
puunaigal	பூனைகள்	பட்டால்
puunaikal	பூனைகள்	பட்டால்
poonaiyai	பூனையை	பா்்கை
poonaiyei	பூனையை	பா்்ி
poorna	பூர்ணா	பாரா
poornaa	பூர்ணா	சுத்ய
puurnaa	பூர்ணா	பார்கா
poolae	பூலே	பாமா
puulae	பூலே	பாலா
poolai	பூளை	பாலை
puulai	பூளை	பாலை
pennukku	பெண்ணுக்கு	செல்கிற்கு
pennnudan	பெண்ணுடன்	செய்கிறார்
pennudan	பெண்ணுடன்	சார்க்கள்
pennum	பெண்ணும்	செல்கும்
penmani	பெண்மணி	சுர்வியா
penmanigal	பெண்மணிகள்	செய்கிறார்
penmanikal	பெண்மணிகள்	செய்கிறார்
penmaniyaaga	பெண்மணியாக	செய்திர்கா
penmaniyaaka	பெண்மணியாக	செய்திர்கா
penmaniyin	பெண்மணியின்	செல்கிரியின்
penmaniyum	பெண்மணியும்	செய்கிறார்
peyarum	பெயரும்	சுற்கும்
peyarchchi	பெயர்ச்சி	பிர்விியா
periyavan	பெரியவன்	சார்டியம்
periyavar	பெரியவர்	சார்க்கம்
periyavargalukku	பெரியவர்களுக்கு	செய்த்துள்ளனர்
periyavargal	பெரியவர்கள்	செய்கிறார்
periyavai	பெரியவை	சுறுகளை
periyoar	பெரியோர்	பிர்டர்
periyor	பெரியோர்	பிர்சி்
perugiya	பெருகிய	பார்டிய
perukiya	பெருகிய	பார்டிய
perumidham	பெருமிதம்	சார்க்கும்
perumitham	பெருமிதம்	சார்க்கும்
bart	பெர்ட்	பாட்
bert	பெர்ட்	பிர்
paerd	பெர்ட்	பிர்
bay	பே	பா
bee	பே	சே
beei	பே	பா
bei	பே	பா
beii	பே	சாய்
faie	பே	பா
faye	பே	பாயா
fayee	பே	பாயா
pee	பே	சே
phaye	பே	சா
paechupavar	பேசுபவர்	செய்கிறார்
paesubavar	பேசுபவர்	சார்க்கம்
pesupavar	பேசுபவர்	சார்க்கம்
paenalgal	பேனல்கள்	பாட்டாகம்
paenalkal	பேனல்கள்	பாட்டாகம்
peanalkal	பேனல்கள்	பார்க்கள்
penalkal	பேனல்கள்	பார்க்கள்
paep	பேப்	பேட்
pap	பேப்	பாம்
peap	பேப்	சேட்
peep	பேப்	பின்
pep	பேப்	பேட்
bearaasiriyarin	பேராசிரியரின்	சிற்றுக்கிின்
paeraasiriyarin	பேராசிரியரின்	சிர்துக்கிின்
pearaasiriyarin	பேராசிரியரின்	சிற்றுக்கிின்
paerunthil	பேருந்தில்	செய்கிறார்
pearunthil	பேருந்தில்	சார்டியில்
perunthil	பேருந்தில்	சார்டியில்
beal	பேல்	பாட்
bel	பேல்	பாட்
pael	பேல்	பாட்
pel	பேல்	பாட்
bealai	பேழை	பாலை
paelai	பேழை	பாமி
pelai	பேழை	பாமா
pezhai	பேழை	பாலை
paelaiyil	பேழையில்	பாட்டின்
paezhaiyil	பேழையில்	பார்டின்
pezhaiyil	பேழையில்	பார்டின்
paigalai	பைகளை	பா்தை
paikalai	பைகளை	பா்தை
podhunala	பொதுநல	பட்்காக
pothunala	பொதுநல	பட்்காக
podhuvudamai	பொதுவுடமை	படுத்தையை
pothuvudamai	பொதுவுடமை	படுத்தியை
ponnai	பொன்னை	பா்்கை
pori	பொரி	பாரி
porikkum	பொரிக்கும்	போர்க்கும்
poriththa	பொரித்த	பாட்டாக
ubayoagangkal	பொருட்கள்	இருப்புகள்
ubayoakangkal	பொருட்கள்	இருப்புகள்
upayokankal	பொருட்கள்	உருக்கியல்
poruththappatta	பொருத்தப்பட்ட	பாத்துக்கான
poruththappattulla	பொருத்தப்பட்டுள்ள	பட்டுக்கின்றன
poruththappatulla	பொருத்தப்பட்டுள்ள	பட்டுக்கின்றன
porundhakkoodiya	பொருந்தக்கூடிய	பாதுக்கு்தையை
porundhdhakkoodiya	பொருந்தக்கூடிய	பாதுக்கு்தளை
porunthakkoodiya	பொருந்தக்கூடிய	பாதுக்கு்தை
porundhaadha	பொருந்தாத	பாட்டி்காக
porundhdhaadha	பொருந்தாத	பட்டி்தாக
porunthaatha	பொருந்தாத	பாட்டி்காக
porundhum	பொருந்தும்	பாட்டாகும்
porunthum	பொருந்தும்	பாட்டாகும்
porulaagavea	பொருளாகவே	பாருக்கை
porulaakavae	பொருளாகவே	பாட்டுகளை
porulukku	பொருளுக்கு	பாட்டிக்கு
porulukkum	பொருளுக்கும்	பாட்டிக்கும்
poraamaiyum	பொறாமையும்	பாட்டாகும்
poriththa	பொறித்த	பாட்டாக
porimuraiyil	பொறிமுறையில்	பார்க்களில்
poriyiyal	பொறியியல்	பார்கியம்
poruththa	பொறுத்த	பட்த்த
poruththal	பொறுத்தல்	பட்டையள்
poruththae	பொறுத்தே	பா்த்தை
poruththe	பொறுத்தே	பாருகளை
poruththea	பொறுத்தே	பாருக்கை
poruppaettraar	பொறுப்பேற்றார்	பட்டங்களையும்
poruppetraar	பொறுப்பேற்றார்	பட்டங்களையும்
poruppettraar	பொறுப்பேற்றார்	பட்டங்களையும்
porupeattrullar	பொறுப்பேற்றுள்ளார்	புற்ற்குக்களில்
poruppaettrullaar	பொறுப்பேற்றுள்ளார்	பட்டி்படுகளில்
poruppetrullaar	பொறுப்பேற்றுள்ளார்	பட்டி்படுகளில்
poakka	பொழுது	பாராத
poluthu	பொழுது	பட்த்து
pozhudhu	பொழுது	பாட்டு
pozhuthu	பொழுது	பாட்டு
poluthupokkukku	பொழுதுபோக்குக்கு	பார்க்கப்பட்டும்
poluthupookkukku	பொழுதுபோக்குக்கு	பார்க்கப்பட்டும்
pozhudhupoakkuk	பொழுதுபோக்குக்கு	பாதுக்குக்கார்
baus	பொஸ்	பாஸ்
bauus	பொஸ்	பாஸ்
bos	பொஸ்	பாஸ்
boss	பொஸ்	போஸ்
bous	பொஸ்	பாஸ்
bouus	பொஸ்	பாஸ்
paoos	பொஸ்	போஸ்
bogach	போகச்	பாட்
poagach	போகச்	பாட்
pogach	போகச்	பாட்
pokach	போகச்	பால்
poagath	போகத்	பாலா
pogath	போகத்	பாலா
pokath	போகத்	பாலா
bhoagam	போகம்	பாடம்
boagam	போகம்	பாடம்
bogam	போகம்	பாலம்
bhoagar	போகர்	பாலல்
boagar	போகர்	பாலல்
bogar	போகர்	பாலல்
poagavae	போகவே	பா்கா
poagavea	போகவே	பாரா
pogave	போகவே	பா்கை
poagaamal	போகாமல்	பா்்கள்
poakkaaga	போக்காக	பாட்டாக
poakkaaha	போக்காக	பார்மான
poakkuvaraththin	போக்குவரத்தின்	பா்குகி்தில்
poakkuvaraththirku	போக்குவரத்திற்கு	பார்க்கப்பட்டு
boassu	போசு	சியா
poasu	போசு	பாம
boadi	போடி	பாரி
poadi	போடி	பாரி
poattigalin	போட்டிகளின்	பா்குகளில்
poattikalin	போட்டிகளின்	பா்குகளில்
poattigalilum	போட்டிகளிலும்	பாட்டி்களும்
poattikalilum	போட்டிகளிலும்	பாட்டி்களும்
poattigalil	போட்டிகளில்	பா்குகளில்
poattikalil	போட்டிகளில்	பா்குகளில்
poattigalukkaana	போட்டிகளுக்கான	பாதுக்புக்கா
poattikalukkaana	போட்டிகளுக்கான	பாதுக்புக்கா
poattigalukku	போட்டிகளுக்கு	பாட்கின்றன
poattikalukku	போட்டிகளுக்கு	பாட்கின்றன
poattigalum	போட்டிகளும்	பாட்டிக்கம்
poattigalaiyuim	போட்டிகளையும்	பார்க்கு்கள்
poattigalaiyum	போட்டிகளையும்	பாட்டி்களும்
poattikalaiyum	போட்டிகளையும்	பாட்டி்களும்
poattigal	போட்டிகள்	பார்க்கள்
poattikal	போட்டிகள்	பாட்டியம்
poattikku	போட்டிக்கு	பாட்டிக்கு
poattith	போட்டித்	பார்டின்
tervil	போட்டித்	திர்டின்
thaervil	போட்டித்	தேவரில்
poattiyaaga	போட்டியாக	பார்மையான
poattiyaaka	போட்டியாக	பாருக்கா
poattiyaalarkalin	போட்டியாளர்களின்	புறுக்குகியில்
poattiyalargalin	போட்டியாளர்களின்	புறுக்குகளில்
poattiyaalargalai	போட்டியாளர்களை	பாதுக்கு்தியை
poattiyaalarkalai	போட்டியாளர்களை	பாதுக்கு்தியை
poattiyilirindhu	போட்டியிலிருந்து	பார்க்கப்பட்டு
poattiyilirunthu	போட்டியிலிருந்து	பாட்கப்பட்டுள்ளது
poattiyum	போட்டியும்	சுற்க்கும்
poattiayai	போட்டியை	பாருக்கை
poattiyai	போட்டியை	பார்கதை
poattiyei	போட்டியை	பார்டிய
poattiyaith	போட்டியைத்	பார்கத்தை
poattiyeith	போட்டியைத்	சுருக்களின்
poathellaam	போதெல்லாம்	பாட்டாகம்
poandrathu	போன்றது	பாட்டது
poantrathu	போன்றது	பாட்டது
poandravar	போன்றவர்	பாட்களால்
poantravar	போன்றவர்	பாட்களால்
poandravarkalukku	போன்றவர்களுக்கு	பார்க்கப்பட்டு
poantravargalukku	போன்றவர்களுக்கு	பார்க்கப்பட்டும்
poantravarkalukku	போன்றவர்களுக்கு	பார்க்கப்பட்டும்
poandravarkal	போன்றவர்கள்	பட்டங்களில்
poanravarkal	போன்றவர்கள்	பாட்டங்கள்
poantravargal	போன்றவர்கள்	பா்கங்களைப்
poantravarkal	போன்றவர்கள்	பா்கங்களில்
poandrum	போன்றும்	பாட்டும்
poanrum	போன்றும்	பாட்டும்
poantrum	போன்றும்	பாட்டும்
poandrae	போன்றே	பா்்ி
poanrae	போன்றே	பார்ய
poantrae	போன்றே	பார்கா
bauing	போயிங்	பாட்
bauuing	போயிங்	பால்
boaing	போயிங்	போர்
boaying	போயிங்	பார்ட்
boeengs	போயிங்	பிரிஸ்
boeing	போயிங்	போர்
boiings	போயிங்	பிராஜி
boing	போயிங்	பின்
booeengs	போயிங்	பாரிஸ்
booeing	போயிங்	பார்
poaying	போயிங்	பார்ட்
poayina	போயின	பாரா
poyina	போயின	பாரா
poarkkaala	போர்க்கால	பாட்டுகான
poarkkaalaththil	போர்க்காலத்தில்	புறுக்குகளின்
board	போர்ட்	பாட்
ford	போர்ட்	பாட்
poard	போர்ட்	பாட்
poart	போர்ட்	பாட்
poord	போர்ட்	பாட்
poort	போர்ட்	பாட்
port	போர்ட்	பாட்
poalak	போலக்	பாலம்
polak	போலக்	பாலம்
poalirukkum	போலிருக்கும்	பாட்டிக்கும்
polirukkum	போலிருக்கும்	பாட்டிக்கும்
poalum	போலும்	பாடம்
polum	போலும்	பாடம்
bole	போலே	பாரி
bolee	போலே	பாரா
boole	போலே	பாரி
fole	போலே	பாரி
folee	போலே	பாரா
foleey	போலே	பாரா
folei	போலே	பாரி
foley	போலே	பாமி
foli	போலே	பாரி
folii	போலே	பாரி
foole	போலே	பாரி
foolee	போலே	பாரா
fooley	போலே	பாமி
fooli	போலே	பாரி
foolii	போலே	பாரி
phole	போலே	போரி
pholee	போலே	பாரி
pholey	போலே	பாரா
pholi	போலே	போரி
pholii	போலே	பாரி
poalae	போலே	பாமா
poale	போலே	பாரி
polae	போலே	பாமா
poolee	போலே	பாரா
magalaai	மகளாய்	மகாமை
magalaay	மகளாய்	மகாமி
makalaai	மகளாய்	முகை
makalaay	மகளாய்	மகாமி
magalaiyum	மகளையும்	முறையும்
makalaiyum	மகளையும்	முறையாகும்
magaaraajan	மகாராஜன்	மா்்டின்
mahaaraajan	மகாராஜன்	மா்்பின்
maharajan	மகாராஜன்	மா்்டின்
makaaraajan	மகாராஜன்	மா்்பின்
magaalingam	மகாலிங்கம்	முற்கிறார்
magaalingkam	மகாலிங்கம்	முற்கிறார்
mahalingam	மகாலிங்கம்	முற்க்கும்
makaalingam	மகாலிங்கம்	முற்கிறார்
makaalingkam	மகாலிங்கம்	முற்கிறார்
magaal	மகால்	மாடர்
mahal	மகால்	மாட்
makaal	மகால்	மாடர்
magimai	மகிமை	முகைய
makimai	மகிமை	முக்ய
magilchchiyai	மகிழ்ச்சியை	முறுக்களை
makilchchiyai	மகிழ்ச்சியை	முறுக்கையை
makizhchchiyai	மகிழ்ச்சியை	முறுக்கையை
magilchchiyaiyum	மகிழ்ச்சியையும்	மு்்பிட்டாகம்
makilchchiyaiyum	மகிழ்ச்சியையும்	மு்்பிட்டாகம்
makizhchchiyaiyum	மகிழ்ச்சியையும்	மு்்பிருக்கம்
magilchchiyoadu	மகிழ்ச்சியோடு	முற்்பிற்கு
makilchchiyoadu	மகிழ்ச்சியோடு	முற்்பிற்கு
makizhchchiyoadu	மகிழ்ச்சியோடு	முற்கின்றன
maheshvari	மகேஸ்வரி	முக்கிய
maheswari	மகேஸ்வரி	முக்கியி
makaesvari	மகேஸ்வரி	முக்கியி
makkiya	மக்கிய	முக்கி
maggum	மக்கும்	மேட்டும்
makkum	மக்கும்	மேட்டும்
machuuthi	மசூதி	முக்்தி
masoodi	மசூதி	முக்கி
masoothi	மசூதி	முக்கி
masuthi	மசூதி	முக்ய
masuuthi	மசூதி	முக்யி
machuuthiukal	மசூதிகள்	முறுமையாளர்
masoothigal	மசூதிகள்	முறுமையால்
masoothikal	மசூதிகள்	முறுமையால்
masuthigal	மசூதிகள்	முறுமையால்
masuuthigal	மசூதிகள்	முறுமையால்
machuuthiyil	மசூதியில்	முறும்பில்
masoothiyil	மசூதியில்	முறுமையில்
masuthiyil	மசூதியில்	முறுமையில்
masuuthiyil	மசூதியில்	முறுமையில்
madanthai	மடந்தை	முற்கை
matanthai	மடந்தை	முறுகளை
madaalayam	மடாலயம்	முறைகள்
mataalayam	மடாலயம்	முறைகளும்
mattumae	மட்டுமே	முற்கான
manakka	மணக்க	முற்க
manakkaal	மணக்கால்	முறுகளால்
manappathu	மணப்பது	முற்தது
manamurivu	மணமுறிவு	முற்கிற்கு
maninaera	மணிநேர	முக்கா
maninera	மணிநேர	முக்கி
maninaerangal	மணிநேரங்கள்	முற்கிர்கள்
maninaeranggal	மணிநேரங்கள்	முற்கிர்கள்
maninerangkal	மணிநேரங்கள்	முற்குகிறார்
maninaeraththirku	மணிநேரத்திற்கு	முற்்படுக்குும்
manineraththirku	மணிநேரத்திற்கு	முற்்படுக்கும்
maninaeram	மணிநேரம்	முற்காலம்
manineram	மணிநேரம்	முறுமானர்
manimuththaaru	மணிமுத்தாறு	முற்கின்றன
manimuththaru	மணிமுத்தாறு	முற்கிற்கு
manneeral	மண்ணீரல்	முறுகளில்
manneeril	மண்ணீரல்	மார்க்கில்
madhar	மதர்	மாடம்
mathar	மதர்	மாடம்
mother	மதர்	மேட்டர்
madhurakavi	மதுரகவி	முறுக்தை
madurakavi	மதுரகவி	முறுக்தி
mathurakavi	மதுரகவி	முறுக்கை
maddhiyath	மத்தியத்	முறுகளைப்
maththiyath	மத்தியத்	முறுகளைப்
mandhamaaga	மந்தமாக	முற்காக
manthamaaga	மந்தமாக	முற்காக
manthamaaka	மந்தமாக	முற்காக
mandhar	மந்தர்	மேட்டம்
manthar	மந்தர்	மேட்டம்
manaaluththam	மனஅழுத்தம்	முற்களாகும்
manaalzhuththam	மனஅழுத்தம்	முற்கின்றார்
manaazhuththam	மனஅழுத்தம்	முற்கிறார்
manathoadu	மனதோடு	முற்த்து
manappaadam	மனப்பாடம்	முற்க்கும்
manam	மனம்	மார்
manaigalil	மனைகளில்	அம்பியில்
manaikalil	மனைகளில்	அம்பியில்
manaiyil	மனையில்	மக்கில்
mannarai	மன்னரை	முறுகளை
marakkattai	மரக்கட்டை	முற்கத்தை
marakattaigalai	மரக்கட்டைகளை	முற்கு்கை
marakkattaikalai	மரக்கட்டைகளை	முக்குக்களை
maraththinaal	மரத்தினால்	முறுமையில்
maraththin	மரத்தின்	முக்கியின்
marabuvali	மரபுவழி	முறுகளை
marabuvazhi	மரபுவழி	முறுகளை
maravalli	மரவள்ளி	மு்்்தி
mariyannai	மரியன்னை	முறுமையை
mariina	மரீனா	மிராயா
mariinaa	மரீனா	மிக்யா
marina	மரீனா	மிராயா
marinaa	மரீனா	மிக்யா
maru	மரு	மது
marukkal	மருக்கள்	முறுகளைப்
maruththuvamanaigalukku	மருத்துவமனைகளுக்கு	முற்்படுகின்றன
maruththuvamanaikalukku	மருத்துவமனைகளுக்கு	மேற்றுக்கப்படும்
maruththuvamanaikku	மருத்துவமனைக்கு	முற்்படுகின்றன
maruththuvamanaiyaaga	மருத்துவமனையாக	முற்க்கின்றன
maruththuvamanaiyaaka	மருத்துவமனையாக	முற்க்கின்றன
maruththuvamanaiyin	மருத்துவமனையின்	இந்திர்க்கின்
maruththuvamanaiyil	மருத்துவமனையில்	இப்படுத்திின்
marundhae	மருந்தே	முற்காான
marunthae	மருந்தே	முற்காான
marunththae	மருந்தே	முற்காான
marukkappatta	மறுக்கப்பட்ட	முற்கப்பட்ட
marukkum	மறுக்கும்	முற்க்கும்
maraivaal	மறைவால்	மக்கார்
matravar	மற்றவர்	முறைகள்
matrtravar	மற்றவர்	முறுக்கள்
mattravar	மற்றவர்	முறைகள்
matravargalaal	மற்றவர்களால்	முற்கிர்கள்
matrtravargalaal	மற்றவர்களால்	முற்க்கு்கள்
matrtravarkalaal	மற்றவர்களால்	முற்க்கு்கள்
mattravarkalaal	மற்றவர்களால்	முற்கிர்கள்
matravargalukku	மற்றவர்களுக்கு	முற்்படுக்குும்
matrtravargalukku	மற்றவர்களுக்கு	முற்்படுகின்றன
matrtravarkalukku	மற்றவர்களுக்கு	முற்்படுகின்றன
mattravarkalukku	மற்றவர்களுக்கு	முற்்படுகின்றன
matravargalukkum	மற்றவர்களுக்கும்	மு்்க்கின்றனர்
matrtravargalukkum	மற்றவர்களுக்கும்	மு்ப்பிட்டுகள்
matrtravarkalukkum	மற்றவர்களுக்கும்	மு்்பிடுகினார்
mattravarkalukkum	மற்றவர்களுக்கும்	மு்்க்கின்றனர்
matravargaludan	மற்றவர்களுடன்	மு்்கி்த்தார்
matrtravargaludan	மற்றவர்களுடன்	மு்்க்கி்தில்
matrtravarkaludan	மற்றவர்களுடன்	மு்்க்கு்களில்
mattravarkaludan	மற்றவர்களுடன்	மு்்கி்த்தால்
matravargalai	மற்றவர்களை	முற்குகளை
matrtravargalai	மற்றவர்களை	முற்கு்களை
matrtravarkalai	மற்றவர்களை	முற்கு்கை
mattravarkalai	மற்றவர்களை	முற்குகளை
matravargalaip	மற்றவர்களைப்	முற்குகளில்
matrtravargalaip	மற்றவர்களைப்	மு்்குகிறான்
matrtravarkalaip	மற்றவர்களைப்	முற்குகிறான்
mattravarkalaip	மற்றவர்களைப்	முற்குகிறார்
malattu	மலட்டு	முற்க்து
malarin	மலரின்	மா்்ட்
malaril	மலரில்	மா்்கில்
malarai	மலரை	மகாமை
indraiya	மலர்	அர்சாமை
inraiya	மலர்	அர்சாமை
intraiya	மலர்	அர்சியை
malargalaal	மலர்களால்	முறுக்கள்
malarkalaal	மலர்களால்	முறுக்கள்
malargalin	மலர்களின்	மு்த்தில்
malarkalin	மலர்களின்	மு்த்தில்
malargalai	மலர்களை	முறுகளை
malarkalai	மலர்களை	முறுகளை
malargal	மலர்கள்	மாட்டார்
malarkal	மலர்கள்	மாட்டார்
malivaaga	மலிவாக	முற்காக
malivaaka	மலிவாக	முற்காக
maadangal	மாடங்கள்	முறுகளைப்
maadangkal	மாடங்கள்	முறுகளைப்
maatangkal	மாடங்கள்	முறுக்கள்
maadaththil	மாடத்தில்	முறுகளில்
maataththil	மாடத்தில்	முறுக்கள்
maadam	மாடம்	மாடம்
maatam	மாடம்	மாடம்
maanikkak	மாணிக்கக்	முறுமாகம்
manickkak	மாணிக்கக்	முறுமையாம்
maan	மாண்	மேன்
maann	மாண்	மேன்
maadhiriyaaga	மாதிரியாக	முற்்தாக
maadhiriyaaka	மாதிரியாக	முற்்தாக
maathiriyaaga	மாதிரியாக	முற்்தாக
maathiriyaaka	மாதிரியாக	முற்்தாக
maarkandaeya	மார்க்கண்டேய	மு்போடியி
maarkkandaeya	மார்க்கண்டேய	முக்கிரியி
markandeya	மார்க்கண்டேய	முக்கிரியா
markkandaeya	மார்க்கண்டேய	முக்கிரியி
maarkkandaeyan	மார்க்கண்டேயன்	மா்்பிரத்தின்
markandeyan	மார்க்கண்டேயன்	மா்்பிட்டின்
maarban	மார்பன்	மா்்ட்
maarpin	மார்பன்	மா்்டின்
maarbil	மார்பில்	மார்சியில்
maarpil	மார்பில்	மார்சியில்
maaraagak	மாறாகக்	முறையம்
maaraakak	மாறாகக்	முறையும்
maaraagath	மாறாகத்	முறைகள்
maaraakath	மாறாகத்	முறைகள்
maattramadaintha	மாற்றமடைந்து	முற்கின்றன
maattramadainthu	மாற்றமடைந்து	முற்்பிற்கு
mattramadaindhu	மாற்றமடைந்து	முற்கிற்று
maattru	மாற்று	முக்கு
maatrtruk	மாற்றுக்	முற்கும்
maattruk	மாற்றுக்	முற்கும்
maattruch	மாற்றுச்	முக்கின்
maatrum	மாற்றும்	மேட்டும்
maattrum	மாற்றும்	மேற்கும்
maalaimurasu	மாலைமுரசு	முற்கிற்கு
malaimurasu	மாலைமுரசு	முற்கிற்கு
maalaiyilum	மாலையிலும்	முற்க்கும்
maalaiyil	மாலையில்	மா்்கில்
maalaiyaiyum	மாலையையும்	முற்க்கும்
maaligai	மாளிகை	முதியை
maalikai	மாளிகை	முதியை
maaligaigal	மாளிகைகள்	முறுக்கள்
maalikaikal	மாளிகைகள்	முறுகளைப்
maaligaikkul	மாளிகைக்குள்	மு்்பிர்கள்
maalikaikkul	மாளிகைக்குள்	மு்்பிர்கள்
maaligaiyin	மாளிகையின்	முக்கியின்
maalikaiyin	மாளிகையின்	மு்்்தின்
maaligaiyai	மாளிகையை	முறுகளை
maalikaiyai	மாளிகையை	முறுகளை
maavilakku	மாவிளக்கு	முற்கிற்கு
maavoa	மாவோ	மாகா
maavoo	மாவோ	மாகி
mao	மாவோ	மே
maoo	மாவோ	மே
maoow	மாவோ	மேனி
maov	மாவோ	மேன்
maow	மாவோ	மே
mau	மாவோ	மே
mavoo	மாவோ	மாயா
maavoavin	மாவோவின்	மா்்டின்
maavoovin	மாவோவின்	மா்்டின்
maasgoa	மாஸ்கோ	மிராஜி
maaskoa	மாஸ்கோ	மிக்கோ
maaskoo	மாஸ்கோ	மிக்கி
maskoo	மாஸ்கோ	ஹாட்டி
moosccoov	மாஸ்கோ	மார்சின்
mooscoo	மாஸ்கோ	மினி
mooscoow	மாஸ்கோ	முக்கிஸ்
mosccov	மாஸ்கோ	முச்சின்
mosccow	மாஸ்கோ	முகிஸ்
moscoo	மாஸ்கோ	மினி
moscov	மாஸ்கோ	ஹாட்ட்
moscow	மாஸ்கோ	மினிஸ்
moscu	மாஸ்கோ	மியாம்
maaskoavil	மாஸ்கோவில்	மார்சியில்
maaskoovil	மாஸ்கோவில்	மார்சியில்
massgoavil	மாஸ்கோவில்	மார்சியில்
moscowil	மாஸ்கோவில்	மார்சின்
mikka	மிக்க	ஹிக்யா
mikkadhaaga	மிக்கதாக	முற்்தாக
mikkathaaka	மிக்கதாக	முற்்தாக
mikku	மிக்கு	மிற்கு
michchigan	மிச்சிகன்	மார்சியின்
michigan	மிச்சிகன்	மாட்டின்
midhakkum	மிதக்கும்	முற்க்கும்
mithakkum	மிதக்கும்	முற்க்கும்
midhappu	மிதப்பு	மிற்க்கு
mithappu	மிதப்பு	மிற்க்கு
midhavaadha	மிதவாத	முற்காக
mithavaatha	மிதவாத	முற்காக
midhilai	மிதிலை	முதியை
mithilai	மிதிலை	முக்ய
miyaanmar	மியான்மர்	மிக்கிரில்
myanmar	மியான்மர்	மிட்டர்
meov	மியாவ்	மேன்
meow	மியாவ்	மே
mev	மியாவ்	ஹாட்
meva	மியாவ்	மே
mew	மியாவ்	ஹா
mewa	மியாவ்	மே
meyaavu	மியாவ்	மிற்கு
miev	மியாவ்	ஹாட்
miew	மியாவ்	ஹா
miyaav	மியாவ்	மிக்
miyav	மியாவ்	மிக்
mirsaa	மிர்ஸா	மிக்கோ
mirshaa	மிர்ஸா	மிக்கோ
mirzaa	மிர்ஸா	மிக்யா
milagu	மிளகு	மாட்டு
milaku	மிளகு	முக்கு
mee	மீ	ஹே
mie	மீ	ஹே
mii	மீ	ரா
miie	மீ	மே
meenavargalin	மீனவர்களின்	முறுக்களின்
meenavarkalin	மீனவர்களின்	முறுக்களில்
meenavargal	மீனவர்கள்	முறுமையாகப்
meenavarkal	மீனவர்கள்	முறுமையாகம்
meena	மீனா	மா
meenaa	மீனா	மேகா
mena	மீனா	மா
miina	மீனா	ஹாட்
miinaa	மீனா	மியா
mina	மீனா	மியா
meengalil	மீன்களில்	முறுகளில்
meenkalil	மீன்களில்	முறுமையில்
meengalum	மீன்களும்	முற்க்கும்
meenkalum	மீன்களும்	முற்க்கும்
meengalai	மீன்களை	முற்களை
meenkalai	மீன்களை	முற்களை
meengalaik	மீன்களைக்	முறுகளைப்
meenkalaik	மீன்களைக்	முறுமையில்
meara	மீரா	மாகா
meera	மீரா	மா
meeraa	மீரா	மியா
meiira	மீரா	மிரா
meira	மீரா	மியா
miira	மீரா	மியா
miiraa	மீரா	மியா
mira	மீரா	மியா
miraa	மீரா	மியா
meeraan	மீரான்	மேடன்
meeran	மீரான்	மேடன்
meelaad	மீலாத்	மேடன்
meelaath	மீலாத்	மேடன்
mugam	முகம்	மாடம்
mukam	முகம்	மாடம்
thaan	முகம்	தான்
muguntha	முகுந்த	முற்்த
mukunda	முகுந்த	மிக்்தா
mukundha	முகுந்த	முற்்த
mukundhdha	முகுந்த	முற்்தாக
mukuntha	முகுந்த	முற்்த
thiruththum	முடி	திரிக்கும்
tiruttum	முடி	திரிக்கும்
mudigaludan	முடிகளுடன்	முறுமையில்
mudikaludan	முடிகளுடன்	முறுமையில்
mudigalum	முடிகளும்	முற்க்கும்
mudikalum	முடிகளும்	முற்க்கும்
mudigalai	முடிகளை	முறுகளை
mudikalai	முடிகளை	முறுகளை
mudigal	முடிகள்	மாட்டார்
mudikal	முடிகள்	மாட்டார்
boadhu	முடிக்கும்	பாது
poadhu	முடிக்கும்	பாது
poathu	முடிக்கும்	பாடு
potu	முடிக்கும்	பாடு
mudindhdhana	முடிந்தன	முற்்தாக
mudinthana	முடிந்தன	முற்்காக
mudiyaamal	முடியாமல்	முறுகளைப்
mudiyaamai	முடியாமை	முறுகளை
mudiyin	முடியின்	மா்்ட்
mudiyil	முடியில்	மா்்டின்
mudiyai	முடியை	முக்ய
mudivadaiyum	முடிவடையும்	முற்கிற்கும்
mudivin	முடிவின்	மார்சின்
mudivilum	முடிவிலும்	முற்கிறும்
mudivae	முடிவே	முக்கி
muthanilai	முதனிலை	முறுகளை
muthalamaichchar	முதலமைச்சர்	மா்்பிரியில்
muthalamaichchargal	முதலமைச்சர்கள்	மு்ப்பிட்களில்
muthalamaichcharkal	முதலமைச்சர்கள்	மு்ப்பிட்களில்
muthaluthavi	முதலுதவி	முறுக்கை
muthaludhavip	முதலுதவிப்	முறும்பிின்
muthaluthavip	முதலுதவிப்	முறும்பிின்
munaivadhaaga	முனைவதாக	முற்்தாக
munaivathaaka	முனைவதாக	முற்்தாக
munnani	முன்னணி	முக்கி
munnaniyil	முன்னணியில்	மா்்பிரியின்
munnaniyum	முன்னணியும்	முற்கிற்கும்
munnarae	முன்னரே	முற்றை
padugindrana	முன்னெடுக்கப்	பட்டி்களாக
padukinrana	முன்னெடுக்கப்	பட்டி்களாக
padukintrana	முன்னெடுக்கப்	பட்டி்களாக
patukinrana	முன்னெடுக்கப்	பட்டி்களாக
munnedukappatta	முன்னெடுக்கப்பட்ட	முற்றுக்பாட்ட
munnedukkappatta	முன்னெடுக்கப்பட்ட	முற்கப்பட்டன
munnetukkappatta	முன்னெடுக்கப்பட்ட	முற்கப்பட்டன
munnedukkum	முன்னெடுக்கும்	முற்கின்றும்
munnetukkum	முன்னெடுக்கும்	முற்கின்றும்
munmaadhiriyaga	முன்மாதிரியாக	முற்கின்றன
munmaadhiriyaka	முன்மாதிரியாக	முற்கின்றன
munmaathiriyaaga	முன்மாதிரியாக	முற்கின்றன
munmaathiriyaaka	முன்மாதிரியாக	முற்கின்றன
munmadiriyaga	முன்மாதிரியாக	முற்கின்றன
munvaiththa	முன்வைத்த	முற்்தாக
munvaiththaanr	முன்வைத்தனர்	மா்்பிரியின்
munvaiththanar	முன்வைத்தனர்	முன்னிர்கள்
muppathu	முப்பது	முற்த்து
muppathukkum	முப்பதுக்கும்	முற்கின்றனர்
muyandra	முயன்ற	முக்கிய
muyanra	முயன்ற	மிக்கா
muyantra	முயன்ற	முக்கோ
muyandrathaaga	முயன்றதாக	முற்கின்றன
muyandrathaaha	முயன்றதாக	முற்கின்ற
muyandrathaaka	முயன்றதாக	முற்கின்றன
muyanrathaaka	முயன்றதாக	முற்்தாக
muyantrathaaga	முயன்றதாக	முற்கின்றன
muyantrathaaka	முயன்றதாக	முற்கின்றன
muyandrathu	முயன்றது	முற்கிறது
muyanrathu	முயன்றது	முற்தது
muyantrathu	முயன்றது	முற்கிறது
muyandrana	முயன்றன	முற்்தாான
muyanrana	முயன்றன	முற்காக
muyantrana	முயன்றன	முற்்தாக
muyandraan	முயன்றான்	முறும்பில்
muyanraan	முயன்றான்	முக்கியில்
muyantraan	முயன்றான்	முறுமியில்
muyanru	முயன்று	முக்கு
muyantru	முயன்று	முற்க்து
murachu	முரசு	மிக்கு
murasu	முரசு	மிக்க
muraigaettil	முறைகேட்டில்	மு்ப்பிரின்
muraikaettil	முறைகேட்டில்	மா்்பிரியின்
muraikettil	முறைகேட்டில்	மா்்பிரியின்
muraimai	முறைமை	முறையை
muraimaiyaanathu	முறைமையானது	முற்கிற்கு
muraimaiyin	முறைமையின்	மு்பிரின்
muraimaiyil	முறைமையில்	முறுமையில்
murpatta	முற்பட்ட	முற்்ததாக
murpattanar	முற்பட்டனர்	மாச்சியி்தில்
murpattapoathu	முற்பட்டபோது	முற்்படுத்து
murpattapoothu	முற்பட்டபோது	முற்்படுக்கு
murpattapothu	முற்பட்டபோது	முற்்படுக்கு
murpattaan	முற்பட்டான்	மா்்பிரியின்
theevai	முல்லைத்	தேசா
tivai	முல்லைத்	டேசா
mullum	முள்ளும்	மேட்டும்
mullai	முள்ளை	முதைய
mulunera	முழுநேர	முக்கிய
muzhunaera	முழுநேர	முக்கா
muzhunera	முழுநேர	மிக்கி
moodupani	மூடுபனி	மு்்்தி
moondraavadhu	மூன்றாவது	முற்ப்பது
moondraavathu	மூன்றாவது	முற்பிற்கு
moor	மூர்	மேக்
mur	மூர்	மேக்
muur	மூர்	மேக்
moolakkooru	மூலக்கூறு	முற்கிற்கு
moolakkoorugalin	மூலக்கூறுகளின்	முக்கிர்ட்டின்
moolakkoorukalin	மூலக்கூறுகளின்	முக்கிர்ட்டின்
moolakkoorugalai	மூலக்கூறுகளை	முற்குக்களை
moolakkoorukalai	மூலக்கூறுகளை	முற்குக்களை
mechchi	மெச்சி	மிராஜி
maegalai	மேகலை	முதைய
maekalai	மேகலை	முதைய
megalai	மேகலை	முதைய
madein	மேட்டின்	மேடன்
maettin	மேட்டின்	மார்சின்
mate	மேட்டின்	மேக்
matein	மேட்டின்	மேடன்
maeniyil	மேனியில்	மா்்டின்
maembaalaththai	மேம்பாலத்தை	முற்குகளை
maempaalaththai	மேம்பாலத்தை	முற்குகளை
meampaalaththai	மேம்பாலத்தை	முற்குகளை
maicroa	மைக்ரோ	மிராஜி
maikro	மைக்ரோ	மிக்கி
maikroa	மைக்ரோ	மிக்யா
maikroo	மைக்ரோ	மிக்கோ
maiqro	மைக்ரோ	மிக்கி
mekro	மைக்ரோ	ஹிக்கி
micro	மைக்ரோ	ஹாட்டி
microo	மைக்ரோ	மிக்கோ
micru	மைக்ரோ	மிறு
mikro	மைக்ரோ	ஹிக்கி
mykro	மைக்ரோ	ஹெய்சி
mykroo	மைக்ரோ	மிக்கி
myqro	மைக்ரோ	ஹெய்சி
moe	மோ	ஹே
moo	மோ	மே
mooe	மோ	மே
moasaeyin	மோசேயின்	மேட்டி்
moaseayin	மோசேயின்	மார்சி்
mosaeyin	மோசேயின்	மார்டின்
moad	மோட்	மேன்
moat	மோட்	மேன்
mod	மோட்	மேன்
mode	மோட்	மேக்
mood	மோட்	மேன்
mote	மோட்	மேக்
iaak	யாக்	மான்
iacc	யாக்	மான்
iak	யாக்	மேன்
iakk	யாக்	மாட்
iokk	யாக்	அமான்
yaak	யாக்	யாம்
yaaq	யாக்	யான்
yacc	யாக்	மான்
yak	யாக்	மான்
yakk	யாக்	மாக்
yaq	யாக்	யான்
yaqq	யாக்	அம்
yok	யாக்	மேன்
yokk	யாக்	மா்
yoqq	யாக்	மேன்
iaang	யாங்	ஆன்
ianag	யாங்	அமான்
iang	யாங்	அம்
yaang	யாங்	அம்
yan	யாங்	யான்
yanag	யாங்	அலை
yang	யாங்	அம்
yaadhavar	யாதவர்	அவர்
yaathavar	யாதவர்	அமைப்
yaadhavarkal	யாதவர்கள்	அரிப்பால்
yaathavargal	யாதவர்கள்	அரைக்கிறார
yaathavarkal	யாதவர்கள்	அரிப்பால்
iaadav	யாதவ்	அமான்
iadav	யாதவ்	அலை
iaduv	யாதவ்	அழகம்
jadav	யாதவ்	ஜோக்
jadaw	யாதவ்	ஜோக்
yaadav	யாதவ்	அமான்
yaadaw	யாதவ்	அரான்
yaadhav	யாதவ்	அமான்
yaathav	யாதவ்	அமான்
yadav	யாதவ்	அலைப்
yadaw	யாதவ்	அலை
yaduuv	யாதவ்	அழைக்
yaduv	யாதவ்	உரக்
yaduw	யாதவ்	அழக்
yatav	யாதவ்	அராம்
zadav	யாதவ்	ஜெய்
yaavarum	யாவரும்	அர்கும்
yaahoo	யாஹூ	அரா
yahoo	யாஹூ	அரா
yaaka	யோக	அமா
yoaga	யோக	அமா
yoaka	யோக	அமா
yoga	யோக	அமா
yaakangkalai	யோகங்களை	அரிசாமானை
yoagangkalai	யோகங்களை	அரிசாமான
yoakangalai	யோகங்களை	அர்சியை
yoakangkalai	யோகங்களை	அந்தியான
yoagaththil	யோகத்தில்	அர்த்தின்
yoakaththil	யோகத்தில்	அர்தியில்
yookaththil	யோகத்தில்	அம்பியில்
yoakaththai	யோகத்தை	அர்பாமை
yogaththai	யோகத்தை	அர்கைய
yookaththai	யோகத்தை	அந்தியை
yoagaa	யோகா	அமா
yoakaa	யோகா	அமா
yoga	யோகா	அமா
yogaa	யோகா	அமா
yooga	யோகா	அமா
yookaa	யோகா	அமா
youga	யோகா	அமா
yoachanai	யோசனை	முதைய
yoasanai	யோசனை	மகாமை
yoosanai	யோசனை	முதைய
yoasanaiyin	யோசனையின்	அர்ச்சில்
yoosanaiyin	யோசனையின்	அர்ச்சில்
yoasanaiyai	யோசனையை	முறுகளை
yoosanaiyai	யோசனையை	முறுகளை
yosanaiyai	யோசனையை	முறுகளை
jordan	யோர்தான்	ஜெய்வர்
yoarthaan	யோர்தான்	மக்களில்
yoorthaan	யோர்தான்	மக்களில்
rachippathil	ரசிப்பதில்	ராஜ்கிரியின
rasippathil	ரசிப்பதில்	ராஜ்கிரியின
ranchi	ரஞ்சி	ராஜி
ranjchi	ரஞ்சி	ராஜ்சி
ranji	ரஞ்சி	ராஜி
ranchith	ரஞ்சித்	ராஜ்கி்
ranjchith	ரஞ்சித்	ராஜ்கிடின்
ranjeet	ரஞ்சித்	ராஜ்சின்
ranjeit	ரஞ்சித்	ராஜ்சின்
ranjiit	ரஞ்சித்	ராஜ்சி்
ranjit	ரஞ்சித்	ராஜின்
ranjith	ரஞ்சித்	ராஜின்
ranjyt	ரஞ்சித்	ராஜின்
ranzeet	ரஞ்சித்	ராஜ்கிட்்
ranzeit	ரஞ்சித்	ராஜ்கிட்்
ranzit	ரஞ்சித்	ராஜ்சி்
ranzyt	ரஞ்சித்	ராஜ்டி
runjeet	ரஞ்சித்	ராஜ்கிட்்
runjiit	ரஞ்சித்	ராஜ்கிட்்
runzeet	ரஞ்சித்	ராஜ்கிட்்
ruunjeet	ரஞ்சித்	ராஜ்கிட்்
rail	ரயில்	ராட்
raill	ரயில்	ராஜ்
raiyl	ரயில்	ராஜ்
rayil	ரயில்	ராஜின்
rayl	ரயில்	ராட்
reil	ரயில்	ராஜ்
rel	ரயில்	ரான்
rell	ரயில்	ராஜ்
ravikkai	ரவிக்கை	ராஜ்பியா
ravudi	ரவுடி	ராக்கி
rovdy	ரவுடி	ராஜி
rowdi	ரவுடி	ராஜி
rowdy	ரவுடி	ராஜி
rashiya	ரஷ்ய	ராஜி
rashya	ரஷ்ய	ராஜா
rassia	ரஷ்ய	ராஜி
russia	ரஷ்ய	ராஜி
raagul	ராகுல்	ராட்டர்
raahul	ராகுல்	ராகர்
raahuul	ராகுல்	ராக்கர்
ragul	ராகுல்	ராட்்
rahool	ராகுல்	ராஜின்
rahul	ராகுல்	ராக்
rahuul	ராகுல்	ராகர்
rakul	ராகுல்	ராட்்
raajan	ராஜன்	ராஜின்
rajan	ராஜன்	ராஜின்
raajaraaja	ராஜராஜ	ராஜ்சியா
rajaraja	ராஜராஜ	ராஜ்சி
raajjiyam	ராஜ்ஜியம்	ராஜ்க்கம்
rajjiyam	ராஜ்ஜியம்	ராஜ்கரம்
raanuvaththin	ராணுவத்தின்	ராம்பர்சின்
raanuvam	ராணுவம்	ராக்கம்
raat	ராத்	ராக்
raath	ராத்	ராக்
raamachchandhira	ராமச்சந்திர	மாக்கிராம்டி
raamachchanthira	ராமச்சந்திர	ராஜ்ப்பத்தி
ramachandra	ராமச்சந்திர	ராஜ்கிரியா
raamu	ராமு	ராம்
ramu	ராமு	ராகு
raayin	ராயின்	ராஜின்
raiyin	ராயின்	ராஜின்
raavin	ராவின்	ராஜின்
ravin	ராவின்	ராஜின்
rawin	ராவின்	ராஜின்
ring	ரிங்	ராஜ்
reader	ரீடர்	ராசாம்
reedar	ரீடர்	ராசாம்
ruchi	ருசி	ராஜி
rusi	ருசி	ராஜி
rendu	ரெண்டு	ராம்பு
raadaun	ரேடான்	ராஜின்
raadauun	ரேடான்	ராக்க்
raadon	ரேடான்	ராஜின்
radon	ரேடான்	ராஜின்
reedan	ரேடான்	ராஜின்
raemand	ரேமண்ட்	ராஜ்டர்
raemant	ரேமண்ட்	ராஜ்ட்
raimond	ரேமண்ட்	ராஜ்டர்
raymond	ரேமண்ட்	ராஜ்டர்
reemand	ரேமண்ட்	ராஜ்டர்
roo	ரோ	லே
roow	ரோ	ரா
rov	ரோ	ராஜ்
row	ரோ	ரா
landanin	லண்டனின்	ராக்கியன்
londanin	லண்டனின்	ராம்பியின்
londonin	லண்டனின்	ராஜ்கியின்
lav	லவ்	லாய்
lov	லவ்	லாய்
love	லவ்	லியா
low	லவ்	லோ
lowe	லவ்	லியா
luuv	லவ்	ராய்
luv	லவ்	லோப்
luw	லவ்	லோப்
laak	லாக்	ராக்
lack	லாக்	ராட்
lock	லாக்	ராஜ்
laaba	லாப	ரா
laba	லாப	ரா
laabam	லாபம்	ராகம்
laapam	லாபம்	ராகம்
laalu	லாலு	விகு
lalu	லாலு	ராகு
linam	லிங்கம்	வியம்
lingam	லிங்கம்	விச்மம்
linggam	லிங்கம்	விச்மம்
lingkam	லிங்கம்	ஜெய்கம்
linkam	லிங்கம்	ஜெய்கம்
lemeted	லிமிடெட்	விட்டிட்்
limidaed	லிமிடெட்	விச்சின்
limitade	லிமிடெட்	விச்சின்
limited	லிமிடெட்	விஸ்டர்
limitedd	லிமிடெட்	விஸ்ட்டி்
leeli	லில்லி	விஜ்
leelii	லில்லி	விஜ்
liili	லில்லி	ஜூலி
liilii	லில்லி	ஜோடி
liilly	லில்லி	ஜெய்சி
liily	லில்லி	ஜூலி
lilee	லில்லி	ஜோனி
lili	லில்லி	ஜோனி
lilii	லில்லி	ஜோனி
lilli	லில்லி	ஜெய்யி
lilly	லில்லி	ஜெய்யி
lily	லில்லி	ஜெய்
lyly	லில்லி	ஜூலி
leagueil	லீக்கில்	ராக்கில்
leakkil	லீக்கில்	ராமியின்
leena	லீனா	ஜாகா
leenaa	லீனா	லியா
lena	லீனா	லியா
liina	லீனா	ஜாயா
lina	லீனா	ஜோகா
looyi	லூயி	ராஜா
louie	லூயி	லே
louis	லூயி	லேஷ்
louuie	லூயி	ராஜா
luuyi	லூயி	ராஜா
looyis	லூயிஸ்	லேசிஸ்
loues	லூயிஸ்	லோஸ்
louis	லூயிஸ்	லேஷ்
louues	லூயிஸ்	ராஜ்
louuis	லூயிஸ்	லேஷ்
lues	லூயிஸ்	ராஜ்
luis	லூயிஸ்	ராஜ்
luues	லூயிஸ்	ராஜ்
luuis	லூயிஸ்	ராஜ்
luuyis	லூயிஸ்	லேசிஸ்
leptinan	லெப்டினன்	ராஜ்கியின்
lace	லெஸ்	லேச்
laes	லெஸ்	லோஸ்
lais	லெஸ்	லோஸ்
laiss	லெஸ்	ராஜ்
lays	லெஸ்	ராஜ்
layss	லெஸ்	ராஜ்
leis	லெஸ்	லிஸ்
les	லெஸ்	லிஸ்
less	லெஸ்	லிஸ்
laac	லேக்	லேக்
laak	லேக்	ராக்
laakh	லேக்	லோ
laaq	லேக்	ராட்
laaqh	லேக்	லோப்
lac	லேக்	ராய்
laek	லேக்	ராஜ்
lake	லேக்	லே
lakh	லேக்	லா
laqh	லேக்	லோ
leek	லேக்	லிக்
vaguththanar	வகுத்தனர்	வழங்குகள்
vakuththanar	வகுத்தனர்	வழி்களால்
vaguththulladhu	வகுத்துள்ளது	வழங்குகின்றன
vaguththullathu	வகுத்துள்ளது	வழங்குகின்றன
vakuththullathu	வகுத்துள்ளது	வழங்குகின்றன
vagaith	வகைத்	நாய்
vakaith	வகைத்	நாட்ட்
vakkiramaana	வக்கிரமான	நிகழ்ந்தா
vakbu	வக்பு	நான்
vakpu	வக்பு	விது
vangadesa	வங்கதேச	நார்விி
vangathaesa	வங்கதேச	நாட்டியை
vangkadhaesa	வங்கதேச	நார்குமை
vangadhaesaththil	வங்கதேசத்தில்	வாட்ட்க்களின்
vangathaesaththil	வங்கதேசத்தில்	வாட்ட்க்்களின்
vangkadhaesaththil	வங்கதேசத்தில்	நாட்ட்க்கியின்
vangaali	வங்காளி	நார்கிய
vangkaali	வங்காளி	நார்கிய
vasam	வசம்	வால்
vasiththa	வசித்த	விருந்த
vasiththaar	வசித்தார்	விளங்கள்
vadakkae	வடக்கே	வழிமை
vadakke	வடக்கே	நார்யை
vadamaerkae	வடமேற்கே	நாட்கை
vatamaerkae	வடமேற்கே	நாட்களை
vadikka	வடிக்க	வழி்காக
vadikkum	வடிக்கும்	வழி்காகும்
vadivaana	வடிவான	நாரான
vadivil	வடிவில்	நார்டின்
vatti	வட்டி	நாரை
vana	வண	நாக
ven	வண	வேட்
wen	வண	வேட்
vanigar	வணிகர்	நார்ட்
vanikar	வணிகர்	நார்ட்
vanigarkalukku	வணிகர்களுக்கு	நாட்டுக்கிற்கு
vanikarkalukku	வணிகர்களுக்கு	நிறுக்பட்டுக்க
vadhanam	வதனம்	நாயம்
vathanam	வதனம்	நாயம்
wadhanam	வதனம்	நாயம்
vanaviyal	வனவியல்	நா்்கள்
vamsa	வம்ச	நாட்டி
vamsaththin	வம்சத்தின்	விளங்களின்
vamsaththu	வம்சத்து	விருந்து
vamchi	வம்சி	நார்டி
vamsi	வம்சி	நாரி
vayathaagum	வயதாகும்	வழி்கும்
vayathaakum	வயதாகும்	வழி்கும்
vayathilum	வயதிலும்	வழி்களும்
vayathilaeyae	வயதிலேயே	நடி்களை
varagu	வரகு	நாடு
varadha	வரத	நாகா
varatha	வரத	நாகா
vardha	வரத	வழாம
varadhar	வரதர்	நாரால்
varathar	வரதர்	நாரால்
varalaattru	வரலாற்று	வழிக்துக்கு
varalaattruk	வரலாற்றுக்	வழங்களுக்கும்
varalaattrukku	வரலாற்றுக்கு	வழங்குகின்றன
varalaattrudan	வரலாற்றுடன்	வழங்கு்களில்
varalaattrup	வரலாற்றுப்	வழிப்புகள்
varavaerka	வரவேற்க	நடை்காக
varavaerkum	வரவேற்கும்	வழி்களும்
varigalin	வரிகளின்	வழிவிின்
varikalin	வரிகளின்	வழிவிின்
varigalil	வரிகளில்	வழங்களின்
varikalil	வரிகளில்	வழங்களின்
varigalukku	வரிகளுக்கு	வழங்களுக்கு
varikalukku	வரிகளுக்கு	வழங்களுக்கு
varigalum	வரிகளும்	வழி்கும்
varikalum	வரிகளும்	வழி்கும்
varikku	வரிக்கு	வழிந்து
varich	வரிச்	நாட்
varinum	வரினும்	நார்கம்
panaththai	வரிப்	படுத்தை
panattai	வரிப்	படுத்தை
variyaaga	வரியாக	நாட்ட
variyaaka	வரியாக	வழிவாக
variyin	வரியின்	நார்டி
variyum	வரியும்	நார்கம்
varumaaru	வருமாறு	வழி்காக
variya	வறிய	நாட்டி
valimaiyaanathu	வலிமையானது	வழங்குவதற்கு
valuvaaga	வலுவாக	நட்ட
valuvaaka	வலுவாக	நட்்கா
valuvvaaga	வலுவாக	நடை்காக
valaiyamaippai	வலையமைப்பை	வடிப்புகளை
valaiyamaippu	வலையமைப்பை	வழங்களுக்கு
valaiththathu	வளைத்தது	வழிந்தது
valaivaaga	வளைவாக	நட்்கா
valaivaaka	வளைவாக	நட்்கா
valakkarignarum	வழக்கறிஞரும்	வழங்கு்திலும்
valakkarinarum	வழக்கறிஞரும்	வழங்கு்களும்
vazhakkarinarum	வழக்கறிஞரும்	வழங்கு்களும்
valakkugalin	வழக்குகளின்	வட்டங்களில்
valakkukalin	வழக்குகளின்	வட்டங்களில்
vazhakkukalin	வழக்குகளின்	வட்டங்களில்
valakkugalai	வழக்குகளை	வழங்கு்கை
valakkukalai	வழக்குகளை	வழங்கு்கை
vazhakkukalai	வழக்குகளை	வழங்கு்கை
valakkugal	வழக்குகள்	வழங்குகள்
valakkukal	வழக்குகள்	வழங்குகள்
vazhakkukal	வழக்குகள்	வழி்களில்
valakkuth	வழக்குத்	வழி்கும்
vazhakkuth	வழக்குத்	வழி்கும்
valakkum	வழக்கும்	வழி்கும்
vazhakkum	வழக்கும்	வழிவாகும்
valangappada	வழங்கப்பட	வழங்கு்தாக
vazhangappada	வழங்கப்பட	வழங்கு்தாக
vazhanggappada	வழங்கப்பட	வழங்கு்தாக
valangappadaatha	வழங்கப்படாத	வழங்குகின்றன
vazhangappadaadha	வழங்கப்படாத	வழங்குகின்றன
vazhanggappattathaa	வழங்கப்படாத	வழங்குக்பாட்ட
valangappadum	வழங்கப்படும்	வழங்கு்திலும்
valangkappadum	வழங்கப்படும்	வழங்கு்திலும்
vazhanggappadum	வழங்கப்படும்	வழங்கு்திலும்
vazhangkappadum	வழங்கப்படும்	வழங்கு்திலும்
valangavillai	வழங்கவில்லை	வடிப்புகளை
valangkavillai	வழங்கவில்லை	வழங்கு்தை
vazhangkavillai	வழங்கவில்லை	வழங்கு்தை
valinadaththa	வழிநடத்த	வழிக்பாக
vazhinadaththa	வழிநடத்த	வழிக்பாக
valiyil	வழியில்	நார்டின்
vazhiyil	வழியில்	நார்டின்
valiyillai	வழியில்லை	நடிக்கையை
vazhiyillai	வழியில்லை	நடிக்கையை
valiyae	வழியே	நாரை
valiyea	வழியே	நாராய
vazhiyae	வழியே	நாரை
valukkum	வழுக்கும்	வழி்காகும்
vazhukkum	வழுக்கும்	வழி்காகும்
vavuniyaavil	வவுனியாவில்	வட்டங்களில்
vavuniyavil	வவுனியாவில்	வட்டங்களில்
vastook	வஸ்தோக்	விச்சி்
vastuk	வஸ்தோக்	விட்டம்
voostook	வஸ்தோக்	விட்டின்
vostok	வஸ்தோக்	விச்சி்
vostook	வஸ்தோக்	விச்சி்
vostoq	வஸ்தோக்	விட்டின்
wastuk	வஸ்தோக்	விச்யம்
wastuq	வஸ்தோக்	விச்சி்
wastuuk	வஸ்தோக்	விட்டார்
woostook	வஸ்தோக்	விட்டின்
wostok	வஸ்தோக்	விச்சி்
wostook	வஸ்தோக்	விச்சி்
wostooq	வஸ்தோக்	விட்டின்
wostuk	வஸ்தோக்	விச்சம்
vaagana	வாகன	நாரா
vaakana	வாகன	நாரா
vaagananggalil	வாகனங்களில்	வாட்கத்தில்
vaaganangkalil	வாகனங்களில்	வாட்டங்களில்
vaakanangkalil	வாகனங்களில்	விளங்களில்
vaagananggalum	வாகனங்களும்	விளங்களாகும்
vaaganangkalum	வாகனங்களும்	விளங்களாகும்
vaakanangkalum	வாகனங்களும்	விளங்களாகும்
vaagananggalai	வாகனங்களை	வாட்கத்தை
vaaganangkalai	வாகனங்களை	வாட்டுகளை
vaakanangkalai	வாகனங்களை	விளை்களையை
vaagananggal	வாகனங்கள்	வேட்டங்கள்
vaaganangkal	வாகனங்கள்	வேட்டுகள்
vaakanangkal	வாகனங்கள்	விளங்களில்
vaaganaththin	வாகனத்தின்	நார்க்கின்
vaakanaththin	வாகனத்தின்	விளங்களின்
vaaganaththilirunththu	வாகனத்திலிருந்து	வழங்கப்பட்டது
vaaganaththilirunthu	வாகனத்திலிருந்து	விளையிடுகின்றன
vaakanaththilirunththu	வாகனத்திலிருந்து	விளியிடப்பட்டு
vaakanaththilirunthu	வாகனத்திலிருந்து	விளி்கப்பட்டு
vaaganaththil	வாகனத்தில்	வாட்களில்
vaakanaththil	வாகனத்தில்	வாட்டத்தில்
vaaganap	வாகனப்	நார்ட்
vaakanap	வாகனப்	நாட்டர்
vaaganamaana	வாகனமான	வாட்டாான
vaaganamana	வாகனமான	வாட்டான
vaakanamaana	வாகனமான	வேட்டுகை
vaakanamana	வாகனமான	வேட்டாக
vaak	வாக்	வால்
vag	வாக்	வான்
vak	வாக்	வேக்
wag	வாக்	வான்
wak	வாக்	வேல்
walk	வாக்	நால்
vaangappatta	வாங்கப்பட்ட	வழங்கு்திற்க
vaanggappatta	வாங்கப்பட்ட	வழங்கு்திற்க
vaangkappatta	வாங்கப்பட்ட	வாட்டி்பட்ட
vaangalil	வாங்கலில்	வா்்களின்
vaanggalil	வாங்கலில்	வா்்களின்
vaangal	வாங்கல்	நார்கள்
vaanggal	வாங்கல்	நார்கள்
vaangguvatharku	வாங்குவதற்கு	நாட்கின்றன
vaangkuvatharku	வாங்குவதற்கு	நாட்கின்றன
vaangguvathu	வாங்குவது	வாட்டித்து
vaangkuvathu	வாங்குவது	விறையிறது
vaangguvathai	வாங்குவதை	வாட்கத்தை
vaangkuvathai	வாங்குவதை	வாட்கத்தை
vaasippavargal	வாசிப்பவர்கள்	விள்விக்காலம்
vaachippil	வாசிப்பில்	விட்டியில்
vaasippil	வாசிப்பில்	விட்டியில்
vaachippai	வாசிப்பை	விளைய்தை
vaasippai	வாசிப்பை	விளையையை
vaadi	வாடி	நாரி
vadi	வாடி	நாரி
wadi	வாடி	நாரி
wadii	வாடி	நாயை
vaatch	வாட்ச்	நாட்ட்
watch	வாட்ச்	நாட்
vaani	வாணி	நாரி
vani	வாணி	நாரி
vaathittanar	வாதிட்டனர்	வாட்டிகள்
vaathumai	வாதுமை	வாத்தை
vaamana	வாமன	நாரா
vamana	வாமன	நாடை
vaayilaaga	வாயிலாக	வாட்டாக
vaayilaaka	வாயிலாக	வாட்டாக
vaayilaagath	வாயிலாகத்	வழி்களைப்
vaayilaakath	வாயிலாகத்	வாழ்க்கள்
vaayilaagap	வாயிலாகப்	வாட்களால்
vaayilaakap	வாயிலாகப்	வாட்களால்
vaariyaaga	வாரியாக	நிக்காக
vaariyaaka	வாரியாக	நிக்காக
vaalt	வால்ட்	வாட்
vald	வால்ட்	நால்
valt	வால்ட்	வால்
vaoolt	வால்ட்	வாட்
vault	வால்ட்	வாட்
vauult	வால்ட்	வாட்
volt	வால்ட்	வாட்
vult	வால்ட்	வாட்
vuult	வால்ட்	வாட்
walt	வால்ட்	வால்
waoolt	வால்ட்	வாட்
wault	வால்ட்	வாட்
wult	வால்ட்	வாட்
vaalidankal	வாழிடங்கள்	விளங்களில்
vaazhidanggal	வாழிடங்கள்	வேட்டங்கள்
vaazhidangkal	வாழிடங்கள்	வேட்டங்கள்
vaazhitangkal	வாழிடங்கள்	வேட்டங்கள்
vaalidam	வாழிடம்	நாட்ட
vaazhaidam	வாழிடம்	வா்்கள்
vaazhidam	வாழிடம்	நார்கம்
vaazhitam	வாழிடம்	நார்கம்
vaalai	வாழை	வாகை
vaazhai	வாழை	வாகை
vaalaiyaaga	வாழையாக	வாட்டாக
vaazhaiyaaga	வாழையாக	வழி்காக
vaazhaiyaaka	வாழையாக	வழி்காக
vaazhga	வாழ்க	நாரா
vaazhka	வாழ்க	நாரா
valamudan	வாழ்க	நா்்கள்
valamutan	வாழ்க	நா்்கள்
vaazhvathaaga	வாழ்வதாக	நிரு்்தா
vaazhvathaal	வாழ்வதால்	வேட்டுகள்
vaalvukku	வாழ்வுக்கு	நிறையாக்கு
vaazhvukku	வாழ்வுக்கு	நிறையாகு
vaalvoar	வாழ்வோர்	நிக்கால்
vaazhvoar	வாழ்வோர்	நிக்கால்
vaas	வாஸ்	வேச்
vase	வாஸ்	நாய்
was	வாஸ்	வேன்
vigaaraiyil	விகாரையில்	விட்டியில்
viharaiyil	விகாரையில்	விட்டியில்
vikaaraiyil	விகாரையில்	விட்டியில்
vikkirama	விக்கிரம	விசியாான
vikkrama	விக்கிரம	விஜ்மான
vikrama	விக்கிரம	விஜமாக
visaariththu	விசாரித்து	விளிக்தது
vichaesha	விசேஷ	விஜ்யா
visaesha	விசேஷ	விஜ்யா
vichaikal	விசைகள்	விட்டார்
visaigal	விசைகள்	விட்டர்
visaikal	விசைகள்	விட்டர்
vichaikku	விசைக்கு	விரிந்து
visaikku	விசைக்கு	விரிந்து
visaiyaal	விசையால்	விட்டார்
visaiyil	விசையில்	விட்டின்
visaiyum	விசையும்	விர்மாம்
visaiyai	விசையை	விஜ்யா
vingngnaani	விஞ்ஞானி	விரும்பியி
vinjnjaani	விஞ்ஞானி	விரும்பியா
vinniaani	விஞ்ஞானி	விரும்பியா
vingngnaanikalukku	விஞ்ஞானிகளுக்கு	விளி்படுகின்றன
vinjnjaanikalukku	விஞ்ஞானிகளுக்கு	விளி்படுகின்றன
vinniaanigalukku	விஞ்ஞானிகளுக்கு	விளி்படுகின்றன
vingngnaanikal	விஞ்ஞானிகள்	விள்விட்டத்தில்
vinjnjaanikal	விஞ்ஞானிகள்	விச்சியங்கள்
vinniaanigal	விஞ்ஞானிகள்	விள்விக்கள்
vingngnaaniyaana	விஞ்ஞானியான	விருவ்துகளை
vinjnjaaniyaana	விஞ்ஞானியான	விருவாட்்கை
vinniaaniyaana	விஞ்ஞானியான	விருவாட்்கை
vidayangalil	விடயங்களில்	விளங்குகள்
vidayanggalil	விடயங்களில்	விளங்குகள்
vidayangkalil	விடயங்களில்	விளங்குகள்
vidayanggalum	விடயங்களும்	விளிக்குகும்
vidayangkalum	விடயங்களும்	விளங்களாகும்
vitayangkalum	விடயங்களும்	விளிக்குகும்
vidayanggal	விடயங்கள்	விளங்களால்
vidayangkal	விடயங்கள்	விளங்களால்
vitayangkal	விடயங்கள்	விளங்களால்
vidayaththil	விடயத்தில்	விளங்களில்
vitayaththil	விடயத்தில்	விளங்களில்
vidayaththaiyum	விடயத்தையும்	விளங்களாகும்
vitayaththaiyum	விடயத்தையும்	விளங்களாகும்
poaraattam	விடுதலைப்	பாட்டாகம்
porattam	விடுதலைப்	பட்டாகம்
viduthalaip	விடுதலைப்	விளங்களில்
vidum	விடும்	விம்
vittaalum	விட்டாலும்	விருக்கும்
vittup	விட்டுப்	விர்கும்
viththiyaachangkal	வித்தியாசங்கள்	விள்விட்டுகள்
viththiyaasanggal	வித்தியாசங்கள்	விள்விட்டுகள்
viththiyaasangkal	வித்தியாசங்கள்	விள்விட்டுகள்
viththiyaasankal	வித்தியாசங்கள்	விள்விட்டுகள்
viththiyaachappadum	வித்தியாசப்படும்	விளியாட்டி்களும்
viththiyaasappadum	வித்தியாசப்படும்	விளியாட்டிக்கும்
vidhdhiyaasaalai	வித்தியாசாலை	விள்விக்கை
vidhyaasaalai	வித்தியாசாலை	விருவத்தை
vidhyasalai	வித்தியாசாலை	விளங்களை
vidyasalai	வித்தியாசாலை	விளங்களை
viththiyaasaalai	வித்தியாசாலை	விருவ்துகளை
vinaa	வினா	வேகா
vinaavirku	வினாவிற்கு	விளிக்துக்கு
vinaavukku	வினாவுக்கு	விளிக்துக்கு
vibaththaal	விபத்தால்	விளங்களால்
vipaththaal	விபத்தால்	விளங்களால்
booshan	விபூதி	செர்ட்
vibhoodhi	விபூதி	விஜ்வியா
viboodhi	விபூதி	விஜ்யி
viboothi	விபூதி	விஜ்யி
vimarisaiyaaga	விமரிசையாக	விளிக்க்ாக
vimarisaiyaaka	விமரிசையாக	விருவிக்கா
vimarsiththathu	விமர்சித்தது	விளியி்பட்டு
vimarsiththatu	விமர்சித்தது	விளிவிக்கிறது
vimarsiththanar	விமர்சித்தனர்	விள்விக்க்கார்
vimarsiththu	விமர்சித்து	விளிக்பதற்க
vimaanangalil	விமானங்களில்	விள்விக்கள்
vimaananggalil	விமானங்களில்	விள்விக்கள்
vimaananggalai	விமானங்களை	விளங்களையை
vimaanankalai	விமானங்களை	விளைய்கையை
veem	விம்	வேட்
viim	விம்	வில்
vim	விம்	வேட்
vimm	விம்	வில்
weem	விம்	வேட்
wiim	விம்	வில்
wim	விம்	வேட்
wimm	விம்	வில்
viyaabaari	வியாபாரி	விட்டியி
viyaapaari	வியாபாரி	விட்டியி
viyaabaarigalukkum	வியாபாரிகளுக்கும்	விளி்படுத்தார்
viyaapaarigalukkum	வியாபாரிகளுக்கும்	விளி்படுத்தார்
viyaabaarigal	வியாபாரிகள்	விளியாட்டார்
viyaapaarigal	வியாபாரிகள்	விளியாட்டார்
viyabaarigal	வியாபாரிகள்	விளியாட்டார்
viralaal	விரலால்	விட்டார்
virivaagak	விரிவாகக்	விர்க்கம்
virivaagap	விரிவாகப்	விர்க்கள்
virivaagavum	விரிவாகவும்	விளிக்காகும்
virivagavum	விரிவாகவும்	விளிக்கும்
virivurai	விரிவுரை	விளிமையை
virkum	விற்கும்	விட்டும்
virkumpoadhu	விற்கும்போது	விளிக்பட்தது
virkumpoathu	விற்கும்போது	விளிக்பட்தது
virpathum	விற்பதும்	விருக்கும்
vitrtra	விற்ற	விராமா
vittra	விற்ற	விஜாமா
villiamin	வில்லியமின்	விட்டியின்
villiyamin	வில்லியமின்	விளிய்கிின்
williamin	வில்லியமின்	விட்டியின்
villai	வில்லை	விக்யா
villaigalai	வில்லைகளை	விளை்களை
villaikalai	வில்லைகளை	விளை்களை
vilimbu	விளிம்பு	விரிந்து
vilimpu	விளிம்பு	விரிந்து
vilimbugalil	விளிம்புகளில்	விள்விக்களில்
vilimbukalil	விளிம்புகளில்	விள்விக்களில்
vilimpugalil	விளிம்புகளில்	விள்விட்களில்
vilimpukalil	விளிம்புகளில்	விள்விக்்களில்
vilaindha	விளைந்த	விருந்த
vilaintha	விளைந்த	விருந்த
vilaindhadhu	விளைந்தது	விளையிறது
vilaindhathu	விளைந்தது	விளைவிறது
vilainthadhu	விளைந்தது	விறையிறது
vilainthathu	விளைந்தது	விளைவிறது
vilaindhu	விளைந்து	விருந்து
vilainthu	விளைந்து	விருந்து
vilaiyaadinaal	விளையாடினால்	விளங்குகள்
vilaiyaadum	விளையாடும்	விளிக்கும்
vilaiyaadumpoadhu	விளையாடும்போது	விளியிடுகிறது
vilaiyaadumpoathu	விளையாடும்போது	விளியிடுகிறது
vilaiyaaduvadharku	விளையாடுவதற்கு	விளி்குகின்றன
vilaiyaaduvatharku	விளையாடுவதற்கு	விளி்குகின்றன
vilaiyaaduvadhu	விளையாடுவது	விளிக்பதற்
vilaiyaaduvathu	விளையாடுவது	விளிக்பதற்
vilaiyaattaaka	விளையாட்டாக	விளிக்க்ாக
vilaiyattaaga	விளையாட்டாக	நிகழ்ந்தா
vilaiyattaaka	விளையாட்டாக	நிகழ்ந்தா
vilayaattaaga	விளையாட்டாக	விளிக்க்ாக
vivariththa	விவரித்த	விளிக்காக
vivariththu	விவரித்து	விளிக்தது
vivaagaraththu	விவாகரத்து	விளிகின்றன
vivaakaraththu	விவாகரத்து	விளிகின்றன
vivakaaraththu	விவாகரத்து	விளிகின்றது
veesa	வீச	வேசா
veesi	வீசி	வேசி
veechinaar	வீசினார்	விச்சம்
veesinaan	வீசினார்	விட்டின்
veesinaar	வீசினார்	விச்சம்
veechum	வீசும்	விலம்
veesum	வீசும்	விலம்
veechumpoathu	வீசும்போது	விளிகின்றது
veesumpoathu	வீசும்போது	விளிகிறது
veetirku	வீட்டிற்கு	விளிக்கு
veettirgu	வீட்டிற்கு	விளிக்துக்கு
veettirku	வீட்டிற்கு	விளிக்துக்கு
veeraraagavan	வீரராகவன்	விளங்களில்
veeraraakavan	வீரராகவன்	விளங்களில்
veeraraghavan	வீரராகவன்	விளங்களில்
veeraraagavum	வீரராகவும்	விளை்களும்
veeraraakavum	வீரராகவும்	விளை்களும்
veetriruntha	வீற்றிருந்த	விளிக்பதாக
veetrtriruntha	வீற்றிருந்த	விளிக்பதாக
veettriruntha	வீற்றிருந்த	விளிக்பதாக
veelchchi	வீழ்ச்சி	விட்டியி
veerzhchchi	வீழ்ச்சி	விளி்கியி
veezhchchi	வீழ்ச்சி	விட்டியி
veelchchikku	வீழ்ச்சிக்கு	விளிக்ப்பு
veerzhchchikku	வீழ்ச்சிக்கு	விளிக்கப்படு
veezhchchikku	வீழ்ச்சிக்கு	விளிக்ப்பு
veelchchiyaal	வீழ்ச்சியால்	விளங்குகள்
veezhchchiyaal	வீழ்ச்சியால்	விளங்குகள்
veelchchiyai	வீழ்ச்சியை	விளிய்கையை
veezhchchiyai	வீழ்ச்சியை	விளிய்கையை
veelnththa	வீழ்ந்த	விருந்த
veezhntha	வீழ்ந்த	விருந்த
veelnththathil	வீழ்ந்ததில்	விளங்குகள்
veezhnthathil	வீழ்ந்ததில்	விளங்கியல்
veelnththaar	வீழ்ந்தார்	விளங்களால்
veezhnthaar	வீழ்ந்தார்	விளியாகவர்
veelnththu	வீழ்ந்து	விரிந்து
veezhnthu	வீழ்ந்து	விருந்து
vekkai	வெக்கை	விக்யா
vedikka	வெடிக்க	விளையாக
vedikkaatha	வெடிக்காத	நிருவிற்க
vedikkumpoathu	வெடிக்கும்போது	விளியிடுகிறது
vettiya	வெட்டிய	விஜ்விய
vettiyaan	வெட்டியான்	விட்டியில்
veppa	வெப்ப	விஜாமா
veppak	வெப்பக்	விட்டார்
calanam	வெப்பச்	காலம்
chalanam	வெப்பச்	பாடம்
salanam	வெப்பச்	பாடம்
veppach	வெப்பச்	விட்டின்
veppath	வெப்பத்	விட்டி்
veppaththaal	வெப்பத்தால்	விளங்களால்
veppaththil	வெப்பத்தில்	விளங்களில்
veppaththai	வெப்பத்தை	விளை்களை
veppaththaik	வெப்பத்தைக்	விளங்களால்
veppamaana	வெப்பமான	விருவாாக
veppamaanathu	வெப்பமானது	விளிகின்றது
veppamum	வெப்பமும்	விர்க்கும்
veppam	வெப்பம்	விட்டம்
veruththu	வெறுத்து	விருந்து
verumaiyaana	வெறுமையான	நிகழ்ந்தா
vetrikaramaakath	வெற்றிகரமாகத்	விள்விக்கான
vetrtrigaramaagath	வெற்றிகரமாகத்	விள்விக்கான
vetrtrikaramaakath	வெற்றிகரமாகத்	விள்விக்களை
vetrikaramaakap	வெற்றிகரமாகப்	விள்விக்கார்
vetrtrigaramaagap	வெற்றிகரமாகப்	விள்விக்கார்
vetrtrikaramaakap	வெற்றிகரமாகப்	விள்விக்கார்
velippadaiyaana	வெளிப்படையான	விள்விக்கான
velippataiyaana	வெளிப்படையான	விளிக்கினார
velipppadaiyaana	வெளிப்படையான	விளிக்கின்றன
velippaadae	வெளிப்பாடே	விளிக்கையை
velippura	வெளிப்புற	விருவிக்கா
velippurak	வெளிப்புறக்	விள்விக்கார்
velippurath	வெளிப்புறத்	விள்விக்கான
velippuraththil	வெளிப்புறத்தில்	விள்விட்டத்தில்
velippuramaaga	வெளிப்புறமாக	விளிக்க்காக
veliyaagi	வெளியாகி	விட்டியி
veliyaaki	வெளியாகி	விட்டியி
veliyaagina	வெளியாகின	விளிமையை
veliyaakina	வெளியாகின	விளிமையை
veliyidappatta	வெளியிடப்பட்ட	விளிய்கப்பட்ட
veliyidappattadhu	வெளியிடப்பட்டது	விளியிடுகின்றன
veliyidappattathu	வெளியிடப்பட்டது	விளியிடப்பட்டு
veliyidappattu	வெளியிடப்பட்டு	விளி்குகின்றன
vaedkai	வேட்கை	வாட்டி
vaetgai	வேட்கை	வாட்டி
vaetkai	வேட்கை	வாட்டி
vaedkaiyil	வேட்கையில்	வாட்டியில்
vaetkaiyil	வேட்கையில்	வாட்டியில்
vaedhangkalin	வேதங்களின்	வாட்டியில்
vaethangalin	வேதங்களின்	வாட்களில்
vaethangkalin	வேதங்களின்	வாட்களில்
vaedhangkalai	வேதங்களை	வாட்டுகளை
vaethangalai	வேதங்களை	வாட்கதை
vaethangkalai	வேதங்களை	வாட்டியை
vaedhangkalaiyum	வேதங்களையும்	விளங்களாகும்
vaethangalaiyum	வேதங்களையும்	விளங்களாலும்
vaethangkalaiyum	வேதங்களையும்	விளங்களாகும்
vaedhangkal	வேதங்கள்	வாட்டியல்
vaethangal	வேதங்கள்	வாட்டியம்
vaethangkal	வேதங்கள்	வாட்டியல்
vaedham	வேதம்	வேலம்
vaetham	வேதம்	நாடம்
vedam	வேதம்	வேலம்
vedham	வேதம்	வேலம்
vaedhaala	வேதாள	நாட்ட
vaethaala	வேதாள	நாட்ட
vedhaala	வேதாள	நிகா
vaedhik	வேதிக்	நாட்ட்
vaethik	வேதிக்	நாட்ட்
vaedhiya	வேதிய	விக்யா
vaethiya	வேதிய	நாட்டி
vaeyappatta	வேயப்பட்ட	விளிக்பாட
vaeril	வேரில்	நேடன்
giragavaasiyaa	வேற்று	கால்மிரியா
gragavaasiyaa	வேற்று	கால்மிரியா
kiragavaasiyaa	வேற்று	கால்மிரியா
kirakavaasiyaa	வேற்று	கால்மிரியா
kirakavaciya	வேற்று	காட்டி்தி
vaeloor	வேலூர்	விட்டர்
vellore	வேலூர்	விட்டின்
vaelaigalilum	வேலைகளிலும்	விளங்களாலும்
vaelaikalilum	வேலைகளிலும்	விளங்களாலும்
vaelaigalil	வேலைகளில்	வாட்டியில்
vaelaikalil	வேலைகளில்	வாட்டியில்
vaelaigalukku	வேலைகளுக்கு	விளைக்பட்டு
vaelaikalukku	வேலைகளுக்கு	விளை்கிற்கு
vaelaigalaiyum	வேலைகளையும்	விளங்களாலும்
vaelaikalaiyum	வேலைகளையும்	விளங்களாலும்
vaelaigal	வேலைகள்	வேட்டர்
vaelaikal	வேலைகள்	வேட்டர்
vaelaikkaaga	வேலைக்காக	நிறுவியாக
vaelaikkaaka	வேலைக்காக	நிறுவிகா
vaelaikku	வேலைக்கு	நிறைய்து
chellavum	வேலைக்குச்	செல்களும்
vaelaikkuch	வேலைக்குச்	விளங்களில்
vealaikkuch	வேலைக்குச்	விளங்களில்
thittangalukku	வேலைத்	திருப்பி்பட்டு
thittangkalukku	வேலைத்	திருப்பி்பட்டு
thittaththin	வேலைத்	திருக்கியின்
tittankalukku	வேலைத்	திருப்பி்பட்டு
vaelaiththittangal	வேலைத்திட்டங்கள்	விளைய்புக்களில்
vaelaiththittanggal	வேலைத்திட்டங்கள்	நிறுக்குக்களில்
vaelaiththittangkal	வேலைத்திட்டங்கள்	நிறுக்குக்களில்
vaelaiyilirunththu	வேலையிலிருந்து	விளியிடுகின்றன
vaelaiyilirunthu	வேலையிலிருந்து	விளியிடுகிறது
vealaiyilirunthu	வேலையிலிருந்து	விளியிடுக்க்கு
vaelaiyum	வேலையும்	விட்டும்
vealaiyum	வேலையும்	விட்டும்
vaelaangganni	வேளாங்கண்ணி	விள்வி்தி
vaelaangkanni	வேளாங்கண்ணி	நிரும்ப்டி
vealaankanni	வேளாங்கண்ணி	நிரும்ப்டி
velankanni	வேளாங்கண்ணி	நிரும்ப்டி
vaiguntaththil	வைகுண்டத்தில்	நாட்ட்கத்தின்
vaikundaththil	வைகுண்டத்தில்	நிறுப்பத்தில்
vaiguntam	வைகுண்டம்	வேட்டாகம்
vaikundam	வைகுண்டம்	விளை்களும்
vaiko	வைகோ	வேசி
vaikoa	வைகோ	விஜா
vaibava	வைபவ	வாகா
vaipava	வைபவ	வேகா
vaibav	வைபவ்	நாய்
vaibhav	வைபவ்	வாக்
vaipav	வைபவ்	வாட்
shaa	ஷா	சே
shah	ஷா	சியா
shaavin	ஷாவின்	சிரின்
shahvin	ஷாவின்	சிர்சி்
shavin	ஷாவின்	சின்
scot	ஸ்காட்	சிச்
scott	ஸ்காட்	பிரிட்
skaat	ஸ்காட்	ஸ்டான்
skad	ஸ்காட்	சிச்்
spais	ஸ்பைஸ்	ஜோஸ்
spice	ஸ்பைஸ்	ஸ்டீர்
shreenivaacha	ஸ்ரீநிவாச	ஸ்டீராவிய
sreenivaasa	ஸ்ரீநிவாச	ஸ்டீட்டியா
srinivaacha	ஸ்ரீநிவாச	ஸ்டீராவிய
srinivaasa	ஸ்ரீநிவாச	ஸ்டீட்டி
srinivasa	ஸ்ரீநிவாச	ஸ்டீட்டி
shreerangkam	ஸ்ரீரங்கம்	சிர்சிகள்
sreerangam	ஸ்ரீரங்கம்	சிர்சிகளும்
srirangam	ஸ்ரீரங்கம்	சிர்சிகளும்
sriranggam	ஸ்ரீரங்கம்	சிர்சிகளும்
srirangkam	ஸ்ரீரங்கம்	சிர்சிகள்
svaram	ஸ்வரம்	சிர்ம்
swaram	ஸ்வரம்	சிய்கம்
sveet	ஸ்வீட்	ஸ்டீர்
sviid	ஸ்வீட்	ஸ்டீப்
sweet	ஸ்வீட்	ஸ்டீப்
swiit	ஸ்வீட்	பிரிட்
hangari	ஹங்கேரி	முக்கிய
hangary	ஹங்கேரி	முக்கி
hanggaeri	ஹங்கேரி	முக்கிய
hankeari	ஹங்கேரி	மிக்கோடி
hankeeri	ஹங்கேரி	மிக்கோடி
hungaeri	ஹங்கேரி	முக்கிய
hungari	ஹங்கேரி	முக்்சி
hungarii	ஹங்கேரி	முக்்தி
hungary	ஹங்கேரி	முக்கி
hungeery	ஹங்கேரி	முச்சிசி
hungeri	ஹங்கேரி	மிக்கோட்
hungery	ஹங்கேரி	மிக்கோபி
huungarii	ஹங்கேரி	முக்்தி
huungary	ஹங்கேரி	முக்கி
huungery	ஹங்கேரி	முச்சிசி
handar	ஹண்டர்	மிட்டர்
hantar	ஹண்டர்	மிட்டர்
hanter	ஹண்டர்	ஹாட்டர்
huntar	ஹண்டர்	மிக்கர்
huntarr	ஹண்டர்	மில்வின்
hunter	ஹண்டர்	ஹாட்டர்
hunterr	ஹண்டர்	ஹாஸ்டிடர்
huuntar	ஹண்டர்	மிட்டர்
huunter	ஹண்டர்	மிப்டர்
huunterr	ஹண்டர்	மாச்சியன்
hampi	ஹம்பி	ஹிக்கி
haam	ஹாம்	மேக்
haem	ஹாம்	ஹாட்
haim	ஹாம்	ஹாட்
ham	ஹாம்	மேக்
hamm	ஹாம்	மேட்
haum	ஹாம்	மே
hauum	ஹாம்	மாட்
haym	ஹாம்	மேக்
hom	ஹாம்	மே
home	ஹாம்	மேச்
haarisan	ஹாரிசன்	ராஜ்டி்
haarison	ஹாரிசன்	மார்ட்
haarisun	ஹாரிசன்	ஹாட்டின்
hareeson	ஹாரிசன்	ஹாட்ட்
harisan	ஹாரிசன்	ஹாட்ட்
harisaun	ஹாரிசன்	ஹாட்டின்
harison	ஹாரிசன்	ஹாட்ட்
harreeson	ஹாரிசன்	ஹாஸ்டர்
harriison	ஹாரிசன்	மாச்சின்
harrisaun	ஹாரிசன்	மாச்சியின்
harrisauun	ஹாரிசன்	மிர்ட்டின்
harrison	ஹாரிசன்	மாச்சின்
he	ஹி	ஹே
hi	ஹி	ஹே
hills	ஹில்ஸ்	ஹாஸ்ட்
hils	ஹில்ஸ்	ஹாஸ்
hook	ஹூக்	ஹாட்
hooq	ஹூக்	ஹாட்
huk	ஹூக்	ஹாட்
huuk	ஹூக்	ஹாட்
helsiinkii	ஹெல்சின்கி	மிக்கிரியி
helsinki	ஹெல்சின்கி	மிக்கிரிய்
helsinqi	ஹெல்சின்கி	மிக்கிரிய்
health	ஹெல்த்	மேட்
haerath	ஹேரத்	மேட்
hearath	ஹேரத்	மேட்
herath	ஹேரத்	மேட்
heyrath	ஹேரத்	மேட்
haikkoo	ஹைக்கூ	ஹிக்கி
haiku	ஹைக்கூ	மோடு
hikkoo	ஹைக்கூ	ஹாட்டி
haidrookarpan	ஹைட்ரோகார்பன்	மில்விட்டின்
hidrocarbon	ஹைட்ரோகார்பன்	மா்்பிட்டின்
hydrocarbon	ஹைட்ரோகார்பன்	மா்்பிட்டின்
hydroocarboon	ஹைட்ரோகார்பன்	மா்பாட்டின்
hoali	ஹோலி	மியா
holee	ஹோலி	ஹாடி
holey	ஹோலி	ஹாட்
holi	ஹோலி	ஹாடி
holii	ஹோலி	ஹாடி
hollee	ஹோலி	மிக்கி
hollei	ஹோலி	ஹிக்கி
holley	ஹோலி	மிக்கி
holli	ஹோலி	ஹிக்கி
hollii	ஹோலி	ஹிக்கி
holly	ஹோலி	ஹாட்டி
holy	ஹோலி	ஹாட்
hooli	ஹோலி	மியா
hoolii	ஹோலி	மியா
hoollee	ஹோலி	மிக்கி
hoolley	ஹோலி	மிக்கி
hoolli	ஹோலி	ஹிக்கி
hoolly	ஹோலி	ஹாட்டி
hooly	ஹோலி	ஹாடி
huli	ஹோலி	மியா
