Input	Target	Predicted
fire	ஃபயர்	பிரி
phayar	ஃபயர்	பயயர்
baar	ஃபார்	பார்
bar	ஃபார்	பார்
far	ஃபார்	பார்
for	ஃபார்	போர்
hpaar	ஃபார்	பார்
agatrtri	அகற்றி	அகற்றி
agattri	அகற்றி	அகற்றி
akatrtri	அகற்றி	அகற்றி
agatrtrinaar	அகற்றினார்	அகற்றினார்
akatrinaar	அகற்றினார்	அகற்றினார்
akatrtrinaar	அகற்றினார்	அகற்றினார்
academi	அகாதமி	அசாதிமி
academy	அகாதமி	ஆகாடமி
angiekariththathu	அங்கீகரித்தது	அங்கிகரித்தது
angkeekariththathu	அங்கீகரித்தது	அங்கீகரித்தது
angkeegaara	அங்கீகார	அங்கீகார
angkeekaara	அங்கீகார	அங்கீகார
angkeegaaraththai	அங்கீகாரத்தை	அங்கீகாரத்தை
angkeekaaraththai	அங்கீகாரத்தை	அங்கேகாரத்தை
anggeegaaram	அங்கீகாரம்	அங்கீகாரம்
anggeekaaram	அங்கீகாரம்	அங்கீகாரம்
angiekaaram	அங்கீகாரம்	அங்கிகாரம்
angkeekaaram	அங்கீகாரம்	அங்கீகாரம்
asan	அசன்	அசன்
aasin	அசின்	ஆசின்
asin	அசின்	அசின்
asaiyaadha	அசையாத	அசையாத
asaiyaatha	அசையாத	அசையாத
stationaree	அசையாத	ஸ்டாடினாரி
stationari	அசையாத	ஸ்டாட்னோனி
stationarii	அசையாத	ஸ்டாட்னோனி
stationary	அசையாத	ஸ்டாடினாரி
stationri	அசையாத	ஸ்டாட்னின்
stetionaree	அசையாத	ஸ்டெடினாரி
stetionary	அசையாத	ஸ்டெடியன்
stetionri	அசையாத	ஸ்டெட்னின்
asaiaamal	அசையாமல்	அசையாமல்
asaiyaamal	அசையாமல்	அசையாமல்
asaiyamal	அசையாமல்	அசையமால்
ashoka	அசோக	அசோகா
asoga	அசோக	அசோகா
asoka	அசோக	அசோகா
ashokarin	அசோகரின்	அசோகரின்
asokarin	அசோகரின்	அசோகரின்
ashokar	அசோகர்	அசோகர்
asokar	அசோகர்	அசோகர்
ajai	அஜய்	அஜை
ajaii	அஜய்	அஜ்யா
ajay	அஜய்	அஜ்யா
aje	அஜய்	ஆஜே
azai	அஜய்	அஜை
azay	அஜய்	அஜே
adakkinaar	அடக்கினார்	அடக்கினார்
adanggiyirukkum	அடங்கியிருக்கும்	அடங்கியிருக்கும்
adangiyirukkum	அடங்கியிருக்கும்	அடங்கியிருக்கும்
adankiyirukkum	அடங்கியிருக்கும்	அடங்கியிருக்கும்
adangkiyullathu	அடங்கியுள்ளது	அடங்கியுள்ளது
adams	அடம்ஸ்	அடாம்
adigalaal	அடிகளால்	அடிகளால்
adigalin	அடிகளின்	அடிகளின்
adigalil	அடிகளில்	அடிகளில்
adikalil	அடிகளில்	அடிகளில்
adigalai	அடிகளை	அடிகளை
adigazhai	அடிகளை	அடிகளை
adikalai	அடிகளை	அடிகளை
adigal	அடிகள்	அடிகள்
adikal	அடிகள்	அடிகள்
adikkadip	அடிக்கடிப்	அடிக்கடிப்
adikkum	அடிக்கும்	அடிக்கும்
adippadaiyilaana	அடிப்படையிலான	அடிப்படையிலான
adippadaiyilaanadhu	அடிப்படையிலானது	அடிப்படையிலானது
adippadaiyilaanathu	அடிப்படையிலானது	அடிப்படையிலானது
adippadiyilaanathu	அடிப்படையிலானது	அடிப்படியிலானது
adiyaaga	அடியாக	அடியாக
adiyaga	அடியாக	அடியாக
adiyaka	அடியாக	அடியாக
adiyin	அடியின்	அடியின்
adiyil	அடியில்	அடியில்
atiyil	அடியில்	அட்டியில்
adiye	அடியே	அடியே
adiyee	அடியே	அடியே
atiyee	அடியே	அட்டி
adiyodu	அடியோடு	அடியோடு
adiyoodu	அடியோடு	அடியோடு
atiyootu	அடியோடு	அடியோடு
adivayirrai	அடிவயிற்றை	அடிவேயிற்றை
adivayitrai	அடிவயிற்றை	அடிவேயிற்றை
adivayittrai	அடிவயிற்றை	அடிவேயிற்றை
ativayirrai	அடிவயிற்றை	அடிவாயிற்றை
addes	அடிஸ்	ஆட்டேஸ்
addis	அடிஸ்	ஆட்டிஸ்
addiss	அடிஸ்	ஆட்டிஸ்
addys	அடிஸ்	ஆட்டிஸ்
addyss	அடிஸ்	ஆட்டிஸ்
ades	அடிஸ்	ஆடேஸ்
adis	அடிஸ்	ஆடிஸ்
adyss	அடிஸ்	ஆட்ட்ஸ்
adukka	அடுக்க	அடுக்க
adukkaaga	அடுக்காக	அடுக்காக
adukkaaka	அடுக்காக	அடுக்காக
atukkaaga	அடுக்காக	அடுக்காக
atukkaaka	அடுக்காக	அடுக்காக
aduththu	அடுத்து	அடுத்து
aduthu	அடுத்து	அடுது
adutthu	அடுத்து	அடுத்து
attaak	அட்டாக்	அட்டாக்
attack	அட்டாக்	அட்டாக்
anivadhae	அணிவதே	அணிவதே
anivadhey	அணிவதே	அணிவதே
anivathae	அணிவதே	அணிவதே
anivathey	அணிவதே	அணிவதே
adhigappadiyaana	அதிகப்படியான	அதிகப்படியான
athigappadiyaana	அதிகப்படியான	அதிகப்படியான
athikappatiyaana	அதிகப்படியான	அதிகப்பட்டியா
adhikamaana	அதிகமான	அதிகாமான
adikamaana	அதிகமான	அடிக்கமான
athikamaana	அதிகமான	அதிகமான
atikamaana	அதிகமான	அடிகமான
adhikamaanavai	அதிகமானவை	அதிகமானவை
athigamaanavai	அதிகமானவை	அதிகமானவை
athikamaanavai	அதிகமானவை	அதிகமானவை
adhikamaanoor	அதிகமானோர்	அதிகாமானூர்
athigamaanoor	அதிகமானோர்	அதிகாமானூர்
athikamaanoar	அதிகமானோர்	அதிகாமானோர்
athiradith	அதிரடித்	அதிரடித்
athiradip	அதிரடிப்	அதிரடிப்
adhilirundhdha	அதிலிருந்த	அதிலிருந்த
athiliruntha	அதிலிருந்த	அதிலிருந்த
adhilulla	அதிலுள்ள	அதிலுள்ள
athilulla	அதிலுள்ள	அதிலுள்ள
adele	அதிலே	அடெல்
adhilae	அதிலே	அதிலே
adhile	அதிலே	அதிலே
athilae	அதிலே	அதிலே
athile	அதிலே	அதிலே
adheedha	அதீத	அதேத
adhidha	அதீத	அதித
atheetha	அதீத	அதேத
athitha	அதீத	அதித
athaepoola	அதேபோல	அதேபோலா
atheepola	அதேபோல	அதீபோலா
athepola	அதேபோல	அத்போலா
advaita	அத்வைத	அட்வைட்ட
advaitha	அத்வைத	அட்வைத்த
athvaidha	அத்வைத	அத்வைத்த
athvaitha	அத்வைத	அத்வைத்த
advaidam	அத்வைதம்	அட்வைடம்
advaitham	அத்வைதம்	அட்வைத்தம்
adwaytham	அத்வைதம்	அட்வாத்தம்
athvaidham	அத்வைதம்	அத்வைதம்
athvaitham	அத்வைதம்	அத்வைதம்
andhach	அந்தச்	அந்தச்
anthac	அந்தச்	அந்தாக்
anthach	அந்தச்	அந்தச்
andhath	அந்தத்	அந்தத்
anthath	அந்தத்	அந்தத்
andham	அந்தம்	அந்தம்
antham	அந்தம்	அந்தம்
andhu	அந்து	அந்து
anthu	அந்து	அந்து
ana	அனா	அனா
anaa	அனா	அனா
anna	அனா	அன்னா
annaa	அனா	அன்னா
anaadhai	அனாதை	அனாதை
anaathai	அனாதை	அனாதை
anaadhaiyaana	அனாதையான	அனாதையான
anaathaiyaana	அனாதையான	அனாதையான
anupallavee	அனுபல்லவி	அனுபல்ளவே
anupallavi	அனுபல்லவி	அணுபல்ளவி
anupazhavee	அனுபல்லவி	அனுபாவேே
anupazhavi	அனுபல்லவி	அணுபாவவி
anubavikkum	அனுபவிக்கும்	அணுபவிக்கும்
anupavikkum	அனுபவிக்கும்	அணுபவிக்கும்
anupavikum	அனுபவிக்கும்	அணுபவிக்கும்
anuraadhapura	அனுராதபுர	அனுராதபுபா
anuraathapura	அனுராதபுர	அனுராதபுபார
anuradhapura	அனுராதபுர	அனுரதபுரு
anurathapura	அனுராதபுர	அனுரதப்புற
anushka	அனுஷ்கா	அனுஷ்கா
anushkaa	அனுஷ்கா	அனுஷ்கா
andriyum	அன்றியும்	அன்றியும்
antriyum	அன்றியும்	அன்றியும்
abaabaa	அபாபா	அபாபா
ababa	அபாபா	அபாபா
abbaba	அபாபா	அப்பா
apapa	அபாபா	அப்பா
aboo	அபூ	அபோ
abu	அபூ	அபு
aboorva	அபூர்வ	அபோர்வா
apoorva	அபூர்வ	அபோர்வா
aboorvamaaga	அபூர்வமாக	அபோர்வமாக
aboorvamaaka	அபூர்வமாக	அபோர்வமாக
aburvamaaka	அபூர்வமாக	அபுர்வமாக
apoorvamaaga	அபூர்வமாக	அபோர்வமாக
apoorvamaaka	அபூர்வமாக	அபோர்வமாக
abdhul	அப்துல்	அப்துல்
abdool	அப்துல்	அப்டோல்
abdul	அப்துல்	அப்டுல்
abduul	அப்துல்	ஆப்டல்
abthul	அப்துல்	அப்துல்
appaguthiyil	அப்பகுதியில்	அப்பகுதியில்
appakuthiil	அப்பகுதியில்	அப்பகுதில்
appakuthiyil	அப்பகுதியில்	அப்பகுதியில்
appaguthiyai	அப்பகுதியை	அப்பகுதியை
appakuthiai	அப்பகுதியை	அப்பகுதியை
appakuthiyai	அப்பகுதியை	அப்பகுதியை
appadaththin	அப்படத்தின்	அப்படத்தின்
appadatthin	அப்படத்தின்	அப்படத்தின்
appadam	அப்படம்	அப்படம்
appen	அப்பெண்	ஆப்பென்
appenn	அப்பெண்	ஆப்பென்
appoluthuthaan	அப்பொழுதுதான்	அப்பொலுத்து
appoluthuthan	அப்பொழுதுதான்	அப்பொலுத்து
appozhuthuthaan	அப்பொழுதுதான்	அப்பொழுத்து
apppozhuthuthaan	அப்பொழுதுதான்	அப்புழ்துதுதான்
aposthalar	அப்போஸ்தலர்	அபோஸ்தலர்
appoashthalar	அப்போஸ்தலர்	அப்போஸ்தலர்
appoosthalar	அப்போஸ்தலர்	அப்போஸ்தலர்
apposthalar	அப்போஸ்தலர்	அப்போஸ்தலர்
americargalin	அமெரிக்கர்களின்	அமேரிக்கர்களின்
americarkalin	அமெரிக்கர்களின்	அமேரிக்கர்களின்
amerikkargalin	அமெரிக்கர்களின்	அமேரிக்கர்களின்
amerikkarkalin	அமெரிக்கர்களின்	அமேரிக்கர்களின்
americaavin	அமெரிக்காவின்	அமெரிக்காவின்
americavin	அமெரிக்காவின்	அமெரிக்காவின்
amerikkaavin	அமெரிக்காவின்	அமெரிக்காவின்
americaavirkum	அமெரிக்காவிற்கும்	அமெரிக்காவிற்கும்
americavirkkum	அமெரிக்காவிற்கும்	அமெரிக்கவிர்க்கும்
americavirkum	அமெரிக்காவிற்கும்	அமெரிச்கவிர்கும்
amerikkaavirkum	அமெரிக்காவிற்கும்	அமெரிக்காவிற்கும்
americaavilum	அமெரிக்காவிலும்	அமெரிச்காவிலும்
americavilum	அமெரிக்காவிலும்	அமெரிச்சவிலும்
amerikkaavilum	அமெரிக்காவிலும்	அமெரிக்காவிலும்
americaavilulla	அமெரிக்காவிலுள்ள	அமெரிச்காவிலுள்ள
americavilulla	அமெரிக்காவிலுள்ள	அமெரிச்சவில்லா
amerikkaavilulla	அமெரிக்காவிலுள்ள	அமெரிக்காவிலுள்ள
americaavudan	அமெரிக்காவுடன்	அமெரிக்காவேன்
americavudan	அமெரிக்காவுடன்	அமெரிக்கவாடன்
amerikkaavudan	அமெரிக்காவுடன்	அமேரிக்காவுடன்
americaavum	அமெரிக்காவும்	அமேரிக்காவும்
americavum	அமெரிக்காவும்	அமேரிக்கவும்
amerikkaavum	அமெரிக்காவும்	அமேரிக்காவும்
amaichchu	அமைச்சு	அமைச்சு
amaichu	அமைச்சு	அமைச்சு
amaiththup	அமைத்துப்	அமைத்துப்
amaithup	அமைத்துப்	அமைத்துப்
amaitthup	அமைத்துப்	அமைத்துப்
amaiththum	அமைத்தும்	அமைத்தும்
amaithum	அமைத்தும்	அமைத்தும்
amaitthum	அமைத்தும்	அமைத்தும்
perrullatu	அமையப்	பெற்ளுள்டு
petrtrullathu	அமையப்	பெற்றுள்ளது
petrullathu	அமையப்	பெற்றுள்ளது
amsa	அம்ச	அம்சா
amchankalaaka	அம்சங்களாக	அம்சங்களாக
amchankalaka	அம்சங்களாக	அம்சங்களாக
amsangalaaga	அம்சங்களாக	அம்சங்களாக
amsangkalaaka	அம்சங்களாக	அம்சங்களாக
amachankalin	அம்சங்களின்	அமச்கங்களின்
amasankalin	அம்சங்களின்	அமசன்களின்
amsangalin	அம்சங்களின்	அம்சங்களின்
amsangkalin	அம்சங்களின்	அம்சங்களின்
amchankalai	அம்சங்களை	அம்சங்களை
amsangalai	அம்சங்களை	அம்சங்களை
amsankalai	அம்சங்களை	அம்சங்களை
amsangalaiyum	அம்சங்களையும்	அம்சங்களையும்
amsangazhaiyum	அம்சங்களையும்	அம்சங்களையும்
amsanggalaiyum	அம்சங்களையும்	அம்சங்களையும்
amsangal	அம்சங்கள்	அம்சங்கள்
amsangazh	அம்சங்கள்	அம்சங்கள்
amsanggal	அம்சங்கள்	அம்சங்கள்
amsamaaga	அம்சமாக	அம்சமாக
amcham	அம்சம்	அம்சம்
amsam	அம்சம்	அம்சம்
ammonium	அம்மோனியம்	அம்மோனியம்
ammoniumm	அம்மோனியம்	அம்மோனிம்
ammoniuum	அம்மோனியம்	அம்மோனியம்
ammoniuumm	அம்மோனியம்	அம்மோனியம்
ammoonium	அம்மோனியம்	அம்மூனியம்
ammooniumm	அம்மோனியம்	அம்மூனிம்
ammooniyam	அம்மோனியம்	அம்மூனியம்
amoniam	அம்மோனியம்	அமோனியம்
amoniamm	அம்மோனியம்	அமோனியம்
amonium	அம்மோனியம்	அமோனியம்
amoniuum	அம்மோனியம்	அமோனியம்
amonnium	அம்மோனியம்	அமோனியம்
amonniuum	அம்மோனியம்	அமோனியம்
amooniamm	அம்மோனியம்	அமோனியம்
amoonium	அம்மோனியம்	அமோனியம்
amoonnium	அம்மோனியம்	அமோனியம்
ammonia	அம்மோனியா	அம்மோனியா
ammoniaa	அம்மோனியா	அம்மோனியா
ammoniia	அம்மோனியா	அம்மோனியா
ammoonia	அம்மோனியா	அம்மூனியா
ammooniaa	அம்மோனியா	அம்மூனியா
ammooniia	அம்மோனியா	அம்மூனியா
ammooniya	அம்மோனியா	அம்மூனியா
amonia	அம்மோனியா	அமோனியா
amoniaa	அம்மோனியா	அமோனியா
amoniia	அம்மோனியா	அமோனியா
amoonia	அம்மோனியா	அமோனியா
arakkanai	அரக்கனை	அரக்கனை
arrakkanai	அரக்கனை	அர்காக்கானை
aruga	அருக	அருக
aruka	அருக	அருக
arugaaga	அருகாக	அருகாக
arukaaka	அருகாக	அருகாக
arukaka	அருகாக	அருகாக
aarun	அருண்	ஆருன்
aaruun	அருண்	ஆருன்
aroon	அருண்	அரோன்
arrun	அருண்	அர்ன்
arruun	அருண்	அருரன்
arun	அருண்	அருன்
arunn	அருண்	அருன்
aruun	அருண்	அருன்
aruunn	அருண்	அருன்
vijai	அருண்	விஜை
vijay	அருண்	விஜய்
arundhi	அருந்தி	அருந்தி
arunthi	அருந்தி	அருந்தி
arppaniththaar	அர்ப்பணித்தார்	அற்ப்பாணித்தார்
arppaniththu	அர்ப்பணித்து	அற்ப்பணித்து
arimuga	அறிமுகம	அறிமுக
arimugama	அறிமுகம	அறிமுகமா
arimuka	அறிமுகம	அறிமுக
mudikirathu	அறிய	முடிகிறது
mudiyaatha	அறிய	முடியாத
mutikiratu	அறிய	முட்டிகிறது
mutiyata	அறிய	முட்டியா
ariyak	அறியக்	அரியக்
ariyakkoodiya	அறியக்கூடிய	அறியக்கூடிய
ariyappadum	அறியப்படும்	அறியப்படும்
ariyappattavar	அறியப்பட்டவர்	அறியப்பட்டவர்
ariyappattaar	அறியப்பட்டார்	அறியப்பட்டார்
ariyappattaalum	அறியப்பட்டாலும்	அறியப்பட்டாலும்
ariyappattulladhu	அறியப்பட்டுள்ளது	அறியப்பட்டுள்ளது
ariyappattullathu	அறியப்பட்டுள்ளது	அறியப்பட்டுள்ளது
ariyavillai	அறியவில்லை	அறியவில்லை
ariyavum	அறியவும்	அறியவும்
ariyaa	அறியா	அரியா
ariyaamal	அறியாமல்	அரியாமல்
arivadhil	அறிவதில்	அரிவதில்
arivathaal	அறிவதில்	அறிவதால்
arivathil	அறிவதில்	அறிவதில்
arivaar	அறிவார்	அறிவார்
arivaal	அறிவால்	அறிவால்
arivippu	அறிவிப்பு	அறிவிப்பு
arivippugal	அறிவிப்புகள்	அறிவிப்புகள்
arivippukal	அறிவிப்புகள்	அறிவிப்புகள்
arivippup	அறிவிப்புப்	அறிவிப்புப்
arivae	அறிவே	அறிவே
arupathu	அறுபது	அருபது
ali	அலி	அலி
alii	அலி	அலி
aligaar	அலிகார்	அலிகார்
aligar	அலிகார்	அலிகர்
aligarh	அலிகார்	அலிகர்
alikaar	அலிகார்	அலிகார்
aliyin	அலியின்	அலியின்
aliyai	அலியை	அலியை
alboansaa	அல்போன்சா	அல்போன்சா
alphonse	அல்போன்சா	ஆல்பன்சி
alpoansaa	அல்போன்சா	அல்போன்சா
alavu	அளவு	அலவு
alavugalail	அளவுகளில்	அலவுகளைல்
alavugalil	அளவுகளில்	அலவுகளில்
alavukalil	அளவுகளில்	அலவுகளில்
alavugalaik	அளவுகளைக்	அலவுகளைக்
alavukalaik	அளவுகளைக்	அலவுகளைக்
alavugalaiyum	அளவுகளையும்	அலவுகளையும்
alavukalaiyum	அளவுகளையும்	அலவுகளையும்
alavukkaana	அளவுக்கான	அலவுக்கான
alavukku	அளவுக்கு	அழவுக்கு
alavudan	அளவுடன்	அலவுடன்
alavum	அளவும்	அலவும்
azhiththa	அழித்த	அழித்த
azhiththal	அழித்தல்	அழித்தல்
alaippugalai	அழைப்புகளை	அலைப்புகளை
alaippukalai	அழைப்புகளை	அலைப்புகளை
azhaippukalai	அழைப்புகளை	அழைப்புகளை
alaippugal	அழைப்புகள்	அலைப்புகள்
alaippukal	அழைப்புகள்	அலைப்புகள்
azhaippukal	அழைப்புகள்	அழைப்புகள்
avadhaara	அவதார	அவதார
avathaara	அவதார	அவதார
avathaaranggalai	அவதாரங்களை	அவதாரங்களை
avathaarangkalai	அவதாரங்களை	அவதாரங்களை
avathaaramaaga	அவதாரமாக	அவதாரமாக
avathaaramaaka	அவதாரமாக	அவதாரமாக
avathaaramaana	அவதாரமான	அவதாரமான
avadhaaram	அவதாரம்	அவதாரம்
avathaaram	அவதாரம்	அவதாரம்
avaraagavae	அவராகவே	அவராகவே
avaraakavae	அவராகவே	அவராகவே
avaridamae	அவரிடமே	அவரிடமே
avaritamae	அவரிடமே	அவரிடமே
avatrtrul	அவற்றுள்	அவற்றுள்
avatrul	அவற்றுள்	அவற்றுள்
avattrul	அவற்றுள்	அவற்றுள்
avalum	அவளும்	அவலும்
avalai	அவளை	அவலை
astro	அஸ்ட்ரோ	ஆஸ்டரோ
astroa	அஸ்ட்ரோ	ஆஸ்ட்ரோ
aagindradhu	ஆகின்றது	ஆகின்றது
aagindrathu	ஆகின்றது	ஆகின்றது
aakinrathu	ஆகின்றது	ஆகின்றது
aakintrathu	ஆகின்றது	ஆகின்றது
aasirama	ஆசிரம	ஆசிரமா
aasiramaththin	ஆசிரமத்தின்	ஆசிரமத்தின்
aachiramaththai	ஆசிரமத்தை	ஆசிரமாத்தை
aasiramaththai	ஆசிரமத்தை	ஆசிரமத்தை
aachiriyaraaka	ஆசிரியராக	ஆசிரியராக
aasiriyaraaga	ஆசிரியராக	ஆசிரியராக
aasiriyaraaka	ஆசிரியராக	ஆசிரியராக
assiriyaraaga	ஆசிரியராக	அசிரியராக
aasiriyaraakak	ஆசிரியராகக்	ஆசிரியராகக்
assiriyaraagak	ஆசிரியராகக்	அசிரியராகக்
asar	ஆசேர்	அசர்
aseer	ஆசேர்	ஆசர்
aser	ஆசேர்	ஆசர்
ashar	ஆசேர்	அஷ்
asher	ஆசேர்	ஆஸ்
iser	ஆசேர்	ஐஸ்
ysar	ஆசேர்	சார்
yseer	ஆசேர்	சேர்
yser	ஆசேர்	சேர்
ysher	ஆசேர்	ஷேர்
aadi	ஆடி	ஆடி
aadii	ஆடி	ஆடி
adi	ஆடி	அடி
adii	ஆடி	அடி
aodi	ஆடி	ஆடி
aodii	ஆடி	ஆடி
audi	ஆடி	ஆடி
audii	ஆடி	ஆடி
auudi	ஆடி	ஆடி
avdi	ஆடி	அவிடி
awdi	ஆடி	அவிடி
awdii	ஆடி	அவிடி
maatham	ஆடி	மாதம்
matam	ஆடி	மட்ம்
aadu	ஆடு	ஆடு
aadukalin	ஆடுகளின்	ஆடுகளின்
aadugalukku	ஆடுகளுக்கு	ஆடுகளுக்கு
aadukalukku	ஆடுகளுக்கு	ஆடுகளுக்கு
aadugalai	ஆடுகளை	ஆடுகளை
aadukalai	ஆடுகளை	ஆடுகளை
aadugal	ஆடுகள்	ஆடுகள்
aadukal	ஆடுகள்	ஆடுகள்
aanaagap	ஆணாகப்	ஆணாகப்
aanaakap	ஆணாகப்	ஆணாகப்
kulantai	ஆண்	குலந்தை
kulanthai	ஆண்	குழந்தை
kuzhandhai	ஆண்	குழந்தை
aangalil	ஆண்களில்	ஆங்களில்
aankalil	ஆண்களில்	ஆங்களில்
aangalikku	ஆண்களுக்கு	ஆங்களிக்கு
aangalukku	ஆண்களுக்கு	ஆங்களுக்கு
aangalukkum	ஆண்களுக்கும்	ஆங்களுக்கும்
aankalukkum	ஆண்களுக்கும்	ஆங்களுக்கும்
aangaludan	ஆண்களுடன்	ஆங்களுடன்
aankaludan	ஆண்களுடன்	ஆங்களுடன்
aangalai	ஆண்களை	ஆங்களை
aankalai	ஆண்களை	ஆங்களை
aangalaiyum	ஆண்களையும்	ஆங்களையும்
aankalaiyum	ஆண்களையும்	ஆங்களையும்
aankaliayum	ஆண்களையும்	ஆங்களியும்
aandaan	ஆண்டான்	ஆண்டான்
aantaan	ஆண்டான்	ஆண்டான்
aandaar	ஆண்டார்	ஆண்டார்
aantaar	ஆண்டார்	ஆண்டார்
aadhanaal	ஆதனால்	ஆதனால்
aathanaal	ஆதனால்	ஆதனால்
aatharavaliththa	ஆதரவளித்த	ஆதரவளித்த
aatharavaliththu	ஆதரவளித்து	ஆதரவளித்து
aatharavaagap	ஆதரவாகப்	ஆதரவாகப்
aatharavaakap	ஆதரவாகப்	ஆதரவாகப்
aatharavaap	ஆதரவாகப்	ஆதரவாப்
aatharavaagavum	ஆதரவாகவும்	ஆதரவாகவும்
aatharavaakavum	ஆதரவாகவும்	ஆதரவாகவும்
aatharavin	ஆதரவின்	ஆதரவின்
aatharavil	ஆதரவில்	ஆதரவில்
aatharikka	ஆதரிக்க	ஆதரிக்க
aatharikkum	ஆதரிக்கும்	ஆதரிக்கும்
aathmaavum	ஆத்மாவும்	ஆத்மாவும்
aathmaavai	ஆத்மாவை	ஆத்மாவை
aanthaigal	ஆந்தைகள்	ஆந்தைகள்
aanthaikal	ஆந்தைகள்	ஆந்தைகள்
aanththaigal	ஆந்தைகள்	ஆந்தைகள்
aanththaikal	ஆந்தைகள்	ஆந்தைகள்
aanand	ஆனந்த்	ஆனண்ட்
aananth	ஆனந்த்	ஆனந்த்
aananthdh	ஆனந்த்	ஆனந்த்
aananthth	ஆனந்த்	ஆனந்த்
anand	ஆனந்த்	அன்்
anandd	ஆனந்த்	அன்ட்
anandh	ஆனந்த்	அனந்த்
anannd	ஆனந்த்	அன்ண்ட்
annt	ஆனந்த்	ஆண்ட்
aanmaavin	ஆன்மாவின்	ஆண்மாவின்
aanmaavai	ஆன்மாவை	ஆண்மாவை
aabathaithk	ஆபத்தைக்	ஆபதைத்
aabaththaik	ஆபத்தைக்	ஆபத்தைக்
aapaththaik	ஆபத்தைக்	ஆபத்தைக்
aapgaaniya	ஆப்கானிய	ஆப்காணிய
aapkaaniya	ஆப்கானிய	ஆப்காணிய
afghaaniya	ஆப்கானிய	அப்கானியா
afghaniya	ஆப்கானிய	அப்கானியா
aappirikkaa	ஆப்பிரிக்கா	ஆப்பிரிக்கா
aaprikkaa	ஆப்பிரிக்கா	ஆப்ரிக்கா
affrica	ஆப்பிரிக்கா	ஆப்பிரிகா
afreca	ஆப்பிரிக்கா	ஆப்ரிகா
africa	ஆப்பிரிக்கா	ஆபிரிக்கா
africaa	ஆப்பிரிக்கா	அப்ரிகா
afrika	ஆப்பிரிக்கா	ஆபிரிக்கா
afriqa	ஆப்பிரிக்கா	ஆபிரிக்கா
aphphrica	ஆப்பிரிக்கா	அப்பிரிகா
aphreca	ஆப்பிரிக்கா	அப்ரிகா
aphrica	ஆப்பிரிக்கா	அப்ரிகா
aphricaa	ஆப்பிரிக்கா	அப்ரிகா
aphrika	ஆப்பிரிக்கா	அப்ரிக்கா
appirikka	ஆப்பிரிக்கா	அப்பிரிக்க
appricaa	ஆப்பிரிக்கா	அப்பிரிகா
efrica	ஆப்பிரிக்கா	எப்ரிக்கா
ephrica	ஆப்பிரிக்கா	எப்ரிகா
aappirikkaavin	ஆப்பிரிக்காவின்	ஆப்பிரிக்காவின்
africaavin	ஆப்பிரிக்காவின்	ஆப்ரிக்காவின்
aappirikkaavil	ஆப்பிரிக்காவில்	ஆப்பிரிக்காவில்
africaavil	ஆப்பிரிக்காவில்	அப்ரிக்காவில்
africavil	ஆப்பிரிக்காவில்	அப்ரிக்காவில்
ain	ஆயின்	அன்
ainn	ஆயின்	ஐன்
ayin	ஆயின்	அயின்
ein	ஆயின்	என்
einn	ஆயின்	என்
en	ஆயின்	என்
enn	ஆயின்	என்
aayerak	ஆயிரக்	ஆயரரக்
aayirak	ஆயிரக்	ஆயிரக்
aayeraththil	ஆயிரத்தில்	ஆயரரத்தில்
aayiraththil	ஆயிரத்தில்	ஆயிரத்தில்
aayut	ஆயுட்	ஆயுட்
out	ஆயுட்	ஓட்
aaivu	ஆய்வு	ஆய்வு
aayvu	ஆய்வு	ஆய்வு
aaivukalilum	ஆய்வுகளிலும்	ஆய்வுகளிலும்
aayvugalilum	ஆய்வுகளிலும்	ஆய்வுகளிலும்
aayvukalilum	ஆய்வுகளிலும்	ஆய்வுகளிலும்
aaivukalil	ஆய்வுகளில்	ஆய்வுகளில்
aayvugalil	ஆய்வுகளில்	ஆய்வுகளில்
aayvukalil	ஆய்வுகளில்	ஆய்வுகளில்
aaivukalum	ஆய்வுகளும்	ஆய்வுகளும்
aayvugalum	ஆய்வுகளும்	ஆய்வுகளும்
aayvukalum	ஆய்வுகளும்	ஆய்வுகளும்
aaivukalai	ஆய்வுகளை	ஆய்வுகளை
aayvugalai	ஆய்வுகளை	ஆய்வுகளை
aayvukalai	ஆய்வுகளை	ஆய்வுகளை
aaivukkum	ஆய்வுக்கும்	ஆய்வுக்கும்
aayvukkum	ஆய்வுக்கும்	ஆய்வுக்கும்
aaivuch	ஆய்வுச்	ஆய்வுச்
aayvuch	ஆய்வுச்	ஆய்வுச்
aaivup	ஆய்வுப்	ஆய்வுப்
aayvup	ஆய்வுப்	ஆய்வுப்
aaraathanaa	ஆராதனா	ஆராதனா
aradhana	ஆராதனா	அரதான
aaraayndha	ஆராய்ந்த	ஆராயந்த
aaraayntha	ஆராய்ந்த	ஆராயந்த
aaraaynththa	ஆராய்ந்த	ஆராய்ந்த
aaraayndhanar	ஆராய்ந்தனர்	ஆராயந்தனர்
aaraaynthanar	ஆராய்ந்தனர்	ஆராயந்தனர்
aaraaynththanar	ஆராய்ந்தனர்	ஆராயந்தனர்
aaraainthaar	ஆராய்ந்தார்	ஆராயந்தார்
aaraaynthaar	ஆராய்ந்தார்	ஆராய்ந்தார்
aaraaynththaar	ஆராய்ந்தார்	ஆராய்ந்தார்
aaraainthu	ஆராய்ந்து	ஆராயந்து
aaraaynthu	ஆராய்ந்து	ஆராய்ந்து
araaynththu	ஆராய்ந்து	அராய்ந்து
aariyargalaal	ஆரியர்களால்	ஆரியர்களால்
aariyarkalaal	ஆரியர்களால்	ஆரியர்களால்
aariyargal	ஆரியர்கள்	ஆரியர்கள்
aariyarkal	ஆரியர்கள்	ஆரியர்கள்
aardar	ஆர்டர்	ஆர்டர்
ardar	ஆர்டர்	ஆர்டர்
arder	ஆர்டர்	ஆர்டர்
ordar	ஆர்டர்	ஒர்டர்
order	ஆர்டர்	ஆர்டர்
aarppaattaththil	ஆர்ப்பாட்டத்தில்	ஆற்ப்பாட்டத்தில்
aarva	ஆர்வ	ஆர்வா
aarvaththaal	ஆர்வத்தால்	ஆர்வத்தால்
aarvaththin	ஆர்வத்தின்	ஆர்வத்தின்
aarvaththukku	ஆர்வத்துக்கு	ஆர்வத்துக்கு
aarvaththudan	ஆர்வத்துடன்	ஆர்வத்துடன்
aarvaththutan	ஆர்வத்துடன்	ஆர்வத்துடன்
aarvaththaiyum	ஆர்வத்தையும்	ஆர்வத்தையும்
aarvamaaga	ஆர்வமாக	ஆர்வமாக
aarvamaaka	ஆர்வமாக	ஆர்வமாக
aarvam	ஆர்வம்	ஆர்வம்
aarvalarum	ஆர்வலரும்	ஆர்வலரும்
aarvee	ஆர்வி	ஆர்வே
aarvi	ஆர்வி	ஆர்வி
harvey	ஆர்வி	ஹார்வே
aaraam	ஆறாம்	ஆராம்
aaruthal	ஆறுதல்	ஆருதல்
aatralaaka	ஆற்றலாக	ஆற்றலாக
aatrtralaaga	ஆற்றலாக	ஆற்றலாக
aatrtralaaka	ஆற்றலாக	ஆற்றலாக
aatrtralum	ஆற்றலும்	ஆற்றலும்
aattralum	ஆற்றலும்	ஆற்றலும்
aatrtralae	ஆற்றலே	ஆற்றலே
aatrtralilae	ஆற்றலே	ஆற்றலிலே
aattralae	ஆற்றலே	ஆற்றலே
aattrale	ஆற்றலே	ஆற்றலே
aatri	ஆற்றி	ஆற்றி
aatrtri	ஆற்றி	ஆற்றி
aattree	ஆற்றி	ஆற்றே
aattri	ஆற்றி	ஆற்றி
aatrtrinaar	ஆற்றினார்	ஆற்றினார்
aattrinaar	ஆற்றினார்	ஆற்றினார்
aatrtrin	ஆற்றின்	ஆற்றின்
aattrin	ஆற்றின்	ஆற்றின்
aatrtril	ஆற்றில்	ஆற்றில்
aattril	ஆற்றில்	ஆற்றில்
aatrtruppaduththum	ஆற்றுப்படுத்தும்	ஆற்றுப்படுத்தும்
aattruppaduththum	ஆற்றுப்படுத்தும்	ஆற்றுப்படுத்தும்
aattruppadutthum	ஆற்றுப்படுத்தும்	ஆற்றுப்படுத்தும்
aatrtrum	ஆற்றும்	ஆற்றும்
aattrum	ஆற்றும்	ஆற்றும்
aalaya	ஆலய	ஆலையா
aalayangalil	ஆலயங்களில்	ஆலயங்களில்
aalayanggalil	ஆலயங்களில்	ஆலயங்களில்
aalayangkalil	ஆலயங்களில்	ஆலயங்களில்
aalayankalil	ஆலயங்களில்	ஆலயங்களில்
aalayangal	ஆலயங்கள்	ஆலயங்கள்
aalayanggal	ஆலயங்கள்	ஆலயங்கள்
aalayangkal	ஆலயங்கள்	ஆலயங்கள்
aalayankal	ஆலயங்கள்	ஆலயங்கள்
aalayach	ஆலயச்	ஆலயாச்
aalayaththin	ஆலயத்தின்	ஆலயத்தின்
aalayatthin	ஆலயத்தின்	ஆலையத்தின்
aalayaththil	ஆலயத்தில்	ஆலயத்தில்
aalayaththai	ஆலயத்தை	ஆலையத்தை
aalayamaaga	ஆலயமாக	ஆலையமாக
aalayamaaka	ஆலயமாக	ஆலையமாக
aalayam	ஆலயம்	ஆலையம்
aaloachanai	ஆலோசனை	ஆலோசனை
aaloasanai	ஆலோசனை	ஆலோசனை
aalosanai	ஆலோசனை	ஆலோசனை
aaloachanaikalai	ஆலோசனைகளை	ஆலோசனைகளை
aaloasanaigalai	ஆலோசனைகளை	ஆலோசனைகளை
aaloasanaikalai	ஆலோசனைகளை	ஆலோசனைகளை
aalosanaigalai	ஆலோசனைகளை	ஆலோசனைகளை
aalosanaikalai	ஆலோசனைகளை	ஆலோசனைகளை
aaloachanaik	ஆலோசனைக்	ஆலோசனைக்
aaloasanaik	ஆலோசனைக்	ஆலோசனைக்
aalosanaik	ஆலோசனைக்	ஆலோசனைக்
aaloasanaiyin	ஆலோசனையின்	ஆலோசனையின்
aalosanaiyin	ஆலோசனையின்	ஆலோசனையின்
aalosanaiyinpadi	ஆலோசனையின்	ஆலோசனையின்ப
aaloasanaiyai	ஆலோசனையை	ஆலோசனையை
aalosanaiyai	ஆலோசனையை	ஆலோசனையை
aashis	ஆஷிஷ்	ஆஷிஸ்
aashish	ஆஷிஷ்	ஆஷிஷ்
aasis	ஆஷிஷ்	ஆசிஸ்
asees	ஆஷிஷ்	ஆசிஸ்
asheesh	ஆஷிஷ்	அசேஷ்
ashish	ஆஷிஷ்	அசிஷ்
asiis	ஆஷிஷ்	ஆசிஸ்
asis	ஆஷிஷ்	ஆசிஸ்
aash	ஆஷ்	ஆஸ்
ash	ஆஷ்	ஆஸ்
engkae	இங்கே	எங்கே
ingae	இங்கே	இங்கே
ingkae	இங்கே	இங்கே
engkaeyae	இங்கேயே	எங்கேயே
ingaeyae	இங்கேயே	இங்கேயே
ingkaeyae	இங்கேயே	இங்கேயே
ichaikkaruvikalin	இசைக்கருவிகளின்	இசைக்கருவிகளின்
isaikkaruvigalin	இசைக்கருவிகளின்	இசைக்கருவிகளின்
ichaikkaruvikal	இசைக்கருவிகள்	இசைக்கருவிகள்
isaikkaruvigal	இசைக்கருவிகள்	இசைக்கருவிகள்
isaiyamaippaalar	இசையமைப்பாளர்	இசையமைப்பாலர்
isaiymaippaalar	இசையமைப்பாளர்	இசையமைப்பாலர்
isaiyamaippaalargalin	இசையமைப்பாளர்களின்	இசையமைப்பாளர்களின்
isaiyamaippaalargalil	இசையமைப்பாளர்களில்	இசையமைப்பாளர்களில்
isaiyamaippaalargal	இசையமைப்பாளர்கள்	இசையமைப்பாளர்கள்
echchaalai	இச்சாலை	எச்சாலை
ichchaalai	இச்சாலை	இச்சாலை
echchaalaiyil	இச்சாலையில்	இச்சாலையில்
ichchaalaiyil	இச்சாலையில்	இச்சாலையில்
idaththilulla	இடத்திலுள்ள	இடத்திலுள்ள
idamaagavum	இடமாகவும்	இடமாகவும்
idamthaan	இடம்தான்	இடம்தான்
idampeyarum	இடம்பெயரும்	இடம்பெயரும்
idugai	இடுகை	இடுகை
idugaigal	இடுகைகள்	இடுகைகள்
idaik	இடைக்	இடைக்
idaiyae	இடையே	இடையே
idaiyaeyum	இடையேயும்	இடையேயும்
inaiyaana	இணையான	இணையான
idhanathu	இதனது	இதனது
ithanathu	இதனது	இதனது
idhanil	இதனில்	இதனில்
ithanil	இதனில்	இதனில்
idhanpoathu	இதன்போது	இதன்போது
ithanpoathu	இதன்போது	இதன்போது
idazhaalar	இதழாளர்	இடழாலர்
idhazhaalar	இதழாளர்	இதழாலர்
ithalaalar	இதழாளர்	இதலாளர்
ithazhaalar	இதழாளர்	இதழாலர்
iththiraippadaththil	இத்திரைப்படத்தில்	இத்திரைப்படத்தில்
iththiraippadam	இத்திரைப்படம்	இத்திரைப்படம்
iththirappadam	இத்திரைப்படம்	இத்திரப்படம்
iththeevin	இத்தீவின்	இத்திவின்
iththaervil	இத்தேர்வில்	இத்தேர்வில்
iththervil	இத்தேர்வில்	இத்தெர்வில்
iththoguppil	இத்தொகுப்பில்	இத்தொகுப்பில்
iththokuppil	இத்தொகுப்பில்	இத்தொகுப்பில்
iththogaiyai	இத்தொகையை	இத்தோகையை
iththokaiyai	இத்தொகையை	இத்தொகையை
india	இந்தியா	இந்தியா
indiia	இந்தியா	இந்தியா
indiiaa	இந்தியா	இந்தியா
indiya	இந்தியா	இந்தியா
indiyaa	இந்தியா	இந்தியா
inthiyaa	இந்தியா	இந்தியா
inththiyaa	இந்தியா	இந்தியா
intiya	இந்தியா	இந்தியா
indiavin	இந்தியாவின்	இந்தியவின்
inthiyaavin	இந்தியாவின்	இந்தியாவின்
inththiyaavin	இந்தியாவின்	இந்தியாவின்
indiavilum	இந்தியாவிலும்	இந்தியவிலும்
inthiyaavilum	இந்தியாவிலும்	இந்தியாவிலும்
inththiyaavilum	இந்தியாவிலும்	இந்தியாவிலும்
indiavilulla	இந்தியாவிலுள்ள	இந்தியவிலுள்ள
inthiyaavilulla	இந்தியாவிலுள்ள	இந்தியாவிலுள்ள
inththiyaavilulla	இந்தியாவிலுள்ள	இந்தியாவிலுள்ள
indiavukkaana	இந்தியாவுக்கான	இந்தியவுக்கான
inthiyaavukkaana	இந்தியாவுக்கான	இந்தியாவுக்கான
inththiyaavukkaana	இந்தியாவுக்கான	இந்தியாவுக்கான
indiavukku	இந்தியாவுக்கு	இண்டியவுக்கு
inthiyaavukku	இந்தியாவுக்கு	இந்தியாவுக்கு
inththiyaavukku	இந்தியாவுக்கு	இந்தியாவுக்கு
indiavudan	இந்தியாவுடன்	இந்தியவுடன்
inthiyaavudan	இந்தியாவுடன்	இந்தியாவுடன்
inththiyaavudan	இந்தியாவுடன்	இந்தியாவுடன்
indiavum	இந்தியாவும்	இந்தியவும்
inthiyaavum	இந்தியாவும்	இந்தியாவும்
inththiyaavum	இந்தியாவும்	இந்தியாவும்
indhukkalaal	இந்துக்களால்	இந்துக்களால்
indhukkalin	இந்துக்களின்	இந்துக்களின்
indhukkalil	இந்துக்களில்	இந்துக்களில்
indhukkalin	இந்துக்களில்	இந்துக்களின்
indhukkalum	இந்துக்களும்	இந்துக்களும்
hindukkalaiyum	இந்துக்களையும்	இந்துக்களையும்
indhukkalaiyum	இந்துக்களையும்	இந்துக்களையும்
hindukkal	இந்துக்கள்	ஹிண்டுக்கள்
indhukkal	இந்துக்கள்	இந்துக்கள்
inthoa	இந்தோ	இந்தோ
inththoa	இந்தோ	இந்தோ
innaattin	இந்நாட்டின்	இண்ணாட்டின்
inthnaattin	இந்நாட்டின்	இந்நாட்டின்
innigazhvu	இந்நிகழ்வு	இணிகழ்வு
inthnikalvu	இந்நிகழ்வு	இந்நிகள்வு
inniruvanaththin	இந்நிறுவனத்தின்	இணினுவனத்தின்
inthniruvanaththin	இந்நிறுவனத்தின்	இந்நிருவனத்தின்
inniruvanaththil	இந்நிறுவனத்தில்	இணிருவனத்தில்
inthniruvanaththil	இந்நிறுவனத்தில்	இந்நிருவனத்தில்
inaththavargalin	இனத்தவர்களின்	இணத்தவர்களின்
inaththavarkalin	இனத்தவர்களின்	இணத்தவர்களின்
inaththavargal	இனத்தவர்கள்	இணத்தவர்கள்
inaththavarkal	இனத்தவர்கள்	இணத்தவர்கள்
inaam	இனாம்	இனாம்
inimai	இனிமை	இணிமை
inimaiyaaga	இனிமையாக	இணிமையாக
inimaiyaaka	இனிமையாக	இணிமையாக
inimaiyaana	இனிமையான	இணிமையான
innalgalukku	இன்னல்களுக்கு	இண்ணல்களுக்கு
innelkalukku	இன்னல்களுக்கு	இண்லெக்களுக்கு
innalgalai	இன்னல்களை	இண்ணல்களை
innalkalai	இன்னல்களை	இண்ணல்களை
innelkalai	இன்னல்களை	இண்லெல்களை
indriyae	இன்றியே	இந்றியே
inriya	இன்றியே	இன்றிய
intriyae	இன்றியே	இன்றியே
ippayir	இப்பயிர்	இப்பயிர்
ippalliyin	இப்பள்ளியின்	இப்பல்லியின்
ippoathellaam	இப்போதெல்லாம்	இப்போதெல்லாம்
ippothellaam	இப்போதெல்லாம்	இப்போத்லல்
imayamalai	இமயமலை	இமையமலை
imayamalaiyil	இமயமலையில்	இமயமலையில்
imchai	இம்சை	இம்சை
imsai	இம்சை	இம்சை
eemfal	இம்பால்	ஈம்பால்
eemphal	இம்பால்	ஈம்பால்
emfal	இம்பால்	எம்பால்
emphal	இம்பால்	எம்பால்
iimphal	இம்பால்	இம்பால்
imfal	இம்பால்	இம்பால்
impal	இம்பால்	இம்பால்
imphal	இம்பால்	இம்பால்
immaraththin	இம்மரத்தின்	இம்மராத்தின்
eiyakkum	இயக்கும்	இயக்கும்
iyakkum	இயக்கும்	இயக்கும்
eiyanra	இயன்ற	இயன்ற
iyandra	இயன்ற	இயன்ற
iyantra	இயன்ற	இயன்ற
eiyanrathu	இயன்றது	இயன்றது
iyandradhu	இயன்றது	இயன்றது
iyantrathu	இயன்றது	இயன்றது
eiyalpai	இயல்பை	இயல்பை
iyalbai	இயல்பை	இயல்பை
iyalbhai	இயல்பை	இயல்பை
iyalpai	இயல்பை	இயல்பை
eiyalpaik	இயல்பைக்	இயல்பைக்
iyalbaik	இயல்பைக்	இயல்பைக்
iyalpaik	இயல்பைக்	இயல்பைக்
eraani	இராணி	இராணி
iraani	இராணி	இராணி
raani	இராணி	ராணி
irukkakkoodiya	இருக்கக்கூடிய	இருக்கக்கூடிய
irukkath	இருக்கத்	இருக்கத்
irukkavum	இருக்கவும்	இருக்கவும்
irukkavae	இருக்கவே	இருக்கவே
irukkavea	இருக்கவே	இருக்கவே
irunooru	இருநூறு	இருநூரு
irunoorukkum	இருநூறுக்கும்	இருநூருக்கும்
irupaal	இருபால்	இருபால்
iruppu	இருப்பு	இருப்பு
irrupputh	இருப்புத்	இருப்புத்
irupputh	இருப்புத்	இருப்புத்
irruppup	இருப்புப்	இருப்புப்
iruppup	இருப்புப்	இருப்புப்
iruppaik	இருப்பைக்	இருப்பைக்
iruma	இரும	இருமா
irumbu	இரும்பு	இரும்பு
irumpu	இரும்பு	இரும்பு
irumbuk	இரும்புக்	இரும்புக்
irumpuk	இரும்புக்	இரும்புக்
irumbuch	இரும்புச்	இரும்புச்
irumpuch	இரும்புச்	இரும்புச்
irul	இருள்	இருல்
erangku	இறங்கு	இரங்கு
irangku	இறங்கு	இரங்கு
irangu	இறங்கு	இரங்கு
erangkum	இறங்கும்	இரங்கும்
irangkum	இறங்கும்	இரங்கும்
irangum	இறங்கும்	இரங்கும்
erappai	இறப்பை	இரப்பை
irappai	இறப்பை	இரப்பை
iravaadha	இறவாத	இறவாத
iravaatha	இறவாத	இறவாத
iruga	இறுக	இருக
iruka	இறுக	இருக
irugiya	இறுகிய	இருகிய
irukiya	இறுகிய	இருகிய
irukkiya	இறுகிய	இருக்கிய
irugum	இறுகும்	இருகும்
irukum	இறுகும்	இருக்கும்
iraivan	இறைவன்	இரைவன்
ilakkangal	இலக்கங்கள்	இலக்கங்கள்
ilakkangkal	இலக்கங்கள்	இலக்கங்கள்
ilakkana	இலக்கண	இலக்கன
ilakkanangkalai	இலக்கணங்களை	இலக்கணங்களை
ilakkanangkali	இலக்கணங்களை	இலக்கணங்களி
ilakkanankalai	இலக்கணங்களை	இலக்கணங்களை
ilakkanangkal	இலக்கணங்கள்	இலக்கணங்கள்
ilakkanankal	இலக்கணங்கள்	இலக்கனங்கள்
ilakkanach	இலக்கணச்	இலக்கனச்
ilakkanaththil	இலக்கணத்தில்	இலக்கணத்தில்
ilakkanaththai	இலக்கணத்தை	இலக்கனத்தை
ilakkanap	இலக்கணப்	இலக்கன்
ilakkanamum	இலக்கணமும்	இலக்கணமும்
ilakkanam	இலக்கணம்	இலக்கனம்
ilakkai	இலக்கை	இலக்கை
ilatcham	இலட்சம்	இலட்சம்
latcham	இலட்சம்	லட்சம்
ilaa	இலா	இலா
ilaechaana	இலேசான	இலேசான
ilaesaana	இலேசான	இலேசான
laesaana	இலேசான	லேசான
leasaana	இலேசான	லேசான
pengaludan	இளம்	பெங்களுடன்
penkalutan	இளம்	பெங்களுடன்
ilampen	இளம்பெண்	இலம்பென்
ilampengalai	இளம்பெண்களை	இலம்பெங்களை
ilampengaludan	இளம்பெண்களை	இலம்பெங்களுடன
ilampenkalai	இளம்பெண்களை	இலம்பென்களை
ilampengal	இளம்பெண்கள்	இலம்பெங்கள்
ilampenkal	இளம்பெண்கள்	இலம்பெங்கள்
ilavayadhu	இளவயது	இலவயாது
ilavayath	இளவயது	இலவயாத்
ilavayathu	இளவயது	இலவயாது
izhaiya	இழைய	இழையா
ivanaal	இவனால்	இவனால்
evatrtrukku	இவற்றுக்கு	இவற்றுக்கு
ivatrtrukku	இவற்றுக்கு	இவற்றுக்கு
ivattrukku	இவற்றுக்கு	இவற்றுக்கு
evatrtrul	இவற்றுள்	இவற்றுள்
ivatrtrul	இவற்றுள்	இவற்றுள்
ivatrul	இவற்றுள்	இவற்றுள்
evaikalin	இவைகளின்	இவைகளின்
ivaigalin	இவைகளின்	இவைகளின்
evaikalilirunthu	இவைகளிலிருந்து	இவைகளிலிருந்து
ivaigalilirundhu	இவைகளிலிருந்து	இவைகளிலிருந்து
evaikalum	இவைகளும்	இவைகளும்
ivaigalum	இவைகளும்	இவைகளும்
evaikal	இவைகள்	இவைகள்
ivaigal	இவைகள்	இவைகள்
evaiyum	இவையும்	இவையும்
ivaiyum	இவையும்	இவையும்
ivvaiyum	இவையும்	இவ்வையும்
eekkal	ஈக்கள்	ஈக்கல்
eesanai	ஈசனை	ஈசனை
eeyam	ஈயம்	ஈயம்
iiyam	ஈயம்	இயம்
iyam	ஈயம்	இயம்
eerppuch	ஈர்ப்புச்	ஈற்ப்புச்
ugandhadhu	உகந்தது	உகந்தது
uganthathu	உகந்தது	உகந்தது
ukandhathu	உகந்தது	உகந்தது
hussain	உசேன்	ஹுசைன்
usaen	உசேன்	உசேன்
udanpaadu	உடன்பாடு	உடன்பாடு
udalin	உடலின்	உடலின்
udalaith	உடலைத்	உடலைத்
udalaip	உடலைப்	உடலைப்
udalaiyum	உடலையும்	உடலையும்
udalnala	உடல்நல	உடல்நல
udalnalathai	உடல்நலத்தை	உடல்நலதை
udalnalaththai	உடல்நலத்தை	உடல்நலத்தை
udalnalththai	உடல்நலத்தை	உடல்நல்தை
udalnalan	உடல்நலன்	உடல்நலன்
udalnalap	உடல்நலப்	உடல்நலப்
udaindha	உடைந்த	உடைந்த
udaintha	உடைந்த	உடைந்த
udaindhaal	உடைந்தால்	உடைந்தால்
udainthaal	உடைந்தால்	உடைந்தால்
udaindhu	உடைந்து	உடைந்து
udainththu	உடைந்து	உடைந்து
udainthu	உடைந்து	உடைந்து
vaendum	உட்கொள்ள	வேண்டும்
vendum	உட்கொள்ள	வெண்டும்
ventum	உட்கொள்ள	வெண்டும்
utkollaamal	உட்கொள்ளாமல்	உட்கொல்லாமல்
utkolluvathan	உட்கொள்வதன்	உட்கொள்ளுவதன்
utkolvathan	உட்கொள்வதன்	உட்கொள்வதன்
utkolvathaal	உட்கொள்வதால்	உட்கொள்வதால்
udpura	உட்புற	உட்புர
utpura	உட்புற	உட்புர
udpurach	உட்புறச்	உட்புரச்
utpurach	உட்புறச்	உட்புரச்
udpuraththil	உட்புறத்தில்	உட்புரத்தில்
utpuraththil	உட்புறத்தில்	உட்புரத்தில்
udpuraththai	உட்புறத்தை	உட்புரத்தை
utpuraththai	உட்புறத்தை	உட்புரத்தை
udpuramulla	உட்புறமுள்ள	உட்புரமுள்ள
utpuramulla	உட்புறமுள்ள	உட்புரமுள்ள
unarvadhu	உணர்வது	உணர்வது
unarvathu	உணர்வது	உணர்வது
unavugalilum	உணவுகளிலும்	உணவுகளிலும்
unavukalilum	உணவுகளிலும்	உணவுகளிலும்
unavugalai	உணவுகளை	உணவுகளை
unavukalai	உணவுகளை	உணவுகளை
unavugal	உணவுகள்	உணவுகள்
unavukal	உணவுகள்	உணவுகள்
unavukkaaga	உணவுக்காக	உணவுக்காக
unavukkaaka	உணவுக்காக	உணவுக்காக
unavukku	உணவுக்கு	உணவுக்கு
thurai	உணவுத்	துறை
turai	உணவுத்	துரை
unavupporutkal	உணவுப்பொருட்கள்	உணவுப்பொருட்கள்
unavupporuttkal	உணவுப்பொருட்கள்	உணவுப்பொருட்டல்
unavum	உணவும்	உணவும்
undadhaal	உண்டதால்	உண்டதால்
undathaal	உண்டதால்	உண்டதால்
untathaal	உண்டதால்	உண்டதால்
unadanar	உண்டனர்	உணடாரர்
undanar	உண்டனர்	உண்டனர்
untanar	உண்டனர்	உண்டனர்
undaana	உண்டான	உண்டான
untaana	உண்டான	உண்டான
undi	உண்டி	உண்டி
uththiyoaga	உத்தியோக	உத்தியோக
uththiyoaka	உத்தியோக	உத்தியோக
ubachaara	உபசார	உபசார
ubasaara	உபசார	உபசார
upasaara	உபசார	உபசார
ubanidatham	உபநிடதம்	உபணிடத்தம்
ubanitatham	உபநிடதம்	உபணிடத்தம்
upanidatham	உபநிடதம்	உபணிடத்தம்
upanitatham	உபநிடதம்	உபணிடத்தம்
uppin	உப்பின்	உப்பின்
uppugal	உப்புகள்	உப்புகள்
uppukal	உப்புகள்	உப்புகள்
uppuk	உப்புக்	உப்புக்
uppukkal	உப்புக்கள்	உப்புக்கள்
uppukku	உப்புக்கு	உப்புக்கு
ubbusam	உப்புசம்	உப்சாம்
uppusam	உப்புசம்	உப்புசம்
uppudan	உப்புடன்	உப்புடன்
umakku	உமக்கு	உமக்கு
umilum	உமிழும்	உமிலும்
umizhum	உமிழும்	உமிழும்
uyirina	உயிரின	உயிரின
uyirinaththin	உயிரினத்தின்	உயிரினத்தின்
uyirinaththai	உயிரினத்தை	உயிரினத்தை
uyirinamaana	உயிரினமான	உயிரினமான
urachiya	உரசிய	உரசியா
urasiya	உரசிய	உரசியா
urugiya	உருகிய	உருகிய
urukiya	உருகிய	உருகிய
uruvappadangkalai	உருவப்படங்களை	உருவப்படங்களை
uruvappadankalai	உருவப்படங்களை	உருவப்படங்களை
uruvappatangkalai	உருவப்படங்களை	உருவப்பட்டங்களை
uruvaaga	உருவாக	உருவாக
uruvaaka	உருவாக	உருவாக
uruvaagaamal	உருவாகாமல்	உருவாகாமல்
uruvaagiyulladhaaga	உருவாகியுள்ளதாக	உருவாகியுள்ளதாக
uruvaagiyullathaaga	உருவாகியுள்ளதாக	உருவாகியுள்ளதாக
uruvaagiyulladhu	உருவாகியுள்ளது	உருவாகியுள்ளது
uruvaagiyullathu	உருவாகியுள்ளது	உருவாகியுள்ளது
uruvaagiyullana	உருவாகியுள்ளன	உருவாகியுள்ளன
uruvaagum	உருவாகும்	உருவாகும்
uruvaagumboadhu	உருவாகும்போது	உருவாகும்போது
uruvaagumpoathu	உருவாகும்போது	உருவாகும்போது
urvaagumpoathu	உருவாகும்போது	உர்வாகும்போது
uruvaaguvadhai	உருவாகுவதை	உருவாகுவதை
uruvaaguvathai	உருவாகுவதை	உருவாகுவதை
vaendum	உருவாக்க	வேண்டும்
veendum	உருவாக்க	வெண்டும்
veentum	உருவாக்க	வெண்டும்
vendum	உருவாக்க	வெண்டும்
ventum	உருவாக்க	வெண்டும்
uruvaakkak	உருவாக்கக்	உருவாக்கக்
uruvaakkakkoodiya	உருவாக்கக்கூடிய	உருவாக்கக்கோடிய
uruvaakkath	உருவாக்கத்	உருவாக்கத்
uruvaakkaththi	உருவாக்கத்தில்	உருவாக்கத்தி
uruvaakkaththil	உருவாக்கத்தில்	உருவாக்கத்தில்
uruvaakkaththai	உருவாக்கத்தை	உருவாக்கத்தை
uruvaakkam	உருவாக்கம்	உருவாக்கம்
uruvaakkavum	உருவாக்கவும்	உருவாக்கவும்
uruvaakkuthal	உருவாக்குதல்	உருவாக்குதல்
uruvaakkum	உருவாக்கும்	உருவாக்கும்
uruvaakkumpoathu	உருவாக்கும்போது	உருவாக்கும்போது
uruvaakkuvathai	உருவாக்குவதை	உருவாக்குவதை
uraiyaadal	உரையாடல்	உரையாடல்
uraiyaatal	உரையாடல்	உரையாடல்
uraiyaadalgal	உரையாடல்கள்	உரையாடல்கள்
uraiyaadalkal	உரையாடல்கள்	உரையாடல்கள்
uraiyaatalkal	உரையாடல்கள்	உரையாடல்கள்
urangaatha	உறங்காத	உரங்காத
urangkaatha	உறங்காத	உரங்காத
urangku	உறங்கு	உரங்கு
urangu	உறங்கு	உரங்கு
urangkum	உறங்கும்	உரங்கும்
urangum	உறங்கும்	உரங்கும்
urangkumpoathu	உறங்கும்போது	உரங்கும்போது
urangumpoathu	உறங்கும்போது	உரங்கும்போது
uravaal	உறவால்	உரவால்
uruthunaiyaaga	உறுதுணையாக	உருதுநையாக
uruthunaiyaaka	உறுதுணையாக	உருதுநையாக
uruthunaiyaga	உறுதுணையாக	உருதுநையகக
uruppugali	உறுப்புகளில்	உருப்புகளி
uruppugalil	உறுப்புகளில்	உருப்புகளில்
uruppugalum	உறுப்புகளும்	உருப்புகளும்
uruppugalai	உறுப்புகளை	உருப்புகளை
utrtru	உற்று	உற்று
uttru	உற்று	உற்று
ulagaich	உலகைச்	உலகைச்
ulunththu	உளுந்து	உளுந்து
ulunthu	உளுந்து	உளுந்து
ullaga	உள்ளக	உள்ளக
ullaka	உள்ளக	உள்ளக
ullagap	உள்ளகப்	உல்லகப்
ullakap	உள்ளகப்	உல்லகப்
ulladakkangalai	உள்ளடக்கங்களை	உள்ளடக்கங்களை
ulladakkangkalai	உள்ளடக்கங்களை	உள்ளடக்கங்களை
ullatakkangkali	உள்ளடக்கங்களை	உள்ளடக்கங்களி
ulladakkangal	உள்ளடக்கங்கள்	உல்லடக்கங்கள்
ulladakkangkal	உள்ளடக்கங்கள்	உல்லடக்கங்கள்
ullatakkangkal	உள்ளடக்கங்கள்	உல்லடக்கங்கள்
ulladakkaththai	உள்ளடக்கத்தை	உள்ளடக்கத்தை
ullatakkaththai	உள்ளடக்கத்தை	உள்ளடக்கத்தை
ulladakkam	உள்ளடக்கம்	உள்ளடக்கம்
ullatakkam	உள்ளடக்கம்	உல்லடக்கம்
ulladakki	உள்ளடக்கி	உள்ளடக்கி
ullatakki	உள்ளடக்கி	உள்ளடக்கி
ullapadi	உள்ளபடி	உள்ளபாடி
ullavaraaga	உள்ளவராக	உள்ளவராக
ullavaraaka	உள்ளவராக	உள்ளவராக
ulleedu	உள்ளீடு	உள்ளிடு
ulleedugalai	உள்ளீடுகளை	உள்ளீடுகளை
ulleedukalai	உள்ளீடுகளை	உள்ளீடுகளை
ulleedugal	உள்ளீடுகள்	உள்ளீடுகள்
ulleedukal	உள்ளீடுகள்	உல்லீடுகள்
ulvaanggum	உள்வாங்கும்	உள்வாங்கும்
ulvaangkum	உள்வாங்கும்	உள்வாங்கும்
ulvaankum	உள்வாங்கும்	உள்வாங்கும்
ulaippil	உழைப்பில்	உலைப்பில்
uzhaippil	உழைப்பில்	உழைப்பில்
uavar	உவர்	உவர்
uvar	உவர்	உவர்
ookkuvippathu	ஊக்குவிப்பது	ஓக்குவிப்பது
uookkuvippathu	ஊக்குவிப்பது	ஊக்குவிப்பது
uukkuvippathu	ஊக்குவிப்பது	உக்குவிப்பது
ookkuvippu	ஊக்குவிப்பு	ஓக்குவிப்பு
uookkuvippu	ஊக்குவிப்பு	ஊக்குவிப்பு
uukkuvippu	ஊக்குவிப்பு	ஊக்குவிப்பு
oosal	ஊசல்	ஓசல்
uoosal	ஊசல்	ஊசல்
uusal	ஊசல்	ஊசல்
oonchal	ஊஞ்சல்	ஓண்சல்
oonchchal	ஊஞ்சல்	ஊன்ச்சல்
unchal	ஊஞ்சல்	உஞ்சல்
uunchchal	ஊஞ்சல்	ஊன்சல்
uunjsal	ஊஞ்சல்	ஊஞ்சல்
oodagath	ஊடகத்	ஓடகத்
oodakath	ஊடகத்	ஓடகத்
udakath	ஊடகத்	உடகத்
uudakath	ஊடகத்	ஊடகத்
oodagaththin	ஊடகத்தின்	ஓடகத்தின்
oodakaththin	ஊடகத்தின்	ஓடகத்தின்
udagaththin	ஊடகத்தின்	உடகத்தின்
uudakaththin	ஊடகத்தின்	ஊடகத்தின்
oodagamaaga	ஊடகமாக	ஓடகமாக
oodakamaaka	ஊடகமாக	ஓடகமாக
udakamaaka	ஊடகமாக	உடகமாக
uudakamaaka	ஊடகமாக	ஊடகமாக
oodaadum	ஊடாடும்	ஓடாடும்
uoodaadum	ஊடாடும்	ஊடாடும்
uudaadum	ஊடாடும்	ஊடாடும்
oothaak	ஊதாக்	ஓதாக்
uuthaak	ஊதாக்	ஊதாக்
ooran	ஊரன்	ஓரன்
uooran	ஊரன்	ஊரான்
uuraan	ஊரன்	உரான்
uuran	ஊரன்	ஊர்ன்
ooraar	ஊரார்	ஓரார்
uuraar	ஊரார்	ஊரார்
oorilirunththu	ஊரிலிருந்து	ஓரிலிருந்து
oorilirunthu	ஊரிலிருந்து	ஓரிலிருந்து
uurilirunththu	ஊரிலிருந்து	உரிலிருந்து
uurilirunthu	ஊரிலிருந்து	உரிலிருந்து
oorilaeyae	ஊரிலேயே	ஓரிலேயே
urilaeyae	ஊரிலேயே	உரிலேயே
uurilaeyae	ஊரிலேயே	உரிலேயே
oorvalanggal	ஊர்வலங்கள்	ஓர்வலங்கள்
oorvalangkal	ஊர்வலங்கள்	ஓர்வலங்கள்
uurvalangkal	ஊர்வலங்கள்	ஊர்வலங்கள்
oorvalaththil	ஊர்வலத்தில்	ஓர்வலத்தில்
uurvalaththil	ஊர்வலத்தில்	ஊர்வலத்தில்
oorvalam	ஊர்வலம்	ஓர்வலம்
uurvalam	ஊர்வலம்	ஊர்வாலம்
ootrtruvathu	ஊற்றுவது	ஓற்றுவது
ootruvathu	ஊற்றுவது	ஓட்றுவது
uutrtruvathu	ஊற்றுவது	உற்றுவது
accon	எகான்	ஆக்கன்
akkon	எகான்	அக்கோன்
akon	எகான்	அக்ன்
akonn	எகான்	அக்னன்
aqon	எகான்	அக்ன்
aqonn	எகான்	அக்னன்
aqqon	எகான்	அக்கோன்
yekan	எகான்	எகன்
edisan	எடிசன்	எடிசன்
edison	எடிசன்	எடிசன்
idison	எடிசன்	இடிசன்
yedisan	எடிசன்	எடிசன்
edukkappada	எடுக்கப்பட	எடுக்கப்பட
yedukappatta	எடுக்கப்பட	எடுகப்பட்ட
etta	எட்ட	எட்டா
ettavillai	எட்டவில்லை	எட்டவில்லை
yettavillai	எட்டவில்லை	எட்டவில்லை
ettaatha	எட்டாத	எட்டாத
ettiya	எட்டிய	எட்டிய
yettiya	எட்டிய	எட்டிய
ennikkaigal	எண்ணிக்கைகள்	எண்ணிக்கைகள்
ennikkaikal	எண்ணிக்கைகள்	எண்ணிக்கைகள்
yennikkaigal	எண்ணிக்கைகள்	எண்ணிக்கைகள்
ennikkaikku	எண்ணிக்கைக்கு	எண்ணிக்கைக்கு
yennikkaikku	எண்ணிக்கைக்கு	எண்ணிக்கைக்கு
ennikkaiyin	எண்ணிக்கையின்	எண்ணிக்கையின்
ennikkaiyum	எண்ணிக்கையும்	எண்ணிக்கையும்
ennikkaiyai	எண்ணிக்கையை	எண்ணிக்கையை
ennikkaiyaiyum	எண்ணிக்கையையும்	எண்ணிக்கையையும்
ennima	எண்ணிம	எண்ணிமா
ethirkatchiyaaga	எதிர்கட்சியாக	எதிர்க்கட்சியாக
ethirkatchiyaaka	எதிர்கட்சியாக	எதிர்க்கட்சியாக
yedhirkatchiyaaga	எதிர்கட்சியாக	எதிர்க்கட்சியாக
edhirpaarppugalai	எதிர்பார்ப்புகளை	எதிர்பார்ப்புகளை
ethirpaarppugalai	எதிர்பார்ப்புகளை	எதிர்பார்ப்புகளை
ethirpaarppukalai	எதிர்பார்ப்புகளை	எதிர்பார்ப்புகளை
eththanaiyo	எத்தனையோ	எத்தனையோ
eththanaiyoa	எத்தனையோ	எத்தனையோ
paeyar	எனப்	பேயர்
payar	எனப்	பயயர்
peyar	எனப்	பெயர்
enil	எனில்	எணில்
endroa	என்றோ	என்றோ
entroa	என்றோ	என்றோ
em	எம்	எம்
yem	எம்	எம்
emdan	எம்டன்	எம்டன்
emdon	எம்டன்	எம்டன்
emtan	எம்டன்	எம்டன்
emton	எம்டன்	எம்டன்
yemtan	எம்டன்	எம்டன்
eythinaar	எய்தினார்	எதினார்
yeithinaar	எய்தினார்	எதினார்
eythiya	எய்திய	எத்யிய
yeithiya	எய்திய	எதிய
eythu	எய்து	எது
yeithu	எய்து	எத்து
eru	எரு	ஏறு
yeru	எரு	ஏறு
eruvai	எருவை	இருவை
yeruvai	எருவை	எருவை
elaktraan	எலக்ட்ரான்	எலக்ற்னான்
electron	எலக்ட்ரான்	எலிக்டர்னன்
ilektraan	எலக்ட்ரான்	இலக்கிறான்
ilektron	எலக்ட்ரான்	இலக்ட்ரனன்
ileqtraan	எலக்ட்ரான்	இலக்்தினான்
ileqtron	எலக்ட்ரான்	இலக்டர்னன்
ilictron	எலக்ட்ரான்	இலிக்டன்
iliktraan	எலக்ட்ரான்	இலிக்டிரான்
iliktron	எலக்ட்ரான்	இலிக்டரனன்
yelakdran	எலக்ட்ரான்	எலக்கிறன்
yelaktraan	எலக்ட்ரான்	எலக்கிறான்
elaktraankalai	எலக்ட்ரான்களை	எலக்றினாங்களை
electronkalai	எலக்ட்ரான்களை	எலிக்டர்ன்களை
yekaltraankalai	எலக்ட்ரான்களை	எகல்ற்றான்களை
ellaippura	எல்லைப்புற	எல்லைப்புற
yellaippura	எல்லைப்புற	எல்லைப்புற
elithaakkum	எளிதாக்கும்	எலிதாக்கும்
yelidhaakkum	எளிதாக்கும்	எலிதாக்கும்
yelithaakkum	எளிதாக்கும்	எலிதாக்கும்
elimaiyaakavum	எளிமையாகவும்	எலிமையாகவும்
yelimaiyaagavum	எளிமையாகவும்	எலிமையாகவும்
yelimaiyaakavum	எளிமையாகவும்	எலிமையாகவும்
ezhuthiyullaar	எழுதியுள்ளார்	எழுதியுள்ளார்
yeluthiyullaar	எழுதியுள்ளார்	எழுதியுள்ளார்
evvakai	எவ்வகை	இவ்வகை
yavvakai	எவ்வகை	யவ்வகை
evvaaraana	எவ்வாறான	இவ்வாரான
yavvaaraana	எவ்வாறான	யவ்வாரான
aa	ஏ	ஆ
ae	ஏ	ஏே
e	ஏ	ஏ
ee	ஏ	ஈ
acre	ஏக்கர்	ஆக்ரி
aekkar	ஏக்கர்	ஏக்கர்
ekkar	ஏக்கர்	எக்கர்
aesiyaa	ஏசியா	ஏசியா
asia	ஏசியா	அசியா
esia	ஏசியா	எசியா
angeles	ஏஞ்சல்ஸ்	அங்கெலஸ்
angels	ஏஞ்சல்ஸ்	அங்கெஸ்
angilis	ஏஞ்சல்ஸ்	அங்கிலிஸ்
aden	ஏடன்	அடன்
adenn	ஏடன்	அடன்
aidan	ஏடன்	அட்டன்
edan	ஏடன்	எடன்
eden	ஏடன்	எடன்
edenn	ஏடன்	எடனன்
eedan	ஏடன்	ஈடன்
eton	ஏடன்	எட்டன்
iton	ஏடன்	இட்டன்
eetan	ஏதன்	ஈட்டன்
eithaan	ஏதன்	இத்தான்
eithan	ஏதன்	எத்தன்
ethan	ஏதன்	எத்ன்
ethann	ஏதன்	எத்னன்
eythan	ஏதன்	எத்தன்
iithaan	ஏதன்	இத்
ithan	ஏதன்	இதன்
ithann	ஏதன்	இதன்
iythan	ஏதன்	இத்தன்
aerpada	ஏற்பட	ஏற்படட
yerpada	ஏற்பட	எற்பட
aerpadath	ஏற்படத்	ஏற்படத்
yerpadath	ஏற்படத்	எற்படத்
aerpadap	ஏற்படப்	ஏற்படப்
yerpadap	ஏற்படப்	எற்படப்
aerpadin	ஏற்படின்	ஏற்படின்
earpadin	ஏற்படின்	ஏற்படின்
yerpadin	ஏற்படின்	எர்பாடின்
aerpaduththina	ஏற்படுத்தின	ஏற்படுத்தின
yaerpaduththina	ஏற்படுத்தின	ஏற்படுத்தின
yerpaduththina	ஏற்படுத்தின	எற்படுத்தின
aerpadumpoathu	ஏற்படும்போது	ஏற்படும்போது
yaerpadumpoathu	ஏற்படும்போது	ஏற்படும்போது
yerpadumpoathu	ஏற்படும்போது	எற்படும்போது
aerpaduvathu	ஏற்படுவது	ஏற்படுவது
yaerpaduvathu	ஏற்படுவது	ஏற்படுவது
yerpaduvathu	ஏற்படுவது	எற்படுவது
aerpaduvathai	ஏற்படுவதை	ஏற்படுவதை
earpaduvathai	ஏற்படுவதை	ஏற்படுவதை
yerpaduvathai	ஏற்படுவதை	எற்படுவதை
aetrtrukkonda	ஏற்றுக்கொண்ட	ஏற்றுக்கொண்ட
eattrukkonda	ஏற்றுக்கொண்ட	ஏற்றுக்கொண்ட
aetrtrukkondaar	ஏற்றுக்கொண்டார்	ஏற்றுக்கொண்டார்
eattrukkondaar	ஏற்றுக்கொண்டார்	ஏற்றுக்கொண்டார்
aela	ஏல	ஏல
eala	ஏல	ஏல
yaela	ஏல	ஏல
aelaththil	ஏலத்தில்	ஏலத்தில்
ealaththil	ஏலத்தில்	ஏழத்தில்
yaelaththil	ஏலத்தில்	ஏழத்தில்
aelam	ஏலம்	ஏலம்
ealam	ஏலம்	ஏலம்
yaelam	ஏலம்	ஏலம்
aelanam	ஏளனம்	ஏலனம்
ealanam	ஏளனம்	ஏலனம்
eelanam	ஏளனம்	ஈலனம்
yelanam	ஏளனம்	எலனம்
ainaavin	ஐநாவின்	ஐன்வான்
aynaavin	ஐநாவின்	அய்நாவின்
inaavin	ஐநாவின்	இணாவின்
aippachi	ஐப்பசி	ஐப்பாசி
aippasi	ஐப்பசி	ஐப்பாசி
ippachi	ஐப்பசி	இப்பசி
aivarum	ஐவரும்	ஐவரும்
ivarum	ஐவரும்	இவரும்
odunggi	ஒடுங்கி	ஓடுங்கி
odungi	ஒடுங்கி	ஓடுங்கி
odungki	ஒடுங்கி	ஓடுங்கி
odungiya	ஒடுங்கிய	ஓடுங்கிய
odungkiya	ஒடுங்கிய	ஓடுங்கிய
oppandhangalil	ஒப்பந்தங்களில்	ஓப்பந்தங்களில்
oppanthangalil	ஒப்பந்தங்களில்	ஓப்பந்தங்களில்
oppanthangkalil	ஒப்பந்தங்களில்	ஓப்பந்தங்களில்
oppandhangalai	ஒப்பந்தங்களை	ஓப்பந்தங்களை
oppanthangalai	ஒப்பந்தங்களை	ஓப்பந்தங்களை
oppanthangkalai	ஒப்பந்தங்களை	ஓப்பந்தங்களை
oppandhangal	ஒப்பந்தங்கள்	ஓப்பந்தங்கள்
oppandhangall	ஒப்பந்தங்கள்	ஓப்பந்தங்கள்
oppanthangall	ஒப்பந்தங்கள்	ஓப்பந்தங்கள்
oppanthangkal	ஒப்பந்தங்கள்	ஓப்பந்தங்கள்
oppandhathin	ஒப்பந்தத்தின்	ஒப்பந்ததின்
oppandhaththin	ஒப்பந்தத்தின்	ஒப்பந்தத்தின்
oppanthaththin	ஒப்பந்தத்தின்	ஒப்பந்தத்தின்
oppandhaththai	ஒப்பந்தத்தை	ஒப்பந்தத்தை
oppanthathai	ஒப்பந்தத்தை	ஒப்பந்ததை
oppanthaththai	ஒப்பந்தத்தை	ஒப்பந்தத்தை
oppukkolgiraar	ஒப்புக்கொள்கிறார்	ஒப்புக்கொள்கிறார்
oppukkolgirar	ஒப்புக்கொள்கிறார்	ஒப்புக்கொள்கிறார்
oppukkolkiraar	ஒப்புக்கொள்கிறார்	ஒப்புக்கொள்கிறார்
oppukkolkirar	ஒப்புக்கொள்கிறார்	ஒப்புக்கொள்கிறார்
omeega	ஒமேகா	ஓமிகா
omeegaa	ஒமேகா	ஓமீகா
omeeka	ஒமேகா	ஓமீக
omega	ஒமேகா	ஓமேகா
omegaa	ஒமேகா	ஓமேகா
ommeega	ஒமேகா	ஒம்மீக
ommeegaa	ஒமேகா	ஓம்மீகா
ommega	ஒமேகா	ஓம்கேகா
ommegaa	ஒமேகா	ஓம்கேகா
orisa	ஒரிசா	ஒரிசா
orisaa	ஒரிசா	ஒரிசா
orissa	ஒரிசா	ஒரிஸ்சா
orissaa	ஒரிசா	ஒரிஸ்சா
orrisa	ஒரிசா	ஒரிசா
orichaavil	ஒரிசாவில்	ஒரிச்சாவில்
orisavil	ஒரிசாவில்	ஓரிசவில்
orissavil	ஒரிசாவில்	ஓரிஸ்சவில்
orunginaipai	ஒருங்கிணைப்பை	ஒருங்கினைப்பை
orunginaippai	ஒருங்கிணைப்பை	ஒருங்கினைப்பை
orunkinaippai	ஒருங்கிணைப்பை	ஒருங்கினைப்பை
orupadi	ஒருபடி	ஒருபாடி
orupati	ஒருபடி	ஒருப்படி
oruphadi	ஒருபடி	ஒருப்தாதி
otrarkal	ஒற்றர்கள்	ஒற்றர்கள்
ottrargal	ஒற்றர்கள்	ஒற்றர்கள்
ottrarkal	ஒற்றர்கள்	ஒற்றர்கள்
ovvoar	ஒவ்வோர்	ஓவ்வோர்
ovvoor	ஒவ்வோர்	ஓவ்வூர்
ovvor	ஒவ்வோர்	ஓவ்வர்
oangi	ஓங்கி	ஓங்கி
ongi	ஓங்கி	ஓங்கி
oongi	ஓங்கி	ஓங்கி
ozone	ஓசோன்	ஓஜனன்
oaiyaa	ஓயா	ஓய்யா
oayaa	ஓயா	ஓயா
ooyaa	ஓயா	ஓயா
oyaa	ஓயா	ஓயா
hora	ஓர	ஹோரா
oora	ஓர	ஓரா
ora	ஓர	ஓரா
vora	ஓர	வோரா
horangalil	ஓரங்களில்	ஹரங்களில்
oorangalil	ஓரங்களில்	ஓரங்களில்
orangalil	ஓரங்களில்	ஒரங்களில்
vorangalil	ஓரங்களில்	வர்ங்களில்
horathilum	ஓரத்திலும்	ஹரதிலும்
oorathilum	ஓரத்திலும்	ஓரதிலும்
orathilum	ஓரத்திலும்	ஒரதிலும்
oraththilum	ஓரத்திலும்	ஒரத்திலும்
vorathilum	ஓரத்திலும்	வரதிலும்
horathil	ஓரத்தில்	ஹரத்தில்
oorathil	ஓரத்தில்	ஓரதில்
orathil	ஓரத்தில்	ஓரதில்
oraththil	ஓரத்தில்	ஓரத்தில்
vorathil	ஓரத்தில்	வரதிதில்
horamaaga	ஓரமாக	ஹோரமாக
ooramaaga	ஓரமாக	ஓரமாக
oramaaga	ஓரமாக	ஒரமாக
voramaaga	ஓரமாக	வரமாக
horam	ஓரம்	ஹோரம்
ooram	ஓரம்	ஓரம்
oram	ஓரம்	ஓரம்
voram	ஓரம்	வோரம்
aolaichchuvadikal	ஓலைச்சுவடிகள்	அலைச்சுவடிகள்
oalaichchuvadikal	ஓலைச்சுவடிகள்	ஓலைச்சுவடிகள்
oalaichuvadigal	ஓலைச்சுவடிகள்	ஓலைசுவடிகள்
olaichchuvadigal	ஓலைச்சுவடிகள்	ஒலைச்சுவடிகள்
oolaichuvadigal	ஓலைச்சுவடிகள்	ஓலைசுவடிகள்
oaldu	ஓல்டு	ஓல்டு
oldu	ஓல்டு	ஓல்டு
ooldu	ஓல்டு	ஓல்டு
kakkan	கக்கன்	காக்கன்
kakken	கக்கன்	காக்கேன்
kaki	கக்கி	காக்கி
kakki	கக்கி	காக்கி
kakky	கக்கி	காக்கி
kachan	கசன்	கசன்
kajan	கசன்	காஜன்
kasan	கசன்	கசன்
kazan	கசன்	கான்
qazan	கசன்	கான்
kadaththal	கடத்தல்	கடத்தல்
kadaththalgalil	கடத்தல்களில்	கடத்தல்களில்
kadaththalkalil	கடத்தல்களில்	கடத்தல்களில்
kadandhaar	கடந்தார்	கடந்தார்
kadanthaar	கடந்தார்	கடந்தார்
katandhaar	கடந்தார்	கடந்தார்
katanthaar	கடந்தார்	கடந்தார்
kadanin	கடனின்	கடடனின்
kadanil	கடனில்	கடனில்
kadanudhavi	கடனுதவி	கடனுதவி
kadanuthavi	கடனுதவி	கடனுதவி
katanuthavi	கடனுதவி	கடனுதவி
kadarkaraigalil	கடற்கரைகளில்	கடற்கரைகளில்
kadarkaraikalil	கடற்கரைகளில்	கடற்கரைகளில்
kadarkaraigal	கடற்கரைகள்	கடற்கரைகள்
kadarkaraikal	கடற்கரைகள்	கடற்கரைகள்
kadarkaraich	கடற்கரைச்	கடர்கரைச்
katarkaraichh	கடற்கரைச்	கடற்கரைச்
kadarkaraip	கடற்கரைப்	கடற்கரைப்
kadarkaraiyum	கடற்கரையும்	கடற்கரையும்
kadarkollaiyargal	கடற்கொள்ளையர்கள்	கடர்கொள்ளையர்கள்
kadarkollaiyarkal	கடற்கொள்ளையர்கள்	கடர்கொள்ளையர்கள்
kadalin	கடலின்	கடலின்
katalin	கடலின்	கட்லான்
kadavul	கடவுள்	கடவுள்
kadvul	கடவுள்	கட்வுல்
kadavulgalil	கடவுள்களில்	கடவுள்களில்
kadavulkalil	கடவுள்களில்	கடவுள்களில்
kadavulgalai	கடவுள்களை	கடவுள்களை
kadavulkalai	கடவுள்களை	கடவுள்களை
kadavulgal	கடவுள்கள்	கடவுள்கள்
kadavulkal	கடவுள்கள்	கடவுள்கள்
kadidha	கடித	கடித
kadith	கடித	கடித்
kaditha	கடித	கடித்த
kadidhangalil	கடிதங்களில்	கடிதங்களில்
kadithangalil	கடிதங்களில்	கடிதங்களில்
kadithangkalil	கடிதங்களில்	கடிதங்களில்
kadidhangal	கடிதங்கள்	கடிதங்கள்
kadithangal	கடிதங்கள்	கடிதங்கள்
kadithangkal	கடிதங்கள்	கடிதங்கள்
kadidhu	கடிது	கடிது
kadithu	கடிது	கடித்து
katithu	கடிது	கடித்து
kadugu	கடுகு	கடுகு
kadumaiyaana	கடுமையான	கடுமையான
kadaisith	கடைசித்	கடைசித்
kadaisip	கடைசிப்	கடைசிப்
kadaisiyil	கடைசியில்	கடைசியில்
kadaippidiththu	கடைப்பிடித்து	கடைப்பிடித்து
kadaippidithu	கடைப்பிடித்து	கடைப்பிடிது
kadaippiditthu	கடைப்பிடித்து	கடைப்பிடித்து
avut	கட்	அவுட்
cut	கட்	குட்
kat	கட்	காட்
out	கட்	ஓட்
kattamaikkum	கட்டமைக்கும்	கட்டமைக்கும்
kattaayamaaga	கட்டாயமாக	கட்டாயமாக
kattumaanak	கட்டுமானக்	கட்டுமானக்
kattumaanath	கட்டுமானத்	கட்டுமானத்
kattumaanathin	கட்டுமானத்தின்	கட்டுமானத்தின்
kattumaanaththin	கட்டுமானத்தின்	கட்டுமானத்தின்
kattumaanathirku	கட்டுமானத்திற்கு	கட்டுமானத்திற்கு
kattumaanaththirku	கட்டுமானத்திற்கு	கட்டுமானத்திற்கு
katumaanaththirku	கட்டுமானத்திற்கு	கடுமானத்திற்கு
kattumaanathil	கட்டுமானத்தில்	கட்டுமானத்தில்
kattumaanaththil	கட்டுமானத்தில்	கட்டுமானத்தில்
katturaigal	கட்டுரைகள்	கட்டுரைகள்
kanangalin	கணங்களின்	கணங்களின்
kanangkalin	கணங்களின்	கணங்களின்
kanaththin	கணத்தின்	கணத்தின்
kanini	கணிணி	கணினி
kanippori	கணிப்பொறி	கணிப்போரி
kanipporiyil	கணிப்பொறியில்	கணிப்போரியில்
ganes	கணேஸ்	கானஸ்
ganesh	கணேஸ்	கானஸ்
kandarindhavar	கண்டறிந்தவர்	கண்டரிந்தவர்
kandarindhdhavar	கண்டறிந்தவர்	கண்டரிந்தவர்
kandarinthavar	கண்டறிந்தவர்	கண்டரிந்தவர்
kandarinththavar	கண்டறிந்தவர்	கண்டரிந்தவர்
kandarindhaar	கண்டறிந்தார்	கண்டரிந்தார்
kandarindhdhaar	கண்டறிந்தார்	கண்டரிந்தார்
kandarinthaar	கண்டறிந்தார்	கண்டரிந்தார்
kandarinththaar	கண்டறிந்தார்	கண்டரிந்தார்
kandarindhdhu	கண்டறிந்து	கண்டரிந்து
kandarindhu	கண்டறிந்து	கண்டரிந்து
kandarinthu	கண்டறிந்து	கண்டரிந்து
kandrinththu	கண்டறிந்து	கண்றிந்து
kandarindhulladhu	கண்டறிந்துள்ளது	கண்டரிந்துள்ளது
kandarindhullathu	கண்டறிந்துள்ளது	கண்டரிந்துள்ளது
kandarinthulladhu	கண்டறிந்துள்ளது	கண்டரிந்துள்ளது
kandarinthullathu	கண்டறிந்துள்ளது	கண்டரிந்துள்ளது
athinaveena	கண்டுபிடிக்க	அதினவேன
kandupidikka	கண்டுபிடிக்க	கண்டுபிடிக்க
kandupitikka	கண்டுபிடிக்க	கண்டுபிடிக்க
kanupidikka	கண்டுபிடிக்க	கணுபிடிக்க
kandupidikkak	கண்டுபிடிக்கக்	கண்டுபிடிக்கக்
kandupitikkak	கண்டுபிடிக்கக்	கண்டுபிடிக்கக்
kandupidikkavum	கண்டுபிடிக்கவும்	கண்டுபிடிக்கவும்
kandupidikkum	கண்டுபிடிக்கும்	கண்டுபிடிக்கும்
kannaottaththudan	கண்ணோட்டத்துடன்	கண்ணட்டத்துடன்
kannoottaththudan	கண்ணோட்டத்துடன்	கண்ணூட்டத்துன்
kannottaththudan	கண்ணோட்டத்துடன்	கண்ணோட்டத்துன்
kanoottatthudan	கண்ணோட்டத்துடன்	கணோட்டத்துடன்
kannoottathai	கண்ணோட்டத்தை	கண்ணோட்டத்தை
kannoottaththai	கண்ணோட்டத்தை	கண்ணூட்டத்தை
kannottaththai	கண்ணோட்டத்தை	கண்ணோட்டத்தை
kannoattam	கண்ணோட்டம்	கண்ணோட்டம்
kannoottam	கண்ணோட்டம்	கண்ணோட்டம்
kannottam	கண்ணோட்டம்	கண்ணோட்டம்
kanpaarvai	கண்பார்வை	கண்பார்வை
gana	கன	கானா
kana	கன	கன
ganam	கனம்	காமம்
kanam	கனம்	கணம்
ganaraga	கனரக	கனராக
kanaraga	கனரக	கணராக
kanavai	கனவை	கணவை
canno	கனோ	கனனோ
cannoo	கனோ	கன்னோ
cano	கனோ	கனோ
kanno	கனோ	கன்னோ
kannoo	கனோ	கன்னோ
kano	கனோ	கனோ
kanoo	கனோ	கனோ
kanu	கனோ	கணு
qanno	கனோ	கன்னோ
qano	கனோ	கனோ
qanoo	கனோ	கனோ
comiti	கமிட்டி	காமிட்
comitie	கமிட்டி	காமிட்
comittee	கமிட்டி	காமிட்டி
comity	கமிட்டி	காமிட்
commitee	கமிட்டி	காமிட்டி
committee	கமிட்டி	கம்மிட்டி
committii	கமிட்டி	கமமிட்டி
kamiddi	கமிட்டி	காமிட்டி
kamiti	கமிட்டி	காமிட்
kamitte	கமிட்டி	காமிட்டி
kamitti	கமிட்டி	கமித்தி
qamiti	கமிட்டி	காமிதி
kamees	கமீஸ்	காமேஸ்
kameez	கமீஸ்	காமீழ்
kamis	கமீஸ்	காமிஸ்
cumbaththil	கம்பத்தில்	கும்பத்தில்
kambaththil	கம்பத்தில்	கம்பத்தில்
kambattil	கம்பத்தில்	கம்பட்டில்
kampattil	கம்பத்தில்	கம்பட்டில்
kambam	கம்பம்	கம்பம்
kampam	கம்பம்	கம்பம்
kambaramayanam	கம்பராமாயணம்	கம்பரமாயமம்
kamparamayanam	கம்பராமாயணம்	கம்பரமாயமம்
company	கம்பெனி	கம்பனி
kambeni	கம்பெனி	கம்பெனி
kampeni	கம்பெனி	கம்பெனி
companykku	கம்பெனிக்கு	கம்பன்க்கு
kambenikku	கம்பெனிக்கு	கம்பெனிக்கு
kampenikku	கம்பெனிக்கு	கம்பெனிக்கு
companyil	கம்பெனியில்	காம்பனியில்
kambeniyil	கம்பெனியில்	கம்பெனியில்
kampeniyil	கம்பெனியில்	கம்பெனியில்
gayaanaa	கயானா	கேயானா
gayana	கயானா	கேயானா
guana	கயானா	குனா
guiaana	கயானா	குயானா
guiana	கயானா	குயானா
guianaa	கயானா	குயானா
guiiana	கயானா	குயியானா
guiyana	கயானா	குயியானா
guuana	கயானா	கூனா
guuiana	கயானா	கூயானா
guuiyana	கயானா	கூய்யானா
guuvana	கயானா	கூவானா
guuwana	கயானா	கூவானா
guuyaana	கயானா	கூயானா
guuyana	கயானா	கூயனா
guuyanaa	கயானா	கூயனா
guvana	கயானா	குவான
guwana	கயானா	குவானா
guyaana	கயானா	குயானா
guyana	கயானா	குயனா
guyanaa	கயானா	குயானா
kayana	கயானா	கேயனா
karagaatam	கரகாட்டம்	கரகாடம்
karagaattam	கரகாட்டம்	கரகாட்டம்
karakaatam	கரகாட்டம்	கரகாடம்
karakaattam	கரகாட்டம்	கரகாட்டம்
karachiyil	கராச்சியில்	கரச்சியில்
karung	கருங்	கருங்
karuththaa	கருத்தா	கருத்தா
karuththaakkangal	கருத்தாக்கங்கள்	கருத்தாக்கங்கள்
karuththaakkanggal	கருத்தாக்கங்கள்	கருத்தாக்கங்கள்
karuththaakkangkal	கருத்தாக்கங்கள்	கருத்தாக்கங்கள்
karuththaakkaththai	கருத்தாக்கத்தை	கருத்தாக்கத்தை
karuththaal	கருத்தால்	கருத்தால்
karutthaal	கருத்தால்	கருத்தால்
karuththukalaal	கருத்துக்களால்	கருத்துகளால்
karuththukkalaal	கருத்துக்களால்	கருத்துக்களால்
karuthukkalaal	கருத்துக்களால்	கருதுக்களால்
karuththukalil	கருத்துக்களில்	கருத்துகளில்
karuththukkalil	கருத்துக்களில்	கருத்துக்களில்
karuththukalukku	கருத்துக்களுக்கு	கருத்துகளுக்கு
karuththukkalukku	கருத்துக்களுக்கு	கருத்துக்களுக்கு
karuththukalum	கருத்துக்களும்	கருத்துகளும்
karuththukkalum	கருத்துக்களும்	கருத்துக்களும்
karuththulla	கருத்துள்ள	கருத்துள்ள
karuththae	கருத்தே	கருத்தே
karuththe	கருத்தே	கருத்தே
karuththey	கருத்தே	கருத்தே
karunira	கருநிற	கருனிற
karum	கரும்	கரும்
karumpalagai	கரும்பலகை	கரும்பலகை
karumpalakai	கரும்பலகை	கரும்பலகை
karmpuli	கரும்புலி	கர்ம்புளி
karumpuli	கரும்புலி	கரும்புளி
karumpuligal	கரும்புலிகள்	கரும்புளிகள்
karumpulikal	கரும்புலிகள்	கரும்புளிகள்
karumpulith	கரும்புலித்	கரும்புளித்
karumpulli	கரும்புள்ளி	கரும்புள்ளி
karna	கர்ண	கர்னா
karnanai	கர்ணனை	கர்னனை
karnnanai	கர்ணனை	கர்னனனை
karma	கர்ம	கர்மா
karpadhu	கற்பது	கற்பது
karpathu	கற்பது	கற்பது
karpatthu	கற்பது	கற்பத்து
karpam	கற்பம்	கற்பம்
padugira	கற்பிக்கப்	படுக்கிற
padugiradhu	கற்பிக்கப்	படுகிறது
padukira	கற்பிக்கப்	படுக்கிற
padukirathu	கற்பிக்கப்	படுக்கிறது
patukiratu	கற்பிக்கப்	பட்டுகிறது
karpikkappatta	கற்பிக்கப்பட்ட	கற்பிக்கப்பட்ட
karpikkum	கற்பிக்கும்	கற்பிக்கும்
karpithanggal	கற்பிதங்கள்	கர்பித்தங்கள்
karpithangkal	கற்பிதங்கள்	கர்பித்தங்கள்
karpin	கற்பின்	கார்பின்
kalasam	கலசம்	கலசம்
kalandhaaivu	கலந்தாய்வு	கலந்தாய்வு
kalandhaayvu	கலந்தாய்வு	கலந்தாய்வு
kalanthaaivu	கலந்தாய்வு	கலந்தாய்வு
kalandhuk	கலந்துக்	கலந்துக்
kalanthuk	கலந்துக்	கலந்துக்
kalandhum	கலந்தும்	கலந்தும்
kalanthum	கலந்தும்	கலந்தும்
kalavi	கலவி	கலவி
kalaviyil	கலவியில்	கலவியில்
kalaanidhi	கலாநிதி	கலாநிதி
kalaanithi	கலாநிதி	கலாநிதி
kalanidhi	கலாநிதி	கலனிதி
kalaanidhip	கலாநிதிப்	கலாநிதிப்
kalaanithip	கலாநிதிப்	கலாநிதிப்
kalanidhip	கலாநிதிப்	கலனிதிப்
kalinga	கலிங்க	கலிங்க
kalingam	கலிங்கம்	கலிங்கம்
kalinkam	கலிங்கம்	கலிங்கம்
ccalinga	கலிங்கா	காலிங்கா
kaliina	கலிங்கா	கலினா
kaliinga	கலிங்கா	கலிங்கா
kalina	கலிங்கா	கலினா
kalinaa	கலிங்கா	கலினா
kalinga	கலிங்கா	கலிங்க
kalingaa	கலிங்கா	கலிங்கா
kalinka	கலிங்கா	கலிங்க
kallinaa	கலிங்கா	கல்லினா
kallingaa	கலிங்கா	கல்லிங்கா
qaliinga	கலிங்கா	கலிங்கா
qalinga	கலிங்கா	கலிங்கா
qalingaa	கலிங்கா	கலிங்கா
qallingaa	கலிங்கா	கல்லிங்கா
kaliyan	கலியன்	கலியன்
kalaik	கலைக்	கலைக்
koavan	கலைக்	கோவன்
koovan	கலைக்	கோவன்
kovan	கலைக்	கோவன்
choargal	கலைச்	சோர்கள்
chortkal	கலைச்	சொற்ற்கள்
corkal	கலைச்	கோர்கள்
sorkkal	கலைச்	சோர்க்கள்
sortkal	கலைச்	சோர்ட்கள்
kalaichchorkalai	கலைச்சொற்களை	கலைச்சொர்களை
kalicchorkalai	கலைச்சொற்களை	கலிச்சொர்களை
kalladi	கல்லடி	கல்லடி
kalluppatti	கல்லுப்பட்டி	கல்லுப்பட்டி
kalloorigalin	கல்லூரிகளின்	கல்லூரிகளின்
kallorikalin	கல்லூரிகளின்	கல்லோரிகளின்
kallurigalin	கல்லூரிகளின்	கல்லுரிகளின்
kallurigazhin	கல்லூரிகளின்	கல்லுரிகளின்
kallurikalin	கல்லூரிகளின்	கல்லுரிகளின்
kallurikazhin	கல்லூரிகளின்	கல்லுரிகளின்
kalloorigalil	கல்லூரிகளில்	கல்லூரிகளில்
kalloorikalil	கல்லூரிகளில்	கல்லூரிகளில்
kallurigalil	கல்லூரிகளில்	கல்லுரிகளில்
kallurigazhil	கல்லூரிகளில்	கல்லுரிகளில்
kallurikalil	கல்லூரிகளில்	கல்லுரிகளில்
kallurikazhil	கல்லூரிகளில்	கல்லுரிகளில்
kalloorigalukkaana	கல்லூரிகளுக்கான	கல்லூரிகளுக்கான
kalloorikalukkaana	கல்லூரிகளுக்கான	கல்லூரிகளுக்கான
kallurigalukkana	கல்லூரிகளுக்கான	கல்லுரிகளுக்கான
kallurigazhukkana	கல்லூரிகளுக்கான	கல்லுரிகளுக்கன
kallurikalukkana	கல்லூரிகளுக்கான	கல்லுரிகளுக்கான
kallurikazhukkana	கல்லூரிகளுக்கான	கல்லுரிகளுக்கன
kalloorigal	கல்லூரிகள்	கல்லூரிகள்
kalloorikal	கல்லூரிகள்	கல்லூரிகள்
kallurigal	கல்லூரிகள்	கல்லுரிகள்
kallurikal	கல்லூரிகள்	கல்லுரிகள்
kalloorigalukku	கல்லூரிக்கு	கல்லூரிகளுக்கு
kalloorikku	கல்லூரிக்கு	கல்லூரிக்கு
kallurikku	கல்லூரிக்கு	கல்லுரிக்கு
kalloorip	கல்லூரிப்	கல்லூரிப்
kallurip	கல்லூரிப்	கல்லூரிப்
kallooriyin	கல்லூரியின்	கல்லூரியின்
kalluriyin	கல்லூரியின்	கல்லூரியின்
kallooriyilirindhu	கல்லூரியிலிருந்து	கல்லூரியிரிந்து
kallooriyilirundhu	கல்லூரியிலிருந்து	கல்லூரியிலுருந்து
kalluriyilirundhu	கல்லூரியிலிருந்து	கல்லுரியிலிருந்து
kalluriyilirunthu	கல்லூரியிலிருந்து	கல்லுரியிலிருந்து
kallooriyil	கல்லூரியில்	கல்லூரியில்
kalluriyil	கல்லூரியில்	கல்லுரியில்
kallooriyum	கல்லூரியும்	கல்லூரியும்
kalluriyum	கல்லூரியும்	கல்லுரியும்
kallooriei	கல்லூரியை	கல்லூரி
kallooriyai	கல்லூரியை	கல்லூரியை
kalluriyai	கல்லூரியை	கல்லுரியை
kalvikku	கல்விக்கு	கல்விக்கு
kalvikkum	கல்விக்கும்	கல்விக்கும்
kalvich	கல்விச்	கல்விச்
kalviththittam	கல்வித்திட்டம்	கல்வித்திட்டம்
kalvip	கல்விப்	கல்விப்
kalviyaaga	கல்வியாக	கல்வியாக
kalviyin	கல்வியின்	கல்வியின்
kalviyil	கல்வியில்	கல்வியில்
kalvieiyum	கல்வியையும்	கல்வியும்
kalviyaiyum	கல்வியையும்	கல்வியையும்
kaliman	களிமண்	கலிமன்
kalimun	களிமண்	கலிமுன்
kazhiman	களிமண்	காழிமன்
kalaiyum	களையும்	கலையும்
kazhaiyum	களையும்	கழையும்
kazhayum	களையும்	கழையும்
kalutaikal	கழுதைகள்	கலுடைகள்
kaluthaikal	கழுதைகள்	கலுதைகள்
kazhudhaigal	கழுதைகள்	கழுதைகள்
gavanippu	கவனிப்பு	கவனிப்பு
kavanippu	கவனிப்பு	கவனிப்பு
kavalaigalai	கவலைகளை	கவலைகளை
kavalaikalai	கவலைகளை	கவலைகளை
kavaligalai	கவலைகளை	கவலிகளை
kavalaigal	கவலைகள்	கவலைகள்
kavalaikal	கவலைகள்	கவலைகள்
kavaligal	கவலைகள்	கவலிகள்
kaviyarachu	கவியரசு	கவியரசசு
kaviyaracu	கவியரசு	கவியராசு
kaviyarasu	கவியரசு	கவியரசு
counti	கவுண்டி	குண்டி
countii	கவுண்டி	கோண்டி
county	கவுண்டி	குண்டி
couunti	கவுண்டி	குண்டி
couunty	கவுண்டி	குண்டி
kaunti	கவுண்டி	காண்டி
kaunty	கவுண்டி	காண்டி
kauunty	கவுண்டி	காண்டி
kavunti	கவுண்டி	கவுண்டி
kavuntii	கவுண்டி	கவுண்டி
kavuunti	கவுண்டி	கவுண்டி
kawunti	கவுண்டி	கவுண்டி
kounti	கவுண்டி	கோண்டி
kountii	கவுண்டி	கோண்டி
kounty	கவுண்டி	கோண்டி
kouunti	கவுண்டி	கோண்டி
kouunty	கவுண்டி	கூண்டி
qaunty	கவுண்டி	காண்டி
qavunti	கவுண்டி	கவுண்டி
qounti	கவுண்டி	கோண்டி
qounty	கவுண்டி	கோண்டி
conggo	காங்கோ	காங்கோ
congo	காங்கோ	காங்கோ
congoo	காங்கோ	காங்கோ
congu	காங்கோ	காங்கு
conngo	காங்கோ	காங்கோ
coonggoo	காங்கோ	கோங்கோ
coongoo	காங்கோ	கோங்கோ
coonngoo	காங்கோ	கோங்கோ
kaango	காங்கோ	காங்கோ
kaanko	காங்கோ	காங்கோ
kankoo	காங்கோ	கண்கோ
kongo	காங்கோ	கொங்கோ
koongoo	காங்கோ	கோங்கோ
qongo	காங்கோ	காங்கோ
kaattuvadhaagavum	காட்டுவதாகவும்	காட்டுவதாகவும்
kaattuvathaagavum	காட்டுவதாகவும்	காட்டுவதாகவும்
kaattuvadhai	காட்டுவதை	காட்டுவதை
kaattuvathai	காட்டுவதை	காட்டுவதை
kaangindranar	காண்கின்றனர்	காங்கின்றனர்
kaangintranar	காண்கின்றனர்	காங்கின்றனர்
kaankinranar	காண்கின்றனர்	காங்கின்றனர்
kaanbithththu	காண்பித்து	காண்பித்து
kaanbiththu	காண்பித்து	காண்பித்து
kaanpiththu	காண்பித்து	காண்பித்து
kaathi	காதி	காதி
kathi	காதி	கதி
kaadhirundhanar	காத்திருந்தனர்	காதிருந்தனர்
kaathirundhanar	காத்திருந்தனர்	காதிருந்தனர்
kaaththirunthanar	காத்திருந்தனர்	காத்திருந்தனர்
kaatthirunthanar	காத்திருந்தனர்	காத்திருந்தனர்
kaathirunthu	காத்திருந்து	காதிருந்து
kaaththirundhu	காத்திருந்து	காத்திருந்து
kaaththirunththu	காத்திருந்து	காத்திருந்து
kaaththirunthu	காத்திருந்து	காத்திருந்து
kaatthirunthu	காத்திருந்து	காத்திருந்து
kaanagaththin	கானகத்தின்	காணகத்தின்
kanakaththin	கானகத்தின்	கணகத்தின்
kaanagam	கானகம்	காணகம்
kanagam	கானகம்	கணகம்
kaabul	காபூல்	காபுல்
kabul	காபூல்	கபுல்
kabuul	காபூல்	காபல்
kapuul	காபூல்	காப்
qabul	காபூல்	காபல்
kaapaatri	காப்பாற்றி	காப்பாற்றி
kaapaattri	காப்பாற்றி	காப்ற்றி
kaappaatri	காப்பாற்றி	காப்பாற்றி
kaappaatrti	காப்பாற்றி	காப்பாற்றி
kaappatrtri	காப்பாற்றி	காப்பற்றி
kaapaatrinaar	காப்பாற்றினார்	காப்பாற்றினார்
kaappaatrinaar	காப்பாற்றினார்	காப்பாற்றினார்
kaappaatrtrinaar	காப்பாற்றினார்	காப்பாற்றினார்
kaappu	காப்பு	காப்பு
kappu	காப்பு	காப்பு
kaappuch	காப்புச்	காப்புச்
kappuch	காப்புச்	கப்புச்
kaaranangalukkaagavum	காரணங்களுக்காகவும்	காரணங்களுக்காகவும்
kaaranangalukkaakavum	காரணங்களுக்காகவும்	காரணங்களுக்காகவும்
karananggalukkaakavum	காரணங்களுக்காகவும்	கரணங்களுக்காகவும்
kaaranaththai	காரணத்தை	காரணத்தை
kaaranattai	காரணத்தை	காரணட்டை
kaaranatthai	காரணத்தை	காரணத்தை
karanaththai	காரணத்தை	கரணத்தை
kaaranaththaip	காரணத்தைப்	காரணத்தைப்
kaaranattaip	காரணத்தைப்	காரணட்டைப்
kaaranatthaip	காரணத்தைப்	காரணத்தைப்
karanaththaip	காரணத்தைப்	கரணத்தைப்
kaaranamaaga	காரணமாக	காரணமாக
kaaranamaaka	காரணமாக	காரணமாக
karanamaaka	காரணமாக	கரணமாக
kaaranamaakak	காரணமாகக்	காரணமாகக்
karanamaakach	காரணமாகக்	கரணமாகச்
kaaranamaagath	காரணமாகத்	காரணமாகத்
kaaranamaakat	காரணமாகத்	காரணமாகத்
kaaranamaakath	காரணமாகத்	காரணமாகத்
karanamaakath	காரணமாகத்	கரணமாகத்
kaaranamaakavo	காரணமாகவோ	காரணமாகவோ
karanamaakavo	காரணமாகவோ	கரணமாகவோ
kaaram	காரம்	காரம்
carin	காரின்	கரின்
kaarin	காரின்	காரின்
caril	காரில்	கேரில்
kaaril	காரில்	காரில்
carai	காரை	கரரை
kaarai	காரை	காரை
caar	கார்	கார்
car	கார்	கார்
kar	கார்	கார்
cargalai	கார்களை	கர்களை
kaargalai	கார்களை	கார்களை
kaarkalai	கார்களை	கார்களை
carbon	கார்பன்	கார்னன்
kaarban	கார்பன்	கார்பன்
kaarpan	கார்பன்	கார்பன்
karban	கார்பன்	கர்பன்
karbon	கார்பன்	கார்பன்
karbonn	கார்பன்	கார்னன்
karpan	கார்பன்	கார்பன்
qarban	கார்பன்	கர்பன்
qarbon	கார்பன்	கார்னன்
qarbonn	கார்பன்	கார்னன்
caarl	கார்ல்	கார்
carl	கார்ல்	கார்
carll	கார்ல்	கார்ல்
karl	கார்ல்	கார்
karll	கார்ல்	கார்ல்
qarl	கார்ல்	கார்
qarll	கார்ல்	கார்ல்
kaatraal	காற்றால்	காற்றால்
katraal	காற்றால்	கற்றால்
kaatrinaal	காற்றினால்	காற்றினால்
katrinaal	காற்றினால்	கற்றினால்
kaatrilirundhu	காற்றிலிருந்து	காற்றிலிருந்து
kaatrilirunthu	காற்றிலிருந்து	காற்றிலிருந்து
katrilirunthu	காற்றிலிருந்து	கற்றிலிருந்து
kaalakatta	காலகட்ட	காலக்ட
kalakatta	காலகட்ட	கலகட்ட
kaalakattaththin	காலகட்டத்தின்	காலகட்டத்தின்
kalakattaththin	காலகட்டத்தின்	கலகட்டத்தின்
kaalakattam	காலகட்டம்	காலகட்டம்
kalakattam	காலகட்டம்	கலகட்டம்
kattangal	காலக்	கட்டங்கள்
kattangkal	காலக்	கட்டங்கள்
kattankal	காலக்	கட்டங்கள்
kattaththai	காலக்	கட்டத்தை
kattattai	காலக்	கட்டட்டை
keduvukkul	காலக்	கெடுவுக்குள்
ketuvukkul	காலக்	கெடுவுக்குள்
colony	காலணி	காலி
kaalani	காலணி	காலனி
kaalaththaik	காலத்தைக்	காலத்தைக்
kaalattaik	காலத்தைக்	காலட்டைக்
kaalatthaik	காலத்தைக்	காலத்தைக்
kaalaththaip	காலத்தைப்	காலத்தைப்
kaalattaip	காலத்தைப்	காலட்டைப்
kaalatthaip	காலத்தைப்	காலத்தைப்
kaavalthurai	காவல்துறை	காவல்துறை
kaavalturai	காவல்துறை	காவல்டுறை
kaavthurai	காவல்துறை	காவ்துறை
kaavalthuraiyin	காவல்துறையின்	காவல்துறையின்
kaavalturaiyin	காவல்துறையின்	காவல்டுறையின்
kaavalthuraiyil	காவல்துறையில்	காவல்துறையில்
kaavalturaiyil	காவல்துறையில்	காவல்டுறையில்
kaavalthuraiyum	காவல்துறையும்	காவல்துறையும்
kaavalturaiyum	காவல்துறையும்	காவல்டுறையும்
kaavalthuraiyai	காவல்துறையை	காவல்துறையை
kaavalturaiyai	காவல்துறையை	காவல்டுறையை
kidangkugal	கிடங்குகள்	கிடங்குகள்
kidangugal	கிடங்குகள்	கிடங்குகள்
kidangukal	கிடங்குகள்	கிடங்குகள்
kidankukal	கிடங்குகள்	கிடங்குகள்
kitankukal	கிடங்குகள்	கிடங்குகள்
kidandhadhu	கிடந்தது	கிடந்தது
kidandhathu	கிடந்தது	கிடந்தது
kidanthathu	கிடந்தது	கிடந்தது
kitantatu	கிடந்தது	கிட்டாண்டு
kitanthathu	கிடந்தது	கிடந்தது
kidandhana	கிடந்தன	கிடந்தன
kidantana	கிடந்தன	கிடன்தன
kidanthana	கிடந்தன	கிடந்தன
kitantana	கிடந்தன	கிட்டன்னா
kidandhan	கிடந்தான்	கிடந்தன்
kidanthaan	கிடந்தான்	கிடந்தான்
kidanthan	கிடந்தான்	கிடந்தன்
kitantaan	கிடந்தான்	கிட்டான்
kidandhar	கிடந்தார்	கிடந்தர்
kidanthaar	கிடந்தார்	கிடந்தார்
kidanthar	கிடந்தார்	கிடந்தர்
kitantaar	கிடந்தார்	கிட்டா்்
kidandhu	கிடந்து	கிடந்து
kidanthu	கிடந்து	கிடந்து
kidantu	கிடந்து	கிடன்டு
kitanthu	கிடந்து	கிடந்து
kitantu	கிடந்து	கிட்டன்
kidai	கிடை	கிடை
kidaikkach	கிடைக்கச்	கிடைக்கச்
kidaikkap	கிடைக்கப்	கிடைக்கப்
kidaikkaadha	கிடைக்காத	கிடைக்காத
kidaikkaatha	கிடைக்காத	கிடைக்காத
kidaikkaamal	கிடைக்காமல்	கிடைக்காமல்
kitaikkaamal	கிடைக்காமல்	கிடைக்காமல்
kidaikkum	கிடைக்கும்	கிடைக்கும்
kitaikkum	கிடைக்கும்	கிடைக்கும்
kidaikkumbodhu	கிடைக்கும்போது	கிடைக்கும்போது
kidaikkumboodhu	கிடைக்கும்போது	கிடைக்கும்போது
kidaikkumbothu	கிடைக்கும்போது	கிடைக்கும்போது
kidaikkumpodhu	கிடைக்கும்போது	கிடைக்கும்போது
kidaikkumpoodhu	கிடைக்கும்போது	கிடைக்கும்போது
kidaikkumpootu	கிடைக்கும்போது	கிடைக்கும்போடு
kidaikkumpothu	கிடைக்கும்போது	கிடைக்கும்போது
kitaikkumpootu	கிடைக்கும்போது	கிடைக்கும்போடு
ginnas	கின்னஸ்	கினான்
ginnes	கின்னஸ்	கினேன்
guines	கின்னஸ்	குனிஸ்
guinness	கின்னஸ்	கின்னஸ்
guuinness	கின்னஸ்	குனினஸ்
kinnas	கின்னஸ்	கினான்
kinnes	கின்னஸ்	கின்னஸ்
kinns	கின்னஸ்	கின்ஸ்
cubavin	கியூபாவின்	குபவின்
kiyoobaavin	கியூபாவின்	கியோபாவின்
kiyoopaavin	கியூபாவின்	கியோபாவின்
grantha	கிரந்த	கிரந்த
kirantha	கிரந்த	கிரந்த
krantha	கிரந்த	கிரந்த
graham	கிரஹாம்	கிராம்
kirubakaran	கிருபாகரன்	கிருபகரான்
kirubhaagaran	கிருபாகரன்	கிருபாகரன்
kirubhaakaran	கிருபாகரன்	கிருபாகரன்
kirupakaran	கிருபாகரன்	கிறுப்பக்கரன
kiristhavar	கிறித்தவர்	கிறிஸ்தவர்
kiriththavar	கிறித்தவர்	கிறித்தவர்
kiritthavar	கிறித்தவர்	கிறித்தவர்
kiriththuvam	கிறித்துவம்	கிறித்துவம்
keelo	கிலோ	கீலோ
keeloo	கிலோ	கீலோ
kiilo	கிலோ	கிலோ
kilo	கிலோ	கிலோ
kiloo	கிலோ	கிலோ
kylo	கிலோ	கிலோ
kyloo	கிலோ	கிலோ
qeelo	கிலோ	கீலோ
qilo	கிலோ	கிலோ
qylo	கிலோ	கிலோ
keevi	கிவி	கீவி
keewi	கிவி	கீவி
keewii	கிவி	கீவி
kiivi	கிவி	கிவி
kiiwi	கிவி	கிவி
kiiwii	கிவி	கிவி
kivi	கிவி	கிவி
kivii	கிவி	கிவி
kiwi	கிவி	கிவி
kiwii	கிவி	கிவி
qeewi	கிவி	கீவி
qiiwi	கிவி	கீவி
qiwi	கிவி	கிவி
qiwii	கிவி	கிவி
geethaiyin	கீதையின்	கீதையின்
geethayin	கீதையின்	கீதயின்
green	கீரன்	கிரேன்
keeran	கீரன்	கேரன்
kunggumappoo	குங்குமப்பூ	குங்குமப்போ
kungkumappoo	குங்குமப்பூ	குங்குமப்போ
kungumapoo	குங்குமப்பூ	குங்குமபோ
kungumappoo	குங்குமப்பூ	குங்குமப்போ
kuchaylar	குசேலர்	குசையர்
kuchelar	குசேலர்	குசெலர்
kusaylar	குசேலர்	குசெலர்
kuselar	குசேலர்	குசலலர்
kuch	குச்	குச்
kuchh	குச்	குச்
kuuch	குச்	கூச்
kuuchh	குச்	கூச்
quch	குச்	குச்
quchh	குச்	குச்
quuch	குச்	குச்
gunamaagum	குணமாகும்	குணமாகும்
gunamagum	குணமாகும்	குணமாகும்
kunamaakum	குணமாகும்	குணமாகும்
gunavardhana	குணவர்தன	குணவர்தன
gunavarththana	குணவர்தன	குணவர்த்தன
gunaathisayanggalai	குணாதிசயங்களை	குணாதிசயங்களை
gunadhisayangalai	குணாதிசயங்களை	குணதிசயங்களை
gunathisayankalai	குணாதிசயங்களை	குணதிசயங்களை
gunaathisanggal	குணாதிசயங்கள்	குணாதிசங்கள்
gunaathisayanggal	குணாதிசயங்கள்	குணாதிசயங்கள்
gunadhisayangal	குணாதிசயங்கள்	குணதிசயங்கள்
kuththappattu	குத்தப்பட்டு	குத்தப்பட்டு
kuthdhudhal	குத்துதல்	குத்துதல்
kuththudhal	குத்துதல்	குத்துதல்
kuththuthal	குத்துதல்	குத்துதல்
kutthuthal	குத்துதல்	குத்துதல்
guptha	குப்த	குப்த
kuptha	குப்த	குப்த
kumili	குமிழி	குமிலி
kumizhi	குமிழி	குமிழி
kumilikal	குமிழிகள்	குமிலிகள்
kumizhgal	குமிழிகள்	குமிழ்கள்
kumizhigal	குமிழிகள்	குமிழிகள்
kumizhikal	குமிழிகள்	குமிழிகள்
gummi	கும்மி	கும்மி
kummi	கும்மி	கும்மி
kurudi	குருதி	குருடி
kuruthi	குருதி	குறுத்தி
kurudich	குருதிச்	குறுடிச்
kuruthich	குருதிச்	குறுதிச்
kurudhip	குருதிப்	குறுதிப்
kuruthip	குருதிப்	குறுத்பி
kurudiyin	குருதியின்	குறுடியின்
kuruthiyin	குருதியின்	குறுதியின்
kurudiyil	குருதியில்	குறுடியில்
kuruthiyil	குருதியில்	குறுதியில்
kurudhiyai	குருதியை	குறுதியை
kuruthiyai	குருதியை	குறுத்தியை
guruvikal	குருவிகள்	குருவிகள்
kuruvigal	குருவிகள்	குறுவிகள்
guraikkum	குரைக்கும்	குறைக்கும்
kuraikkum	குரைக்கும்	குறைக்கும்
kuraikum	குரைக்கும்	குறைக்கும்
kuravanjchi	குறவஞ்சி	குறவஞ்சி
kuravanji	குறவஞ்சி	குரவஞ்சி
kuripil	குறிப்பில்	குறிப்பில்
kurippil	குறிப்பில்	குறிப்பில்
kurippaedu	குறிப்பேடு	குறிப்பேடு
kurippedu	குறிப்பேடு	குறிப்பெடு
kurugalaana	குறுகலான	குறுகளான
kurukku	குறுக்கு	குறுக்கு
kurukkuk	குறுக்குக்	குறுக்குக்
kuraindha	குறைந்த	குறைந்த
kuraindhdha	குறைந்த	குறைந்த
kuraintha	குறைந்த	குறைந்த
kuraindhadhaaga	குறைந்ததாக	குறைந்ததாக
kuraindhdhadhaaga	குறைந்ததாக	குறைந்ததாக
kurainthathaaka	குறைந்ததாக	குறைந்ததாக
kuraindadhaal	குறைந்ததால்	குறைந்ததால்
kuraindhdhadhaal	குறைந்ததால்	குறைந்ததால்
kurainthathaal	குறைந்ததால்	குறைந்ததால்
kuraindhadhu	குறைந்தது	குறைந்தது
kuraindhdhadhu	குறைந்தது	குறைந்தது
kurainthathu	குறைந்தது	குறைந்தது
kuraindhana	குறைந்தன	குறைந்தன
kuraindhdhana	குறைந்தன	குறைந்தன
kurainthana	குறைந்தன	குறைந்தன
kuraindhaalum	குறைந்தாலும்	குறைந்தாலும்
kuraindhdhaalum	குறைந்தாலும்	குறைந்தாலும்
kurainthaalum	குறைந்தாலும்	குறைந்தாலும்
kuraindhdhullathu	குறைந்துள்ளது	குறைந்துள்ளது
kuraindhulladhu	குறைந்துள்ளது	குறைந்துள்ளது
kurainthulladhu	குறைந்துள்ளது	குறைந்துள்ளது
kulanggalil	குளங்களில்	குழங்களில்
kulangkalil	குளங்களில்	குழங்களில்
kulanggalukku	குளங்களுக்கு	குழங்களுக்கு
kulangkalukku	குளங்களுக்கு	குழங்களுக்கு
kulirchchiyaana	குளிர்ச்சியான	குளிர்ச்சியான
kulai	குழை	குலை
kuzai	குழை	குஜை
kuzhai	குழை	குழை
gooam	குவாம்	கோம்
guam	குவாம்	கும்
guama	குவாம்	குமா
guuam	குவாம்	கும்
guuama	குவாம்	குமா
kuvam	குவாம்	குவம்
kuvindha	குவிந்த	குவிந்த
kuvinta	குவிந்த	குவின்ட
kuvintha	குவிந்த	குவிந்த
kuvindhulladhu	குவிந்துள்ளது	குவிந்துள்ளது
kuvindhullathu	குவிந்துள்ளது	குவிந்துள்ளது
kuvinthullathu	குவிந்துள்ளது	குவிந்துள்ளது
kuvintullathu	குவிந்துள்ளது	குவின்டுள்ளது
kuvintullatu	குவிந்துள்ளது	குவின்டுள்ளது
koodam	கூடம்	கோடம்
koodi	கூடி	கோடி
koodith	கூடித்	கூடித்
koodinar	கூடினர்	கோடினர்
koodip	கூடிப்	கோடிப்
koodu	கூடு	கோடு
kuudu	கூடு	கூடு
kuutu	கூடு	கூடு
koodugalai	கூடுகளை	கோடுகளை
koodukalai	கூடுகளை	கோடுகளை
kuudukalai	கூடுகளை	கூடுகளை
kuutukalai	கூடுகளை	கூடுகளை
koodugal	கூடுகள்	கூடுகள்
koodukal	கூடுகள்	கூடுகள்
kuudugal	கூடுகள்	கூடுகள்
kuudukal	கூடுகள்	கூடுகள்
kuutukal	கூடுகள்	கூடுகள்
kootta	கூட்ட	கோட்டா
kuuta	கூட்ட	கூட்டா
kuutta	கூட்ட	கூட்டா
koottangalil	கூட்டங்களில்	கோட்டங்களில்
kuuttangalil	கூட்டங்களில்	கூட்டங்களில்
kuuttankalil	கூட்டங்களில்	கூட்டங்களில்
koottangalum	கூட்டங்களும்	கோட்டங்களும்
kuuttangalum	கூட்டங்களும்	கூட்டங்களும்
kuuttankalum	கூட்டங்களும்	கூட்டங்களும்
koottaththirku	கூட்டத்திற்கு	கூட்டத்திற்கு
kuuttatthirku	கூட்டத்திற்கு	கூட்டத்திற்கு
kuuttattirku	கூட்டத்திற்கு	கூட்டட்டிற்கு
koottaththil	கூட்டத்தில்	கூட்டத்தில்
koottatthil	கூட்டத்தில்	கூட்டத்தில்
kuuttatil	கூட்டத்தில்	கூட்டாடில்
kuuttatthil	கூட்டத்தில்	கூட்டத்தில்
kuuttattil	கூட்டத்தில்	கூட்டட்டில்
koottaththudan	கூட்டத்துடன்	கூட்டத்துடன்
koottatthudan	கூட்டத்துடன்	கூட்டத்துடன்
kuutattudan	கூட்டத்துடன்	கூட்டுட்டன்
kuutattutan	கூட்டத்துடன்	கூட்டுட்டன்
koottaththaik	கூட்டத்தைக்	கூட்டத்தைக்
koottatthaik	கூட்டத்தைக்	கூட்டத்தைக்
kuuttattaik	கூட்டத்தைக்	கூட்டட்டைக்
kuuttatthaik	கூட்டத்தைக்	கூட்டத்தைக்
koottaththaip	கூட்டத்தைப்	கூட்டத்தைப்
koottatthaip	கூட்டத்தைப்	கூட்டத்தைப்
kuuttataip	கூட்டத்தைப்	கூட்டாட்ப்
kuuttattaip	கூட்டத்தைப்	கூட்டட்டைப்
koottal	கூட்டல்	கோட்டல்
koottavo	கூட்டவோ	கோட்டவோ
kuutavoo	கூட்டவோ	கூட்வோ
kuuttavoo	கூட்டவோ	கூட்டவோ
koottagach	கூட்டாகச்	கோட்டகாச்
koottakach	கூட்டாகச்	கோட்டககச்
kuuttaakac	கூட்டாகச்	கூட்டாகச்
kuuttaakach	கூட்டாகச்	கூட்டாகச்
kootinaal	கூட்டினால்	கோட்டினால்
koottinaal	கூட்டினால்	கோட்டினால்
koottinal	கூட்டினால்	கோட்டினல்
koottuvadharkku	கூட்டுவதற்கு	கூட்டுவதற்கு
koottuvadharku	கூட்டுவதற்கு	கூட்டுவதற்கு
koottuvatharku	கூட்டுவதற்கு	கூட்டுவதற்கு
koottai	கூட்டை	கோட்டை
koorai	கூரை	கோரை
kooraigal	கூரைகள்	கோரைகள்
kooraikal	கூரைகள்	கோரைகள்
kooreigal	கூரைகள்	கோரிகள்
kooraiyin	கூரையின்	கோரையின்
kooraiyilirundhu	கூரையிலிருந்து	கூறையிலிருந்து
kooraiyilirunthu	கூரையிலிருந்து	கூறையிலிருந்து
koorayilirindhu	கூரையிலிருந்து	கூறையிரிந்து
mudiyuma	கூற	முடியுமா
mudiyumaa	கூற	முட்டியா
mutiyuma	கூற	முட்டியா
mutiyumaa	கூற	முட்டியா
koorappattadhu	கூறப்பட்டது	கூறப்பட்டது
koorappattathu	கூறப்பட்டது	கூறப்பட்டது
kuurapattatu	கூறப்பட்டது	கூறப்பட்டது
kuurappattatu	கூறப்பட்டது	கூறப்பட்டடு
koorappattana	கூறப்பட்டன	கூறப்பட்டன
kuurapattana	கூறப்பட்டன	கூறப்பட்டன
kuurappattana	கூறப்பட்டன	கூறப்பட்டன
koorappattaalum	கூறப்பட்டாலும்	கோரப்பட்டாலும்
kuurappataalum	கூறப்பட்டாலும்	கூறப்படாடும்
kuurappattaalum	கூறப்பட்டாலும்	கூறப்பட்டாலும்
koorappattaal	கூறப்பட்டால்	கூறப்பட்டால்
kuurapattaal	கூறப்பட்டால்	கூறப்பட்டால்
kuurappattaal	கூறப்பட்டால்	கூறப்பட்டால்
koorappattulla	கூறப்பட்டுள்ள	கூறப்பட்டுள்ள
kuurapattulla	கூறப்பட்டுள்ள	கூறப்பட்டுள்ள
kuurappattulla	கூறப்பட்டுள்ள	கூறப்பட்டுள்ள
kooravillai	கூறவில்லை	கோரவில்லை
kuuravillai	கூறவில்லை	கூறவில்லை
kooravae	கூறவே	கோரவே
koorave	கூறவே	கோரவே
kuravee	கூறவே	குறவே
koorinaal	கூறினால்	கோரினால்
kuurinaal	கூறினால்	கூறினால்
koorudhal	கூறுதல்	கூறுதல்
kooruthal	கூறுதல்	கூறுதல்
koorumpoadhu	கூறும்போது	கூறும்போது
koorumpodhu	கூறும்போது	கூறும்போது
koorumpothu	கூறும்போது	கூறும்போது
kedu	கெடு	கெடு
kaeplar	கெப்லர்	கேப்லர்
keeplar	கெப்லர்	கீப்லர்
keplar	கெப்லர்	கெப்லர்
kepler	கெப்லர்	கெப்லர்
kiiplar	கெப்லர்	கிப்லர்
qeeplar	கெப்லர்	கீப்லர்
qeplar	கெப்லர்	கெப்லர்
qepler	கெப்லர்	கெப்லர்
kaellar	கெல்லர்	கேல்லர்
keler	கெல்லர்	கெலர்
kellar	கெல்லர்	கெல்லர்
keller	கெல்லர்	கெல்லர்
qeller	கெல்லர்	கெல்லர்
ccelli	கெல்லி	கெல்லி
ccelly	கெல்லி	கெல்லி
ccely	கெல்லி	கெலி
celli	கெல்லி	கெல்லி
celly	கெல்லி	கெல்லி
cely	கெல்லி	கெலி
kaelli	கெல்லி	கேல்லி
keley	கெல்லி	கெலி
keli	கெல்லி	கெலி
kellei	கெல்லி	கெல்லி
kelley	கெல்லி	கெல்லி
kelli	கெல்லி	கெல்லி
kelly	கெல்லி	கெல்லி
kely	கெல்லி	கெலி
qelley	கெல்லி	கெல்லி
qelli	கெல்லி	கெல்லி
qelly	கெல்லி	கெல்லி
gautham	கெளதம்	கௌதம்
goutham	கெளதம்	கோதம்
kaudham	கெளதம்	கௌதம்
kovtham	கெளதம்	கோத்தம்
catalina	கேடலினா	கட்லானி
cetalina	கேடலினா	சட்டலினா
keedalina	கேடலினா	கீடலினா
kaetta	கேட்ட	கேட்ட
ketta	கேட்ட	கெட்டா
kaettadhai	கேட்டதை	கேட்டதை
kaettathai	கேட்டதை	கேட்டதை
ketadhai	கேட்டதை	கேடத்தை
ketathai	கேட்டதை	கேடத்தை
kaettal	கேட்டல்	கேட்டல்
kettal	கேட்டல்	கெட்டல்
kaettavar	கேட்டவர்	கேட்டவர்
kettavar	கேட்டவர்	கட்டவர்
kaettaan	கேட்டான்	கேட்டான்
kettan	கேட்டான்	கெட்டன்
catie	கேட்டி	காட்டி
catiee	கேட்டி	காடி
cetie	கேட்டி	கெட்டி
kaetti	கேட்டி	கேட்டி
kati	கேட்டி	காடி
katie	கேட்டி	காடி
katiee	கேட்டி	கடி
katii	கேட்டி	காடி
katiie	கேட்டி	காடி
katiiee	கேட்டி	கடி
kattie	கேட்டி	கட்டி
kattiee	கேட்டி	கட்டி
katy	கேட்டி	காட்
katyi	கேட்டி	கட்டி
ketie	கேட்டி	கெட்டி
ketiee	கேட்டி	கெட்டி
ketiie	கேட்டி	கெட்டி
ketti	கேட்டி	கெட்டி
kettie	கேட்டி	கெட்டி
kety	கேட்டி	கெட்டி
ketyi	கேட்டி	கெட்டி
qatie	கேட்டி	காடி
qatiee	கேட்டி	காடி
qatiie	கேட்டி	காடி
qattie	கேட்டி	கட்டி
qaty	கேட்டி	காட்
qatyi	கேட்டி	காட்டி
kaettum	கேட்டும்	கேட்டும்
kettum	கேட்டும்	கெட்டும்
kaendhira	கேந்திர	கேந்திர
kaenthira	கேந்திர	கேந்திர
kendhira	கேந்திர	கெந்திர
kendra	கேந்திர	கென்ற
kaikoarkka	கைகோர்க்க	கைகோர்க்க
kaikoorkka	கைகோர்க்க	கைகோர்க்க
kaikorkka	கைகோர்க்க	கைக்கோர்க்கா
kaik	கைக்	கைக்
kaidhi	கைதி	கைதி
kaithi	கைதி	கைதி
kaydhi	கைதி	காதி
kaythi	கைதி	காத்தி
kaidhigaludan	கைதிகளுடன்	கைதிகளுடன்
kaidhigalutan	கைதிகளுடன்	கைதிகளுடன்
kaidhikaludan	கைதிகளுடன்	கைதிகளுடன்
kaithigaludan	கைதிகளுடன்	கைதிகளுடன்
kaithigalutan	கைதிகளுடன்	கைதிகளுடன்
kaidhigalaiyum	கைதிகளையும்	கைதிகளையும்
kaidhikalaiyum	கைதிகளையும்	கைதிகளையும்
kaithigalaiyum	கைதிகளையும்	கைதிகளையும்
kaiyin	கையின்	கையின்
kaiyoppamitta	கையொப்பமிட்ட	கையோப்பமிட்ட
kaiyoppamittaar	கையொப்பமிட்டார்	கையோப்பமிட்டார்
kaiyoppamittar	கையொப்பமிட்டார்	கையோப்பமிட்டர்
kaivittanar	கைவிட்டனர்	கைவிட்டனர்
kaiviral	கைவிரல்	கைவிரள்
kodukkiradhu	கொடுக்கிறது	கொடுக்கிறது
kodukkirathu	கொடுக்கிறது	கொடுக்கிறது
kodukkiraan	கொடுக்கிறான்	கொடுக்கிறான்
kodukkiraar	கொடுக்கிறார்	கொடுக்கிறார்
kottagai	கொட்டகை	கொட்டகை
kottagaikku	கொட்டகைக்கு	கொட்டகைக்கு
vidugirathu	கொட்டி	விடுகிறது
vidukirathu	கொட்டி	விடுகிறது
vitukiratu	கொட்டி	விட்டுகிறது
kottik	கொட்டிக்	கொட்டிக்
konara	கொணர	கோனரா
kondaa	கொண்டா	கொண்டா
kondirukkaamal	கொண்டிருக்காமல்	கொண்டிருக்காமல்
kondirukkamal	கொண்டிருக்காமல்	கொண்டிருக்கமால்
kontirukkamal	கொண்டிருக்காமல்	கொண்டிருக்கமால்
kodhi	கொதி	கொதி
kothi	கொதி	கொதி
kodhikka	கொதிக்க	கொதிக்க
kothikka	கொதிக்க	கொதிக்க
gorilla	கொரில்லாப்	கோரில்லா
gorillaap	கொரில்லாப்	கோரில்லாப்
gorillap	கொரில்லாப்	கோரில்லப்
korillaap	கொரில்லாப்	கொறில்லாப்
kolusu	கொலுசு	கோலு
kolgiraar	கொள்கிறார்	கொள்கிறார்
kolkiraar	கொள்கிறார்	கொல்கிறார்
kolgiraen	கொள்கிறேன்	கொள்கிறேன்
kolkirayn	கொள்கிறேன்	கொல்கிறான்
kollvadhan	கொள்வதன்	கொள்வதான்
kolvadhan	கொள்வதன்	கொள்வதன்
kolvathan	கொள்வதன்	கொள்வதன்
kolvadharkaaga	கொள்வதற்காக	கொள்வதற்காக
kolvatharkaaka	கொள்வதற்காக	கொள்வதற்காக
kollvadharkaagavum	கொள்வதற்காகவும்	கொள்வதற்காகவும்
kolvadharkaagavum	கொள்வதற்காகவும்	கொள்வதற்காகவும்
kolvatharkkakavum	கொள்வதற்காகவும்	கொள்வதற்கக்கவும்
kollvadhaaga	கொள்வதாக	கொள்வதாக
kolvadhaaga	கொள்வதாக	கொள்வதாக
kolvathaaka	கொள்வதாக	கொள்வதாக
kollvathaagum	கொள்வதாகும்	கொள்வதாகும்
kolvadhaagum	கொள்வதாகும்	கொள்வதாகும்
kolvathaakum	கொள்வதாகும்	கொள்வதாகும்
kolu	கொழு	கோலு
kozhu	கொழு	கொழு
koadaari	கோடாரி	கோடாரி
koodaari	கோடாரி	கோடாரி
kootaari	கோடாரி	கோடாரி
kaalangalil	கோடைக்	காலங்களில்
kaalangazhil	கோடைக்	காலங்களில்
kaalangkalil	கோடைக்	காலங்களில்
kalankalil	கோடைக்	கலங்களில்
koatpaatukalil	கோட்பாடுகளில்	கோட்பாடுகளில்
kootpaadugalil	கோட்பாடுகளில்	கோட்பாடுகளில்
kootpaadukalil	கோட்பாடுகளில்	கோட்பாடுகளில்
kootpaatukalil	கோட்பாடுகளில்	கோட்பாடுகளில்
koatpaatugalukku	கோட்பாடுகளுக்கு	கோட்பாடுகளுக்கு
kootpaadugalukku	கோட்பாடுகளுக்கு	கோட்பாடுகளுக்கு
kootpaadukalukku	கோட்பாடுகளுக்கு	கோட்பாடுகளுக்கு
kootpaatugalukku	கோட்பாடுகளுக்கு	கோட்பாடுகளுக்கு
kootpaatukalukku	கோட்பாடுகளுக்கு	கோட்பாடுகளுக்கு
koatpaatukalaip	கோட்பாடுகளைப்	கோட்பாடுகளைப்
kootpaadugalaip	கோட்பாடுகளைப்	கோட்பாடுகளைப்
kootpaadukalaip	கோட்பாடுகளைப்	கோட்பாடுகளைப்
kootpaatugalaip	கோட்பாடுகளைப்	கோட்பாடுகளைப்
kootpaatukalaip	கோட்பாடுகளைப்	கோட்பாடுகளைப்
koatpaatukalaiyum	கோட்பாடுகளையும்	கோட்பாடுகளையும்
kootpaadukalaiyum	கோட்பாடுகளையும்	கோட்பாடுகளையும்
koatpaatukal	கோட்பாடுகள்	கோட்பாடுகள்
kootpaadugal	கோட்பாடுகள்	கோட்பாடுகள்
kootpaadukal	கோட்பாடுகள்	கோட்பாடுகள்
kootpaatukal	கோட்பாடுகள்	கோட்பாடுகள்
godhra	கோத்ரா	கோத்ரா
koathraa	கோத்ரா	கோத்ரா
koothraa	கோத்ரா	கூத்ரா
kootraa	கோத்ரா	கூற்றா
conan	கோனன்	கோனன்
conann	கோனன்	கானன்
connan	கோனன்	கனனன்
coonan	கோனன்	கோனன்
coonann	கோனன்	கோனன்
coonnan	கோனன்	கோனன்
coounan	கோனன்	கோனன்
coownan	கோனன்	கோனன்
counan	கோனன்	கோனன்
couunan	கோனன்	கோனன்
covnan	கோனன்	கவனன்
cownan	கோனன்	கவனன்
koonn	கோனன்	கோன்
koapiththukkondu	கோபித்துக்கொண்டு	கோபித்துக்கொண்டு
kobiththukkondu	கோபித்துக்கொண்டு	கோபித்துக்கொண்டு
kobithukondu	கோபித்துக்கொண்டு	கோபித்துகொண்டு
koopitthukkontu	கோபித்துக்கொண்டு	கோபித்துக்கொண்டு
koopittukkondu	கோபித்துக்கொண்டு	கோபிட்டுக்கொண்டு
koopittukkontu	கோபித்துக்கொண்டு	கோபிட்டுக்கொண்டு
kopiththukkondu	கோபித்துக்கொண்டு	கோபித்துக்கொண்டு
kopithukondu	கோபித்துக்கொண்டு	கோபித்துகொண்டு
koamagan	கோமகன்	கோமகன்
komagan	கோமகன்	கோமகன்
koomagan	கோமகன்	கோமகன்
koomakan	கோமகன்	கோமகன்
caul	கோல்	கால்
cauul	கோல்	கால்
col	கோல்	கால்
coll	கோல்	கால்
cool	கோல்	கோல்
cooll	கோல்	கோல்
goal	கோல்	கோல்
goall	கோல்	கோல்
gol	கோல்	கோல்
gooal	கோல்	கோல்
gooall	கோல்	கோல்
gool	கோல்	கோல்
gooul	கோல்	கோல்
goul	கோல்	கோல்
gouul	கோல்	கோல்
kaul	கோல்	கால்
kauul	கோல்	கால்
kol	கோல்	கோல்
kole	கோல்	கோல்
kool	கோல்	கோல்
qaul	கோல்	கால்
qol	கோல்	கோல்
goalgal	கோல்கள்	கோல்கள்
goalkal	கோல்கள்	கோல்கள்
kolgal	கோல்கள்	கொள்கள்
koolkal	கோல்கள்	கோல்கள்
golconda	கோல்கொண்டா	கால்ட்டா
golkonda	கோல்கொண்டா	கால்கோண்டா
koolkondaa	கோல்கொண்டா	கொல்கொண்டா
koolkontaa	கோல்கொண்டா	கொல்கொண்டா
kolil	கோளில்	கொலில்
koolil	கோளில்	கோலில்
koovalar	கோவலர்	கோவலர்
kovalar	கோவலர்	கோவலர்
gouravaththai	கௌரவத்தை	கோரவத்தை
gowravathai	கௌரவத்தை	கோரவததை
gowrawaththay	கௌரவத்தை	கோரவதத்தே
kouravaththay	கௌரவத்தை	கோரவத்தே
gouravamana	கௌரவமான	கோரவமான
gowravamaana	கௌரவமான	கோரவமான
gowrawamaana	கௌரவமான	கோரவமான
kouravamaana	கௌரவமான	கோரவமான
gauravam	கௌரவம்	கௌரவம்
gowravam	கௌரவம்	கோரவவம்
kauravam	கௌரவம்	கௌரவம்
kouravam	கௌரவம்	கோரவம்
gouravippu	கௌரவிப்பு	கோரவிப்பு
gowravippu	கௌரவிப்பு	கோரவிப்பு
gowrawippu	கௌரவிப்பு	கோரவிப்பு
kouravippu	கௌரவிப்பு	கோரவிப்பு
saga	சக	சாகா
saka	சக	சகா
cagaaya	சகாய	காகாயா
cakaaya	சகாய	காகாயா
chagaaya	சகாய	சகாயா
chakaaya	சகாய	சகாயா
sagaaya	சகாய	சகாயா
sagaya	சகாய	சகாயா
cagaayam	சகாயம்	காகாயம்
cakaayam	சகாயம்	காகாயம்
chagaayam	சகாயம்	சகாயம்
chakaayam	சகாயம்	சகாயம்
sagaayam	சகாயம்	சகாயம்
sagayam	சகாயம்	சகாயம்
cakkara	சக்கர	காக்கர
chakkara	சக்கர	சக்கரா
sakkara	சக்கர	சக்கரா
cakkarangal	சக்கரங்கள்	காக்கரங்கள்
cakkarankal	சக்கரங்கள்	காக்கரங்கள்
chakkarangal	சக்கரங்கள்	சக்கரரங்கள்
chakkarankal	சக்கரங்கள்	சக்கரங்கள்
sakkarangal	சக்கரங்கள்	சக்கரரங்கள்
sakkaranggal	சக்கரங்கள்	சக்கரங்கள்
chakkaraththil	சக்கரத்தில்	சக்கரத்தில்
sakkaraththil	சக்கரத்தில்	சக்கரத்தில்
cakkaram	சக்கரம்	காக்கரம்
chakkaram	சக்கரம்	சக்கரம்
sakkaram	சக்கரம்	சக்கரம்
cakkarai	சக்கரை	காக்கரை
chakkarai	சக்கரை	சக்கரை
sakkarai	சக்கரை	சக்கரை
changka	சங்க	சங்கா
sanga	சங்க	சங்கா
sangga	சங்க	சங்கா
sangh	சங்க	சங்
sangha	சங்க	சங்கா
sangka	சங்க	சங்கா
sangangalin	சங்கங்களின்	சங்கங்களின்
sanggangkalin	சங்கங்களின்	சங்கங்களின்
sangkangkalin	சங்கங்களின்	சங்கங்களின்
sangangalil	சங்கங்களில்	சங்கங்களில்
sanggangkalil	சங்கங்களில்	சங்கங்களில்
sangkangkalil	சங்கங்களில்	சங்கங்களில்
cankangalum	சங்கங்களும்	கங்கங்களும்
cankankalum	சங்கங்களும்	கங்கங்களும்
chankangalum	சங்கங்களும்	சங்கங்களும்
chankankalum	சங்கங்களும்	சங்கங்களும்
sangankalum	சங்கங்களும்	சங்கங்களும்
sanggangkalum	சங்கங்களும்	சங்கங்களும்
changkaththaal	சங்கத்தால்	சங்கத்தால்
sangaththal	சங்கத்தால்	சங்கத்தல்
sanggaththaal	சங்கத்தால்	சங்கத்தால்
sangkaththaal	சங்கத்தால்	சங்கத்தால்
cankatthin	சங்கத்தின்	காங்கத்தின்
cankattin	சங்கத்தின்	காங்கட்டின்
chankattin	சங்கத்தின்	சங்கத்தின்
sangaththin	சங்கத்தின்	சங்கத்தின்
sanggaththin	சங்கத்தின்	சங்கத்தின்
sangaththilirundhdhu	சங்கத்திலிருந்து	சங்கத்திலிருந்து
sangaththilirundhu	சங்கத்திலிருந்து	சங்கத்திலிருந்து
sangaththilirunthu	சங்கத்திலிருந்து	சங்கத்திலிருந்து
sanggaththilirunthu	சங்கத்திலிருந்து	சங்கத்திலிருந்து
sangaththilum	சங்கத்திலும்	சங்கத்திலும்
sanggaththilum	சங்கத்திலும்	சங்கத்திலும்
sangap	சங்கப்	சங்கப்
sanggap	சங்கப்	சங்கப்
sankap	சங்கப்	சங்கப்
sangama	சங்கம	சங்கமா
sanggama	சங்கம	சங்கமா
sankama	சங்கம	சங்கமா
sankarin	சங்கரின்	சங்கரின்
shankarin	சங்கரின்	சங்கரின்
sanggin	சங்கின்	சங்கின்
sangin	சங்கின்	சங்கின்
sanggiliyin	சங்கிலியின்	சங்கிலியின்
sangiliyin	சங்கிலியின்	சங்கிலியின்
sangilyyin	சங்கிலியின்	சங்கிலியின்
sanggiliyil	சங்கிலியில்	சங்கிலியில்
sangiliyil	சங்கிலியில்	சங்கிலியில்
sangilyyil	சங்கிலியில்	சங்கிலியில்
sattaikku	சட்டைக்கு	சட்டைக்கு
sadhaveedha	சதவீத	சதவேத
sathaveetha	சதவீத	சதவேத
sadhaveedhaththai	சதவீதத்தை	சதவேதத்தை
sathaveedhaththai	சதவீதத்தை	சதவேதத்தை
sathaveethaththai	சதவீதத்தை	சதவேதத்தை
santharppa	சந்தர்ப்ப	சந்தர்ப்பா
santharppaththai	சந்தர்ப்பத்தை	சந்தர்ப்பத்தை
sandhaa	சந்தா	சந்தா
santha	சந்தா	சந்தா
santhaa	சந்தா	சந்தா
sandhaippaduththudhal	சந்தைப்படுத்துதல்	சந்தைப்படுத்துதல்
sandhaippaduththuthal	சந்தைப்படுத்துதல்	சந்தைப்படுத்துதல்
santhaippaduththuthal	சந்தைப்படுத்துதல்	சந்தைப்படுத்துதல்
sandhaippaduththum	சந்தைப்படுத்தும்	சந்தைப்படுத்தும்
santhaippaduththum	சந்தைப்படுத்தும்	சந்தைப்படுத்தும்
chaand	சந்த்	சாண்ட்
chand	சந்த்	சா்ட்
chanda	சந்த்	சாண்டா
jaen	சன	ஜேன்
jain	சன	ஜென்
jan	சன	ஜான்
jann	சன	ஜான்
jayn	சன	ஜென்
zaen	சன	ஜேன்
zan	சன	ஜான்
zann	சன	ஜான்
zayn	சன	ஜென்
san	சன்	சான்
sann	சன்	சன்
son	சன்	சோன்
sun	சன்	சுன்
sunn	சன்	சன்
suun	சன்	சன்
suunn	சன்	சன்
tivi	சன்	திவி
sabadham	சபதம்	சபாதம்
sabatham	சபதம்	சபதம்
sabaiyinar	சபையினர்	சபையினர்
sab	சப்	சப்
sabb	சப்	சப்
sub	சப்	சுப்
subb	சப்	சப்
suub	சப்	சப்
suubb	சப்	சப்
samagaalaththil	சமகாலத்தில்	சமகாலத்தில்
samakaalaththil	சமகாலத்தில்	சமகாலத்தில்
samacheeraana	சமச்சீரான	சமச்சீரான
samachieerana	சமச்சீரான	சமச்சியரான
samachierana	சமச்சீரான	சமச்சிரான
samamaagavae	சமமாகவே	சமமாகவே
samamagave	சமமாகவே	சமமாகவே
samamakave	சமமாகவே	சமமாகவே
samamaagum	சமமாகும்	சமமாகும்
samamagum	சமமாகும்	சமமாகும்
samamakum	சமமாகும்	சமமகும்
samayaththavar	சமயத்தவர்	சமயத்தவர்
samarppiththa	சமர்ப்பித்த	சமர்ப்பித்த
samavaaippu	சமவாய்ப்பு	சமவாய்ப்பு
samavaayppu	சமவாய்ப்பு	சமவாய்ப்பு
samavaippu	சமவாய்ப்பு	சமவைப்பு
sameera	சமீரா	சமேர
samsaara	சம்சார	சம்சார
sumsaara	சம்சார	சும்சாரா
sambirathaayathil	சம்பிரதாயத்தில்	சம்பிரதாததியில்
sambradhaayathil	சம்பிரதாயத்தில்	சம்பரதாயத்தில்
sambrathaayathil	சம்பிரதாயத்தில்	சம்பரதாயத்தில்
sampirathaayatthil	சம்பிரதாயத்தில்	சம்பிரத்தாயத்தில
sampirathayathil	சம்பிரதாயத்தில்	சம்பிரதததாதில்
sampirathayaththil	சம்பிரதாயத்தில்	சம்பிரத்தாயத்தில
sambiradhayathai	சம்பிரதாயத்தை	சம்பிரதாயதை
sambradhayathai	சம்பிரதாயத்தை	சம்பரரதயததை
sambrathayaththai	சம்பிரதாயத்தை	சம்பரரதயதத்தை
sampiradhayathai	சம்பிரதாயத்தை	சம்பிரதாயதை
sampirathaayatthai	சம்பிரதாயத்தை	சம்பிரதாதியத்தை
sampirathayaththai	சம்பிரதாயத்தை	சம்பிரத்தாயத்தை
sambandhappatta	சம்மந்தப்பட்ட	சம்பந்தப்பட்ட
sammanthappatta	சம்மந்தப்பட்ட	சம்மந்தப்பட்ட
sammandhdhamaana	சம்மந்தமான	சம்மந்தமான
sammanthamaana	சம்மந்தமான	சம்மந்தமான
cargo	சரக்கு	கார்கோ
kargo	சரக்கு	கார்கோ
kargoo	சரக்கு	கர்கோ
kargou	சரக்கு	கார்கோ
kargouu	சரக்கு	கர்கோ
kargu	சரக்கு	கார்கு
karrgo	சரக்கு	கர்கோ
qargoo	சரக்கு	கர்கோ
qargou	சரக்கு	கார்கோ
qarrgo	சரக்கு	கர்கோ
sarakku	சரக்கு	சரக்கு
sarakkukalai	சரக்குகளை	சரக்குகளை
sarasu	சரசு	சரசு
saranadainthanar	சரணடைந்தனர்	சரணடைந்தனர்
saranadaiyach	சரணடையச்	சரணடையச்
soorai	சர்ரே	சூரை
sooray	சர்ரே	சூரை
soorey	சர்ரே	சூரி
soorreey	சர்ரே	சூர்யே
soorrei	சர்ரே	சூர்ரி
soorrey	சர்ரே	சூர்யே
suray	சர்ரே	சுரே
surey	சர்ரே	சுரே
surrai	சர்ரே	சுர்ரை
surray	சர்ரே	சுர்ரே
surreey	சர்ரே	சுர்ரே
surrei	சர்ரே	சுர்ரே
surrey	சர்ரே	சுர்ரே
suurray	சர்ரே	சுர்ரே
suurrey	சர்ரே	சுர்ரி
sarvaadhigaara	சர்வாதிகார	சர்வாதிகார
sarvaathikaara	சர்வாதிகார	சர்வாதிகார
sarvaadhigaaraththai	சர்வாதிகாரத்தை	சர்வாதிகாரத்தை
sarvaathikaaraththai	சர்வாதிகாரத்தை	சர்வாதிகாரத்தை
sarvaathikaaratthai	சர்வாதிகாரத்தை	சர்வாதிகாரத்தை
sarvaadhigaaram	சர்வாதிகாரம்	சர்வாதிகாரம்
sarvaathikaaram	சர்வாதிகாரம்	சர்வாதிகாரம்
sarvaadigaari	சர்வாதிகாரி	சர்வாடிகாரி
sarvaathikaari	சர்வாதிகாரி	சர்வாதிகாரி
satru	சற்று	சாற்று
sattru	சற்று	சற்று
saakkadai	சாக்கடை	சாக்கடை
sakkadai	சாக்கடை	சக்கடை
saakkadaigal	சாக்கடைகள்	சாக்கடைகள்
sakkadaikal	சாக்கடைகள்	சக்கடைகள்
saakkiya	சாக்கிய	சாக்கியா
sakkiya	சாக்கிய	சக்கியா
saasanam	சாசனம்	சாசனம்
sasanam	சாசனம்	சசனம்
saattai	சாட்டை	சாட்டை
saattay	சாட்டை	சாட்டே
sattai	சாட்டை	சட்டை
saadhagamaaga	சாதகமாக	சாதகமாக
saathakamaaka	சாதகமாக	சாதகமாக
sathakamaka	சாதகமாக	சதாகமாக
saathanangal	சாதனங்கள்	சாதனங்கள்
saathanangkal	சாதனங்கள்	சாதனங்கள்
saadhaarana	சாதாரண	சாதாரன
saathaarana	சாதாரண	சாதாரன
saadhaaranamaaga	சாதாரணமாக	சாதாரணமாக
saathaaranamaaga	சாதாரணமாக	சாதாரணமாக
saathaaranamaaka	சாதாரணமாக	சாதாரணமாக
saadhaaranamaanathu	சாதாரணமானது	சாதாரணமானது
saathaaranamaanathu	சாதாரணமானது	சாதாரணமானது
saaththiyamaaga	சாத்தியமாக	சாத்தியமாக
saaththiyamaaka	சாத்தியமாக	சாத்தியமாக
saaththiyamaagum	சாத்தியமாகும்	சாத்தியமாகும்
saaththiyamaakum	சாத்தியமாகும்	சாத்தியமாகும்
saayam	சாயம்	சாயம்
saaradhi	சாரதி	சாரதி
saarathi	சாரதி	சாரதி
saarathy	சாரதி	சாரத்தி
sarathi	சாரதி	சரத்தி
caarnthoo	சார்ந்தோ	கார்ந்தோ
chaarntho	சார்ந்தோ	சார்ந்தோ
saarndhoa	சார்ந்தோ	சார்ந்தோ
saarnthoo	சார்ந்தோ	சார்ந்தோ
caarpatta	சார்பற்ற	கார்பட்ட
chaarpatta	சார்பற்ற	சார்ப்டாட
saarpatta	சார்பற்ற	சார்பட்ட
saarpattra	சார்பற்ற	சார்ப்றத்ற
saarpattrra	சார்பற்ற	சார்பற்ற
chaalukkiya	சாளுக்கிய	சாலுக்கிய
chalukya	சாளுக்கிய	சலுக்கா
saalukkiya	சாளுக்கிய	சாலுக்கிய
salukkiya	சாளுக்கிய	சலுக்கிய
java	சாவா	ஜவவா
saava	சாவா	சாவா
saavaa	சாவா	சாவா
saavilirundhu	சாவிலிருந்து	சாவிலிருந்து
saavilirunthu	சாவிலிருந்து	சாவிலிருந்து
saashthaa	சாஸ்தா	சாஸ்தா
saasthaa	சாஸ்தா	சாஸ்தா
sastha	சாஸ்தா	சஸ்தா
saashthiriyin	சாஸ்திரியின்	சாஸ்திரியின்
saasthiriyin	சாஸ்திரியின்	சாஸ்திரியின்
sastriyin	சாஸ்திரியின்	சஸ்திரியின்
shastriyin	சாஸ்திரியின்	சா்்திரியின்
chikkanam	சிக்கனம்	சிக்கானம்
sikanam	சிக்கனம்	சிகன்
sikkanam	சிக்கனம்	சிக்கானம்
caitric	சிட்ரிக்	கைட்ரிக்
cetric	சிட்ரிக்	கெட்ரிக்
citric	சிட்ரிக்	சிற்றிக்
citrick	சிட்ரிக்	கிட்ரிக்
citricq	சிட்ரிக்	கிட்ரிக்
citrik	சிட்ரிக்	கிட்ரிக்
citriq	சிட்ரிக்	கிற்றிக்
shidhi	சிதி	சிதி
sidhi	சிதி	சிதி
sidi	சிதி	சிடி
siidhii	சிதி	சிதி
siidii	சிதி	சிடி
sydhi	சிதி	சிதி
sydhii	சிதி	சிதி
chithiraith	சித்திரைத்	சிதிரைத்
sithiraith	சித்திரைத்	சிதிரைத்
siththiraith	சித்திரைத்	சித்திரைத்
sitthiraith	சித்திரைத்	சித்திரைத்
chithiraiyil	சித்திரையில்	சித்திரையில்
sithiraiyil	சித்திரையில்	சித்திரையில்
siththiraiyil	சித்திரையில்	சித்திரையில்
sitthiraiyil	சித்திரையில்	சித்திரையில்
chintha	சிந்தா	சிந்த
chinthaa	சிந்தா	சிந்தா
sindhaa	சிந்தா	சிந்தா
sintha	சிந்தா	சிந்த
sinthaa	சிந்தா	சிந்தா
chinthitthu	சிந்தித்து	சிந்தித்து
sinthiththu	சிந்தித்து	சிந்தித்து
sinthithu	சிந்தித்து	சிந்தித்து
sinthitthu	சிந்தித்து	சிந்தித்து
sindhu	சிந்து	சிந்து
sinthu	சிந்து	சிந்து
sindhum	சிந்தும்	சிந்தும்
sindhuvin	சிந்துவின்	சிந்துவின்
cbse	சிபிஎஸ்இ	காஸ்
seempson	சிம்ப்சன்	சிம்போன்
siimpson	சிம்ப்சன்	சிம்போன்
simpsan	சிம்ப்சன்	சிம்பன்
simpson	சிம்ப்சன்	சிம்பன்
simpsonn	சிம்ப்சன்	சிம்பன்
sympson	சிம்ப்சன்	சிம்பன்
shimma	சிம்ம	சிம்மா
simma	சிம்ம	சிம்மா
chiyol	சியோல்	சியோல்
chiyool	சியோல்	சியோல்
seooul	சியோல்	சோயல்
seoul	சியோல்	சோல்
seouul	சியோல்	சோல்
siyoal	சியோல்	சியோல்
siyool	சியோல்	சியோல்
sirikka	சிரிக்க	சிறிக்கா
siria	சிரிய	சிரியா
siriya	சிரிய	சிறியா
syria	சிரிய	சிரியா
siridhalavum	சிறிதளவும்	சிறிதலாவும்
sirithalavum	சிறிதளவும்	சிறிதலாவும்
koodam	சிறைக்	கோடம்
kutam	சிறைக்	குட்டம்
siraik	சிறைக்	சிறைக்
siraikh	சிறைக்	சிறைக்
sivanadhu	சிவனது	சிவனாது
sivanathu	சிவனது	சிவனாது
sivanaal	சிவனால்	சிவனால்
sivanal	சிவனால்	சிவனால்
sivapragasham	சிவப்பிரகாசம்	சிவப்பரராசம்
sivaprakasam	சிவப்பிரகாசம்	சிவப்பர்காசம்
sivasivappiragasam	சிவப்பிரகாசம்	சிவசிவாப்பிராக
sivappirakaashar	சிவப்பிரகாசர்	சிவப்பிரகாகர்
sivappirakasar	சிவப்பிரகாசர்	சிவப்பிரகாகர்
sivaprakasar	சிவப்பிரகாசர்	சிவப்பர்காசர்
sivaprakashar	சிவப்பிரகாசர்	சிவப்பர்காசர்
cevil	சிவில்	கேவில்
cewil	சிவில்	கேவில்
civiil	சிவில்	கிவில்
civil	சிவில்	கிவில்
ciwiil	சிவில்	சிவில்
ciwil	சிவில்	சிவில்
sivil	சிவில்	சிவில்
siwil	சிவில்	சிவில்
season	சீசன்	சேசன்
sesan	சீசன்	சேசன்
seson	சீசன்	சேன்
siijan	சீசன்	சிஜன்
siizan	சீசன்	சிசன்
sijan	சீசன்	சிசன்
sizan	சீசன்	சிசன்
caesarin	சீசரின்	சேசரின்
cesarin	சீசரின்	சேரின்
seesarin	சீசரின்	சீசரின்
caesar	சீசர்	கேசர்
cesar	சீசர்	சேசர்
ciisar	சீசர்	சிசர்
cisar	சீசர்	சிசர்
seesar	சீசர்	சேசர்
siijor	சீசர்	சிஜோர்
sijor	சீசர்	சிசோர்
sizor	சீசர்	சிசோர்
seenivasan	சீனிவாசன்	சீனிவசான்
srinivasan	சீனிவாசன்	ஸ்ரீனிவசான்
seeriya	சீரிய	சீரியா
sarial	சீரியல்	சரியல்
serial	சீரியல்	சேரியல்
seriial	சீரியல்	செரியல்
chiirutaikalai	சீருடைகளை	சிறுதைகளை
chirutaikalai	சீருடைகளை	சிறுதைகளை
seerudaigalai	சீருடைகளை	சீருடைகளை
seerudaikalai	சீருடைகளை	சீருடைகளை
serutaikalai	சீருடைகளை	சேருடைகளை
siirutaikalai	சீருடைகளை	சிறுதைகளை
seeri	சீறி	சீரி
sugandhan	சுகந்தன்	சுகந்தன்
suganthan	சுகந்தன்	சுகந்தன்
sukanthan	சுகந்தன்	சுகந்தன்
chukumaaran	சுகுமாரன்	சுகுமாரன்
sugumaaran	சுகுமாரன்	சுகுமாரன்
sugumaran	சுகுமாரன்	சுகுமரன்
sukumaaran	சுகுமாரன்	சுகுமாரன்
sukumaran	சுகுமாரன்	சுகுமாரன்
chuththa	சுத்த	சுத்த
chuttha	சுத்த	சுத்த
suththa	சுத்த	சுத்த
suttha	சுத்த	சுத்த
chuththap	சுத்தப்	சுத்தப்
chutthap	சுத்தப்	சுத்தப்
suththap	சுத்தப்	சுத்தப்
sutthap	சுத்தப்	சுத்தப்
chuttham	சுத்தம்	சுத்தம்
sutham	சுத்தம்	சுதம்
suththam	சுத்தம்	சுத்தம்
suttham	சுத்தம்	சுத்தம்
sudhthikarikkappatta	சுத்திகரிக்கப்பட்ட	சுத்திகரிக்கப்பட்ட
suththikarikkappatta	சுத்திகரிக்கப்பட்ட	சுத்திகரிக்கப்பட்ட
suththikarippu	சுத்திகரிப்பு	சுத்திகரிப்பு
chunithaa	சுனிதா	சுனிதா
sunita	சுனிதா	சுனிடா
sunitha	சுனிதா	சுனித
sunithaa	சுனிதா	சுனிதா
suunita	சுனிதா	சுனிடா
chuyeecchai	சுயேச்சை	சுயேச்சை
suyaechchai	சுயேச்சை	சுயேச்சை
suyechai	சுயேச்சை	சுய்சை
suyechchai	சுயேச்சை	சுயச்சை
suyeecchai	சுயேச்சை	சுயேச்சை
shruthi	சுருதி	ஷிருத்தி
surudhi	சுருதி	சுருதி
suruthi	சுருதி	சுருத்தி
surusuruppaaga	சுறுசுறுப்பாக	சுருசுருப்பாக
surrullaath	சுற்றுலாத்	சுர்லுளாத்
sutrullaath	சுற்றுலாத்	சுற்றுள்ளாத்
suttrulaath	சுற்றுலாத்	சுற்றுளாத்
surrulaavin	சுற்றுலாவின்	சுர்லுவாவின்
sutrulaavin	சுற்றுலாவின்	சுற்றுளாவின்
suttrulaavin	சுற்றுலாவின்	சுற்றுளாவின்
surrulaavai	சுற்றுலாவை	சுர்லுவாவை
sutrulaavai	சுற்றுலாவை	சுற்றுளாவை
suttrulaavai	சுற்றுலாவை	சுற்றுளாவை
sulalil	சுழலில்	சுலலில்
suzhalil	சுழலில்	சுழலில்
suvaasikkath	சுவாசிக்கத்	சுவாசிக்கத்
suvachikkath	சுவாசிக்கத்	சுவசிக்கத்
suvasikkath	சுவாசிக்கத்	சுவசிக்கத்
chootti	சூட்டி	சூட்டி
chutti	சூட்டி	சுட்டி
shootti	சூட்டி	சூட்டி
sootti	சூட்டி	சூட்டி
choottinaar	சூட்டினார்	சூட்டினார்
chuttinaar	சூட்டினார்	சுட்டினார்
shoottinaar	சூட்டினார்	சூட்டினார்
soottinaar	சூட்டினார்	சூட்டினார்
choottinai	சூட்டினை	சூட்டினை
chuttinai	சூட்டினை	சுட்டினை
shootinai	சூட்டினை	சூட்டினை
soottinai	சூட்டினை	சூட்டினை
suittinai	சூட்டினை	சூட்டினை
choottil	சூட்டில்	சூட்டில்
soottil	சூட்டில்	சூட்டில்
suittil	சூட்டில்	சூட்டில்
choothaatta	சூதாட்ட	சூதாட்ட
soodhaatta	சூதாட்ட	சூதாட்ட
soothaatta	சூதாட்ட	சூதாட்ட
choothaattathil	சூதாட்டத்தில்	சூதாட்டதில்
soodhattaththil	சூதாட்டத்தில்	சூதட்டத்தில்
soothaattaththil	சூதாட்டத்தில்	சூதாட்டத்தில்
sooyas	சூயஸ்	சோயஸ்
suez	சூயஸ்	சுஸ்
suyas	சூயஸ்	சுயஸ்
sooraavali	சூறாவளி	சூராவலி
sooravazhi	சூறாவளி	சூரவாளி
sooraavaliyaaga	சூறாவளியாக	சூராவலியாக
sooraavaliyaaka	சூறாவளியாக	சூராவலியாக
sooravazhiyaga	சூறாவளியாக	சூரவவியாக
soolappatta	சூழப்பட்ட	சூலப்பட்ட
soozhappatta	சூழப்பட்ட	சூழப்பட்ட
soolappattu	சூழப்பட்டு	சூலப்பட்டு
soozhappattu	சூழப்பட்டு	சூழப்பட்டு
chengkam	செங்கம்	செங்கம்
sengam	செங்கம்	செங்கம்
sengkam	செங்கம்	செங்கம்
senkam	செங்கம்	செங்கம்
seyarpaadugalinaal	செயற்பாடுகளினால்	செயற்பாடுகளினால்
seyarpaadugal	செயற்பாடுகள்	செயற்பாடுகள்
seyarpadugal	செயற்பாடுகள்	செயர்படுகள்
seyarpaadum	செயற்பாடும்	செயற்பாடும்
seyarpadum	செயற்பாடும்	செயர்படும்
seyalaatri	செயலாற்றி	செயலாற்றி
seyalaattri	செயலாற்றி	செயலாற்றி
seyalattri	செயலாற்றி	செயலற்றி
seyalaatrum	செயலாற்றும்	செயலாற்றும்
seyalaattrum	செயலாற்றும்	செயலாற்றும்
seyalattrum	செயலாற்றும்	செயலற்றும்
seyalaatruvathu	செயலாற்றுவது	செயலாற்றுவது
seyalaattruvathu	செயலாற்றுவது	செயலாற்றுவது
seyalattruvadhu	செயலாற்றுவது	செயலற்றுவது
seyalattruvathu	செயலாற்றுவது	செயலற்றுவது
seyalilakka	செயலிழக்க	செயலிலக்க
seyalizhakka	செயலிழக்க	செயலிழக்க
seyalukku	செயலுக்கு	செயலுக்கு
seyalum	செயலும்	செயலும்
seyalpada	செயல்பட	செயல்படா
seyalpadakkoodiya	செயல்படக்கூடிய	செயல்படக்கோடிய
seyalpadakkudiya	செயல்படக்கூடிய	செயல்படக்குடிய
seyalpadath	செயல்படத்	செயல்படடத்
seyalpadavillai	செயல்படவில்லை	செயல்படவவில்லை
seyalpadavum	செயல்படவும்	செயல்படவாம்
seyalpaduvum	செயல்படவும்	செயல்படுவும்
seyalpadaamal	செயல்படாமல்	செயல்படாமல்
seyalpadamal	செயல்படாமல்	செயல்படமால்
cheyalpaduvatharku	செயல்படுவதற்கு	செயல்படுவதறது
cheyalpatuvatharku	செயல்படுவதற்கு	செயல்பட்டுவதற்கு
seyalpaduvadharku	செயல்படுவதற்கு	செயல்படுவதற்கு
seyalpaduvatharku	செயல்படுவதற்கு	செயல்படுவதற்கு
seyalpatuvatharku	செயல்படுவதற்கு	செயல்படுடுவதற்கு
cheyalmurai	செயல்முறை	செயல்முறை
seyalmurai	செயல்முறை	செயல்முறை
seidhadhan	செய்ததன்	செய்ததான்
seithathan	செய்ததன்	செய்ததன்
cheythavan	செய்தவன்	செய்தவன்
seidhavan	செய்தவன்	செய்தவன்
seithavan	செய்தவன்	செய்தவன்
seythavan	செய்தவன்	செய்தவன்
seidhulladhu	செய்துள்ளது	செய்துள்ளது
seithullathu	செய்துள்ளது	செய்துள்ளது
seidhullaar	செய்துள்ளார்	செய்துள்ளார்
seithullaar	செய்துள்ளார்	செய்துள்ளார்
seibavargalin	செய்பவர்களின்	செய்பவர்களின்
seibavarkalin	செய்பவர்களின்	செய்பவர்களின்
seibavargalukku	செய்பவர்களுக்கு	செய்பவர்களுக்கு
seibavarkalukku	செய்பவர்களுக்கு	செய்பவர்களுக்கு
seibavargalai	செய்பவர்களை	செய்பவர்களை
seibavarkalai	செய்பவர்களை	செய்பவர்களை
seiyappattathaal	செய்யப்பட்டதால்	செய்யப்பட்டதால்
seiyyappattadhaal	செய்யப்பட்டதால்	செய்யப்பட்டதால்
seiyyappattathaal	செய்யப்பட்டதால்	செய்யப்பட்டதால்
seiyappattathai	செய்யப்பட்டதை	செய்யப்பட்டதை
seiyyappattadhai	செய்யப்பட்டதை	செய்யப்பட்டதை
seiyyappattathai	செய்யப்பட்டதை	செய்யப்பட்டதை
seiyappattana	செய்யப்பட்டன	செய்யப்பட்டன
seiyyappattana	செய்யப்பட்டன	செய்யப்பட்டன
seiyappattavar	செய்யப்பட்டவர்	செய்யப்பட்டவர்
seiyyappattavar	செய்யப்பட்டவர்	செய்யப்பட்டவர்
seiyappattaal	செய்யப்பட்டால்	செய்யப்பட்டால்
seiyappattal	செய்யப்பட்டால்	செய்யப்பட்டல்
seyyappattal	செய்யப்பட்டால்	செய்யப்பட்டல்
seiyappattirukkum	செய்யப்பட்டிருக்கும்	செய்யப்பட்டிருக்கும்
seyyappattirukkum	செய்யப்பட்டிருக்கும்	செய்யப்பட்டிருக்கும்
seiyappattum	செய்யப்பட்டும்	செய்யப்பட்டும்
seyyappattum	செய்யப்பட்டும்	செய்யப்பட்டும்
seiyappattulla	செய்யப்பட்டுள்ள	செய்யப்பட்டுள்ள
seyyappattulla	செய்யப்பட்டுள்ள	செய்யப்பட்டுள்ள
seiyappattulladhu	செய்யப்பட்டுள்ளது	செய்யப்பட்டுள்ளது
seiyappattullathu	செய்யப்பட்டுள்ளது	செய்யப்பட்டுள்ளது
seyyappattullathu	செய்யப்பட்டுள்ளது	செய்யப்பட்டுள்ளது
seiyulil	செய்யுளில்	செய்யுளில்
seyyulil	செய்யுளில்	செய்யுளில்
cherbiya	செர்பிய	செர்பியா
serbia	செர்பிய	சர்பியா
serbiya	செர்பிய	சேர்பியா
chelavita	செலவிட	செலவிட்டா
selavida	செலவிட	செலவிடா
selavita	செலவிட	செலவிட்டா
chelavitapadum	செலவிடப்படும்	செலவிடப்படும்
chelavitappadum	செலவிடப்படும்	செலவிடப்படும்
selavidappadum	செலவிடப்படும்	செலவிடப்படும்
selavitappatum	செலவிடப்படும்	செலவிடப்பட்டும்
cheluthi	செலுத்தி	செலுத்தி
chelutthi	செலுத்தி	செலுத்தி
seluthi	செலுத்தி	செலுத்தி
seluththi	செலுத்தி	செலுத்தி
selutthi	செலுத்தி	செலுத்தி
cheluthik	செலுத்திக்	செலுத்திக்
chelutthik	செலுத்திக்	செலுத்திக்
seluthik	செலுத்திக்	செலுத்திக்
seluththik	செலுத்திக்	செலுத்திக்
selutthik	செலுத்திக்	செலுத்திக்
cheluthina	செலுத்தின	செலுத்தின
chelutthina	செலுத்தின	செலுத்தின
seluthina	செலுத்தின	செலுத்தின
seluththina	செலுத்தின	செலுத்தின
selutthina	செலுத்தின	செலுத்தின
cheluthinar	செலுத்தினார்	செலுத்தினர்
chelutthinaar	செலுத்தினார்	செலுத்தினார்
seluthinaar	செலுத்தினார்	செலுத்தினார்
seluththinaar	செலுத்தினார்	செலுத்தினார்
selutthinaar	செலுத்தினார்	செலுத்தினார்
segarippil	சேகரிப்பில்	செகரிப்பில்
sekarippil	சேகரிப்பில்	செகரிப்பில்
chaethamadainththu	சேதமடைந்து	சேதமடைந்து
saethamadainththu	சேதமடைந்து	சேதமடைந்து
sedhamadaindhu	சேதமடைந்து	செதமதைந்து
sethamadaindhu	சேதமடைந்து	செதமதைந்து
saeiyon	சேயோன்	சேயோன்
saeyaon	சேயோன்	சேயான்
saeyon	சேயோன்	சேயன்
seiyon	சேயோன்	செய்னோ
seyon	சேயோன்	செயன்
cheri	சேரி	செரி
saeri	சேரி	சேரி
saerkkaikkaana	சேர்க்கைக்கான	சேர்க்கைக்கான
serkkaikkaana	சேர்க்கைக்கான	சேர்க்கைக்கான
saerkkaikku	சேர்க்கைக்கு	சேர்க்கைக்கு
serkkaikku	சேர்க்கைக்கு	சேர்க்கைக்கு
saerkkaiyil	சேர்க்கையில்	சேர்க்கையில்
serkkaiil	சேர்க்கையில்	சேர்க்கையில்
serkkaiyil	சேர்க்கையில்	செர்க்கையில்
saerkkaiyum	சேர்க்கையும்	சேர்க்கையும்
serkkaium	சேர்க்கையும்	சேர்க்கையும்
serkkaiyum	சேர்க்கையும்	சேர்க்கையும்
saerththu	சேர்த்து	சேர்த்து
serththu	சேர்த்து	சேர்த்து
saerththuk	சேர்த்துக்	சேர்த்துக்
serththuk	சேர்த்துக்	சேர்த்துக்
saerththukkondaar	சேர்த்துக்கொண்டார்	சேர்த்துக்கொண்டார்
serththukkondaar	சேர்த்துக்கொண்டார்	சேர்த்துக்கொண்டார்
saerththukkolvathan	சேர்த்துக்கொள்வதன்	சேர்த்துக்கொள்வதன்
serththukkolvathan	சேர்த்துக்கொள்வதன்	சேர்த்துக்கொள்வதன்
saerththuth	சேர்த்துத்	சேர்த்துத்
serththuth	சேர்த்துத்	சேர்த்துத்
saerththup	சேர்த்துப்	சேர்த்துப்
serththup	சேர்த்துப்	சேர்த்துப்
chervai	சேர்வை	செர்வே
saervai	சேர்வை	சேர்வை
servai	சேர்வை	சேர்வை
saigaigalai	சைகைகளை	சைகைகளை
saigaikalai	சைகைகளை	சைகைகளை
saikaigalai	சைகைகளை	சைகைகளை
saikaikalai	சைகைகளை	சைகைகளை
cibar	சைபர்	சிபர்
cibarr	சைபர்	சிபர்
ciber	சைபர்	கிபர்
ciberr	சைபர்	சிபர்
cipher	சைபர்	சிப்ரர்
cybar	சைபர்	சிபர்
cyber	சைபர்	சிபர்
cyfer	சைபர்	கிப்பர்
cyphar	சைபர்	சிப்
cypher	சைபர்	சைப்
saibar	சைபர்	சைபர்
sibar	சைபர்	சிபர்
siber	சைபர்	சிபர்
syber	சைபர்	சிபர்
saivaththin	சைவத்தின்	சைவத்தின்
saivar	சைவர்	சைவர்
sombu	சொம்பு	சோம்பு
sompu	சொம்பு	சொம்பு
chori	சொறி	சோரி
sori	சொறி	சோரி
chorpolivu	சொற்பொழிவு	சொற்போலிவு
sorpolivu	சொற்பொழிவு	சொற்போலிவு
sorpozhivu	சொற்பொழிவு	சொற்போழிவு
chorpolivukalai	சொற்பொழிவுகளை	சொற்போலிவுகளை
sorpolivugalai	சொற்பொழிவுகளை	சொர்போலிவுகளை
sorpolivukalai	சொற்பொழிவுகளை	சொற்போலிவுகளை
sorpolzhivugalai	சொற்பொழிவுகளை	சொர்பொழ்விவுகள
chorpolivukal	சொற்பொழிவுகள்	சொற்பொலிவுகள்
sorpolivugal	சொற்பொழிவுகள்	சொற்பொலிவுகள்
sorpolivukal	சொற்பொழிவுகள்	சொற்பொலிவுகள்
sorpozhivugal	சொற்பொழிவுகள்	சொற்பொழிவுகள்
cholana	சொல்லான	சோலன
chollaana	சொல்லான	சொல்லான
sollaana	சொல்லான	சொல்லான
chollu	சொல்லு	சொல்லு
sollu	சொல்லு	சொல்லு
chollukkup	சொல்லுக்குப்	சொல்லுக்குப்
cholukup	சொல்லுக்குப்	சொலுக்குப்
sollukkup	சொல்லுக்குப்	சொல்லுக்குப்
solluvar	சொல்லுவர்	சொல்லுவர்
cholvar	சொல்வர்	சொல்வர்
solvar	சொல்வர்	சொல்வர்
cholvaar	சொல்வார்	சொல்வார்
cholvar	சொல்வார்	சொல்வர்
solvaar	சொல்வார்	சொல்வார்
solvar	சொல்வார்	சொல்வர்
soasalisap	சோசலிசப்	சோசலிசப்
socialisap	சோசலிசப்	சோசியாசிச
sosalisap	சோசலிசப்	சோசலிசப்
shocialishm	சோசலிசம்	சாசியாலிம
soasalisam	சோசலிசம்	சோசலிசம்
socialeesm	சோசலிசம்	சாகியால்ம
socialiism	சோசலிசம்	சாசியாலிம
socialism	சோசலிசம்	சாகியால்
soocialeesm	சோசலிசம்	சூசியால்ம
soocialism	சோசலிசம்	சூசியால்ம
sosalisam	சோசலிசம்	சோசலிசம்
soadi	சோடி	சோடி
sodi	சோடி	சோடி
choathikka	சோதிக்க	சோதிக்க
soathikka	சோதிக்க	சோதிக்க
sothikka	சோதிக்க	சொதிக்க
chooppup	சோப்புப்	சூப்புப்
soappup	சோப்புப்	சோப்புப்
sooppup	சோப்புப்	சூப்புப்
soppup	சோப்புப்	சோப்புப்
sopup	சோப்புப்	சோப்ப்
choayaa	சோயா	சோயா
soayaa	சோயா	சோயா
soi	சோயா	சோ
soia	சோயா	சோயா
sooy	சோயா	சூய்
sooya	சோயா	சூயா
soy	சோயா	சோ
soya	சோயா	சோயா
soyaa	சோயா	சோயா
choazharkalaal	சோழர்களால்	சோழர்களால்
cholargalal	சோழர்களால்	சொலர்களால்
chozharkalaal	சோழர்களால்	சொர்க்கலால்
soazhargalaal	சோழர்களால்	சோழர்களால்
soazharkalaal	சோழர்களால்	சோழர்களால்
solargalal	சோழர்களால்	சொலர்களால்
sozharkalaal	சோழர்களால்	சொழர்களால்
choazharkalai	சோழர்களை	சோழர்களை
cholargalai	சோழர்களை	சொலர்களை
chozhargalai	சோழர்களை	சொரர்களை
soazhargalai	சோழர்களை	சோழர்களை
soazharkalai	சோழர்களை	சோழர்களை
sozharkalai	சோழர்களை	சொழர்களை
jajeera	ஜசீரா	ஜெஜரரா
jazeara	ஜசீரா	ஜெஜாரா
jazeera	ஜசீரா	ஜெஜிரா
jaziira	ஜசீரா	ஜெசிரா
zazeera	ஜசீரா	ஜஜேரா
janadha	ஜனதா	ஜனதா
janadhaa	ஜனதா	ஜனதா
janata	ஜனதா	ஜனாதா
janataa	ஜனதா	ஜனாதா
janatha	ஜனதா	ஜனதா
janeta	ஜனதா	ஜெனத்தா
janetaa	ஜனதா	ஜனேதா
janta	ஜனதா	ஜாந்தா
zanata	ஜனதா	ஜனனா
zanataa	ஜனதா	ஜன்ாதா
japaniya	ஜப்பானிய	ஜப்பானியா
jappaaniya	ஜப்பானிய	ஜப்பானியா
japaniyak	ஜப்பானியக்	ஜப்பானியாக்
jappaaniyak	ஜப்பானியக்	ஜப்பானியாக்
japaniyarkal	ஜப்பானியர்கள்	ஜப்பனியர்கள்
jappaaniyargal	ஜப்பானியர்கள்	ஜப்பானியர்கள்
jappaaniyarkal	ஜப்பானியர்கள்	ஜப்பானியர்கள்
japanukku	ஜப்பானுக்கு	ஜப்பானுக்கு
jappaanukku	ஜப்பானுக்கு	ஜப்பானுக்கு
jameen	ஜமீன்	ஜாமேன்
jamuna	ஜமுனா	ஜமமுனா
jamunaa	ஜமுனா	ஜமுனா
jamp	ஜம்ப்	ஜாம்
jump	ஜம்ப்	ஜம்ப்
juump	ஜம்ப்	ஜாம்
zump	ஜம்ப்	ஜம்ப்
jaansan	ஜான்சன்	ஜான்சன்
jaanson	ஜான்சன்	ஜான்சன்
jhonsan	ஜான்சன்	ஜான்சன்
jhonson	ஜான்சன்	ஜான்ன்
johnson	ஜான்சன்	ஜான்சன்
jecas	ஜீசஸ்	ஜெகஸ்
jesus	ஜீசஸ்	ஜெசஸ்
jesuus	ஜீசஸ்	ஜெசஸ்
jiicas	ஜீசஸ்	ஜிகாஸ்
zesus	ஜீசஸ்	ஜெசஸ்
jeeroa	ஜீரோ	ஜீரோ
zeero	ஜீரோ	ஜீரோ
zero	ஜீரோ	ஜெரோ
jeevan	ஜீவன்	ஜீவன்
joori	ஜூரி	ஜூரி
joory	ஜூரி	ஜூரி
juri	ஜூரி	ஜூரி
jurii	ஜூரி	ஜூரி
jury	ஜூரி	ஜூரி
juuri	ஜூரி	ஜூரி
juury	ஜூரி	ஜூரி
zoory	ஜூரி	ஜூரி
zuri	ஜூரி	ஜூரி
zury	ஜூரி	ஜூரி
jaenna	ஜென்னா	ஜேன்
jeina	ஜென்னா	ஜென்
jena	ஜென்னா	ஜெனா
jenaa	ஜென்னா	ஜெனா
jenna	ஜென்னா	ஜென்
jennaa	ஜென்னா	ஜென்
jeyna	ஜென்னா	ஜெனா
zena	ஜென்னா	ஜெனா
zenna	ஜென்னா	ஜென்னா
zennaa	ஜென்னா	ஜென்னா
zeyna	ஜென்னா	ஜெனா
jaenni	ஜென்னி	ஜென்னி
jannine	ஜென்னி	ஜானின்
jeanie	ஜென்னி	ஜெனி
jeannie	ஜென்னி	ஜெனி
jenni	ஜென்னி	ஜெனி
jennie	ஜென்னி	ஜெனி
jennii	ஜென்னி	ஜெனி
jenny	ஜென்னி	ஜென்
jianine	ஜென்னி	ஜியனனி
jiannine	ஜென்னி	ஜினனனி
jyanine	ஜென்னி	ஜியனனி
jyannine	ஜென்னி	ஜினனின்
zeannie	ஜென்னி	ஜெனி
zenni	ஜென்னி	ஜெனி
zenny	ஜென்னி	ஜென்
ziannine	ஜென்னி	ஜினனனி
zyannine	ஜென்னி	ஜெனினே
jaens	ஜென்ஸ்	ஜென்ஸ்
jains	ஜென்ஸ்	ஜென்ஸ்
jens	ஜென்ஸ்	ஜெஸ்
zains	ஜென்ஸ்	ஜென்ஸ்
zens	ஜென்ஸ்	ஜெஸ்
jebam	ஜெபம்	ஜெபம்
jepam	ஜெபம்	ஜெபம்
jefersaun	ஜெபர்சன்	ஜெபர்சன்
jeferson	ஜெபர்சன்	ஜெபர்சன்
jeffarsaun	ஜெபர்சன்	ஜெப்பர்சன்
jeffarson	ஜெபர்சன்	ஜெப்பர்சன்
jeffersaun	ஜெபர்சன்	ஜெப்பர்சன்
jeffersauun	ஜெபர்சன்	ஜெப்பர்சன்
jefferson	ஜெபர்சன்	ஜெப்பர்ஸன்
jefpharson	ஜெபர்சன்	ஜெப்பரர்சன்
jefpherson	ஜெபர்சன்	ஜெப்பர்சன்
jephpharson	ஜெபர்சன்	ஜெப்பரர்சன்
jephphersaun	ஜெபர்சன்	ஜெப்பர்சுன்
jephpherson	ஜெபர்சன்	ஜெப்பர்சன்
zeffersaun	ஜெபர்சன்	ஜெப்பர்சன்
zefferson	ஜெபர்சன்	ஜெப்பர்ஸன்
zefpherson	ஜெபர்சன்	ஜெப்பர்சன்
zephpharson	ஜெபர்சன்	ஜெப்பர்சன்
germaaniya	ஜெர்மானிய	கேர்மானியா
germania	ஜெர்மானிய	கேர்மனியா
germaaniyap	ஜெர்மானியப்	கேர்மானியப்
germaniyap	ஜெர்மானியப்	கேர்மனியப்
germaaniyarkal	ஜெர்மானியர்கள்	கேர்மானியர்கள்
germaniyargal	ஜெர்மானியர்கள்	கேர்மனியர்கள்
jami	ஜேமி	ஜாமி
jamie	ஜேமி	ஜாமி
jamiee	ஜேமி	ஜாமி
jamii	ஜேமி	ஜாமி
jamiie	ஜேமி	ஜாமி
jamy	ஜேமி	ஜாமி
jeemi	ஜேமி	ஜீமி
jeemiee	ஜேமி	ஜீமி
jemie	ஜேமி	ஜெமி
jemiie	ஜேமி	ஜெமி
zami	ஜேமி	ஜாமி
zamie	ஜேமி	ஜாமி
zamii	ஜேமி	ஜாமி
zamy	ஜேமி	ஜாமி
zemie	ஜேமி	ஜெமி
jioti	ஜோதி	ஜியோட்டி
jooti	ஜோதி	ஜோட்டி
jothi	ஜோதி	ஜோதி
jyooti	ஜோதி	ஜோய்டி
jyoti	ஜோதி	ஜியோட்டி
jyotii	ஜோதி	ஜியோட்டி
zyoti	ஜோதி	ஜியோட்டி
gnanashnaanam	ஞானஸ்நானம்	ஞாசன்னானம்
gnanasnaanam	ஞானஸ்நானம்	ஞாசன்னாமம்
gnanasnanam	ஞானஸ்நானம்	ஞாசன்னாம்
taakshi	டாக்ஸி	தாக்சி
taxi	டாக்ஸி	தாதி
daan	டான்	டான்
dain	டான்	டென்
dan	டான்	டான்
dann	டான்	டன்
dayn	டான்	டென்
den	டான்	டென்
don	டான்	டன்
donn	டான்	டன்
taan	டான்	டான்
design	டிசைன்	டெசிங்
disain	டிசைன்	டிசன்
dear	டியர்	டேர்
der	டியர்	டெர்
diyar	டியர்	டியர்
diram	டிராம்	டிராம்
tiraam	டிராம்	திராம்
tirom	டிராம்	டிரோம்
traam	டிராம்	திராம்
tram	டிராம்	திராம்
trama	டிராம்	திராமா
tirailar	டிரெய்லர்	திரைலர்
trailer	டிரெய்லர்	டிரைலர்
daepiyan	டெபியன்	டேபியன்
deban	டெபியன்	டேபன்
debann	டெபியன்	டபபன்
debeean	டெபியன்	டேபன்
debeen	டெபியன்	டேபன்
debian	டெபியன்	டெபியன்
debiann	டெபியன்	டபபின்
debiian	டெபியன்	டெபியன்
debiyan	டெபியன்	டெபியன்
delivery	டெலிவரி	டெலிவர்
telivari	டெலிவரி	தெலிவரி
devil	டெவில்	டெவில்
daeni	டேனி	டென்
danni	டேனி	டன்னி
danny	டேனி	டன்னி
dany	டேனி	டானி
deeni	டேனி	டீனி
dison	டைசன்	டிசன்
tisan	டைசன்	டிசன்
tison	டைசன்	டிசன்
tyson	டைசன்	டிசன்
daiveng	டைவிங்	டெவங்
daivengg	டைவிங்	டெய்வங்
daiving	டைவிங்	டெவின்
daiwengg	டைவிங்	டெய்வங்
daiwing	டைவிங்	டெவிங்
devengg	டைவிங்	டெவங்க்
deving	டைவிங்	டெவிங்
diving	டைவிங்	டிவிங்
divingg	டைவிங்	டிவிங்
diwing	டைவிங்	டிவிங்
diwingg	டைவிங்	டிவிங்
druuman	ட்ரூமன்	டிராமன்
trooman	ட்ரூமன்	திராமன்
trueman	ட்ரூமன்	திருமன்
truman	ட்ரூமன்	திருமன்
trumann	ட்ரூமன்	திருமனன்
truueman	ட்ரூமன்	திராமன்
truuman	ட்ரூமன்	திராமன்
truumann	ட்ரூமன்	திராமன்
driver	ட்ரைவர்	டிரிவர்
tarran	த	தரர்ன்
teran	த	டேரன்
terran	த	டெர்ரன்
thagadugal	தகடுகள்	தகடுகள்
thagadukal	தகடுகள்	தகடுகள்
thakadukal	தகடுகள்	தகடுகள்
thakatukal	தகடுகள்	தகட்குகள
thanggi	தங்கி	தங்கி
thangi	தங்கி	தங்கி
thangki	தங்கி	தங்கி
thanki	தங்கி	தங்கி
thanginar	தங்கினர்	தங்கினர்
thangkinar	தங்கினர்	தங்கினர்
thankinar	தங்கினர்	தங்கினர்
thanginaar	தங்கினார்	தங்கினார்
thangkinaar	தங்கினார்	தங்கினார்
thankinaar	தங்கினார்	தங்கினார்
thangirukka	தங்கியிருக்க	தங்கிருக்க
thangiyirukka	தங்கியிருக்க	தங்கியிருக்க
thangkiirukka	தங்கியிருக்க	தங்கிருக்க
thangkiyirrukka	தங்கியிருக்க	தங்கியிருக்க
thankiyirkka	தங்கியிருக்க	தங்கியிற்க்க
thangiirukkum	தங்கியிருக்கும்	தங்கிருக்கும்
thangiyirukkum	தங்கியிருக்கும்	தங்கியிருக்கும்
thankiyirukkum	தங்கியிருக்கும்	தங்கியிருக்கும்
thangiulla	தங்கியுள்ள	தங்கியுள்ள
thangiyulla	தங்கியுள்ள	தங்கியுள்ள
thankiyulla	தங்கியுள்ள	தங்கியுள்ள
dasaapdhangalaaga	தசாப்தங்களாக	தசாப்தங்களாக
dasaapthangalaaga	தசாப்தங்களாக	தசாப்தங்களாக
dasapthanggalaahga	தசாப்தங்களாக	தசப்தங்களாக
thasaapthangalaaga	தசாப்தங்களாக	தசாப்தங்களாக
dasaapdhangalil	தசாப்தங்களில்	தசாப்தங்களில்
dasaapthangalil	தசாப்தங்களில்	தசாப்தங்களில்
dasapthanggalil	தசாப்தங்களில்	தசப்தங்களில்
thasaapdhangalil	தசாப்தங்களில்	தசாப்தங்களில்
dasapthanggalukku	தசாப்தங்களுக்கு	தசப்தங்களுக்கு
thasaapdhangalukku	தசாப்தங்களுக்கு	தசாப்தங்களுக்கு
thasaapthankkalukku	தசாப்தங்களுக்கு	தசாப்தங்களுக்கு
thadangalai	தடங்களை	தடங்களை
thadanggalai	தடங்களை	தடங்களை
thadangkalai	தடங்களை	தடங்களை
thadangal	தடங்கள்	தடங்கள்
thadanggal	தடங்கள்	தடங்கள்
thadangkal	தடங்கள்	தடங்கள்
thaduththadhu	தடுத்தது	தடுத்தது
thaduththathu	தடுத்தது	தடுத்தது
thaduththanar	தடுத்தனர்	தடுத்தனர்
thaduththal	தடுத்தல்	தடுத்தல்
thadaigalaiyum	தடைகளையும்	தடைகளையும்
thadaikalaiyum	தடைகளையும்	தடைகளையும்
thadaikkalaiyum	தடைகளையும்	தடைக்களையும்
thadaykalayyum	தடைகளையும்	தடைகளையும்
thadaigal	தடைகள்	தடைகள்
thadaikal	தடைகள்	தடைகள்
thadaikkal	தடைகள்	தடைக்கள்
thadaygal	தடைகள்	தடைகள்
thadaykal	தடைகள்	தடைகள்
thadaich	தடைச்	தடைச்
thadaippattu	தடைப்பட்டு	தடைப்பட்டு
thadaiyatrtra	தடையற்ற	தடையற்ற
thadaiyattra	தடையற்ற	தடையற்ற
thadaiyaaga	தடையாக	தடையாக
thadaiyaaka	தடையாக	தடையாக
thadaiyaanadhu	தடையானது	தடையானது
thadaiyaanathu	தடையானது	தடையானது
thadaiyin	தடையின்	தடையின்
thadaiyaiyum	தடையையும்	தடையையும்
dhandanaigalaiyum	தண்டனைகளையும்	தண்டனைகளையும்
thandanaigalaium	தண்டனைகளையும்	தண்டனைகளையும்
thandanaigalaiyum	தண்டனைகளையும்	தண்டனைகளையும்
thandanaikalaiyum	தண்டனைகளையும்	தண்டனைகளையும்
thandanaik	தண்டனைக்	தண்டனைக்
dhandanaikku	தண்டனைக்கு	தண்டனைக்கு
thandanaikku	தண்டனைக்கு	தண்டனைக்கு
dhandanaich	தண்டனைச்	தண்டனைச்
thandanaich	தண்டனைச்	தண்டனைச்
dhandanaiyaaga	தண்டனையாக	தண்டனையாக
thandanaiyaaga	தண்டனையாக	தண்டனையாக
thandanaiyaaka	தண்டனையாக	தண்டனையாக
dhandanaiyum	தண்டனையும்	தண்டனையும்
thandanaiyum	தண்டனையும்	தண்டனையும்
dhandanaiyai	தண்டனையை	தண்டனையை
thandanaiyai	தண்டனையை	தண்டனையை
dhandi	தண்டி	தாண்டி
thandi	தண்டி	தாண்டி
thandil	தண்டில்	தாண்டில்
thandhiramaaga	தந்திரமாக	தந்திரமாக
thanthiramaaga	தந்திரமாக	தந்திரமாக
thanthiramaaka	தந்திரமாக	தந்திரமாக
thandhiram	தந்திரம்	தந்திரம்
thanthiram	தந்திரம்	தந்திரம்
thanakkulla	தனக்குள்ள	தனக்குள்ள
thanakkae	தனக்கே	தனக்கே
thankkae	தனக்கே	தங்கே
thanithanip	தனித்தனிப்	தனிதனிப்
thaniththani	தனித்தனிப்	தனித்தனி
thaniththanip	தனித்தனிப்	தனித்தனிப்
thanithaniye	தனித்தனியே	தனிதனியே
thaniththaniyae	தனித்தனியே	தனித்தனியே
thaniththaniye	தனித்தனியே	தனித்தனியே
thanithanmai	தனித்தன்மை	தனிதன்மை
thaniththanmai	தனித்தன்மை	தனித்தன்மை
thanithanmaiyai	தனித்தன்மையை	தனித்மண்யை
thaniththanmaiyai	தனித்தன்மையை	தனித்தன்மையை
thanima	தனிம	தனிமா
thanimangal	தனிமங்கள்	தனிமங்கள்
thanimankal	தனிமங்கள்	தனிமங்கள்
thanimam	தனிமம்	தனிமம்
thanatchi	தன்னாட்சி	தனட்சி
thannaatchi	தன்னாட்சி	தன்னாட்சி
thanmaana	தன்மான	தன்மான
tamilaga	தமிழக	தமிழாக
thamilaga	தமிழக	தமிழகா
thamilaka	தமிழக	தமிழகாக
thamizhaka	தமிழக	தமிழகக
tamilagach	தமிழகச்	தமிழகசச்
thamizhakach	தமிழகச்	தமிழக்சச்
tamilagath	தமிழகத்	தமிழகத்
thamizhakath	தமிழகத்	தமிழக்கத்
tamilagaththin	தமிழகத்தின்	தமிழகத்தின்
thamizhakaththin	தமிழகத்தின்	தமிழக்கத்தின்
tamilagaththirku	தமிழகத்திற்கு	தமிழகத்திற்கு
thamizhakaththirkku	தமிழகத்திற்கு	தமிழக்கத்திற்க
thamizhakaththirku	தமிழகத்திற்கு	தமிழக்கத்திற்க
tamilagaththil	தமிழகத்தில்	தமிழகத்தில்
tamilagatthil	தமிழகத்தில்	தமிழகத்தில்
tamilakatthil	தமிழகத்தில்	தமிழக்கத்தில்
tamizhagatthil	தமிழகத்தில்	தமிழகத்தில்
tamizhakatthil	தமிழகத்தில்	தமிழக்கத்தில்
thamilagatthil	தமிழகத்தில்	தமிழகத்தில்
thamilakatthil	தமிழகத்தில்	தமிழக்கத்தில்
thamizhagatthil	தமிழகத்தில்	தமிழகத்தில்
thamizhakaththil	தமிழகத்தில்	தமிழக்கத்தில்
thamizhakatthil	தமிழகத்தில்	தமிழக்கத்தில்
tamilagaththudan	தமிழகத்துடன்	தமிழகத்துடன்
tamilagatthudan	தமிழகத்துடன்	தமிழகத்துடன்
tamilakatthudan	தமிழகத்துடன்	தமிழக்கத்துடன
tamizhagatthudan	தமிழகத்துடன்	தமிழகத்துடன்
tamizhakatthudan	தமிழகத்துடன்	தமிழக்கத்துடன
thamilagatthudan	தமிழகத்துடன்	தமிழகத்துடன்
thamilakatthudan	தமிழகத்துடன்	தமிழக்கத்துடன
thamizhagatthudan	தமிழகத்துடன்	தமிழகத்துடன்
thamizhakaththudan	தமிழகத்துடன்	தமிழக்கத்துடன
thamizhakaththutan	தமிழகத்துடன்	தமிழக்கத்துடன
thamizhakatthudan	தமிழகத்துடன்	தமிழக்கத்துடன
tamilarinargal	தமிழறிஞர்கள்	தமிழரினர்கள்
tamilaringargal	தமிழறிஞர்கள்	தமிழரிங்கர்கள
thamizharingargal	தமிழறிஞர்கள்	தமிழரிங்கர்கள
thamizharingyargal	தமிழறிஞர்கள்	தமிழரிங்கர்கள
thamizharingyarkal	தமிழறிஞர்கள்	தமிழரிங்கர்கள
tamilai	தமிழை	தமிழை
tamizhai	தமிழை	தமிழை
thamilai	தமிழை	தமிழை
thamizhai	தமிழை	தமிழை
tamilaip	தமிழைப்	தமிழைப்
tamizhaip	தமிழைப்	தமிழைப்
thamilaip	தமிழைப்	தமிழைப்
thamizhaip	தமிழைப்	தமிழைப்
tamilnadu	தமிழ்நாடு	தமிழ்நாடு
tamilnatu	தமிழ்நாடு	தமிழ்நாடு
thamilnaatu	தமிழ்நாடு	தமிழ்நாடு
thamilnatu	தமிழ்நாடு	தமிழ்நாடு
thamizhnaadu	தமிழ்நாடு	தமிழ்நாடு
tamilnadum	தமிழ்நாடும்	தமிழ்நாடும்
thamilnaadum	தமிழ்நாடும்	தமிழ்நாடும்
thamilnadum	தமிழ்நாடும்	தமிழ்நாடும்
thamizhnaadum	தமிழ்நாடும்	தமிழ்நாடும்
thambadhigalin	தம்பதிகளின்	தம்பதிகளின்
thambathigalin	தம்பதிகளின்	தம்பத்திகளின்
thambathikalin	தம்பதிகளின்	தம்பத்திகளின்
thampathikalin	தம்பதிகளின்	தம்பத்திகளின்
thambadhiyinarin	தம்பதியினரின்	தம்பதியினரின்
thambathiyinarin	தம்பதியினரின்	தம்பத்தியினரின்
thambadhiyin	தம்பதியின்	தம்பதியின்
thambathiyin	தம்பதியின்	தம்பத்தியின்
tayaaraana	தயாரான	தயாரான
thayaaraana	தயாரான	தயாரான
thayarana	தயாரான	தயாரண
thayaarippaana	தயாரிப்பான	தயாரிப்பான
thayaarippaalarum	தயாரிப்பாளரும்	தயாரிப்பாளரும்
thayaarippaazharum	தயாரிப்பாளரும்	தயாரிப்பாழரும்
dhayaazh	தயாள்	தயாஜ்
thayaal	தயாள்	தயால்
thayal	தயாள்	தயயல்
mudiyumaa	தர	முட்டியா
mutiyuma	தர	முட்டியா
tarathai	தரத்தை	தரத்தை
tharathai	தரத்தை	தரத்தை
tharaththai	தரத்தை	தரத்தை
tharatthai	தரத்தை	தரத்தை
taratthaiyum	தரத்தையும்	தரத்தையும்
tharathaiyum	தரத்தையும்	தரதையும்
tharaththaiyum	தரத்தையும்	தரத்தையும்
tharatthaiyum	தரத்தையும்	தரத்தையும்
tarappil	தரப்பில்	தரப்பில்
tharapil	தரப்பில்	தரப்பில்
tharappil	தரப்பில்	தரப்பில்
tharavarisai	தரவரிசை	தரவரிசை
tharavalladhu	தரவல்லது	தரவள்ளது
tharavallathu	தரவல்லது	தரவள்ளது
tharavugalaich	தரவுகளைச்	தரவுகளைச்
tharavukalaich	தரவுகளைச்	தரவுகளைச்
tharavugalaip	தரவுகளைப்	தரவுகளைப்
tarunatthil	தருணத்தில்	தருநத்தில்
tharunathil	தருணத்தில்	தருநதில்
tharunaththil	தருணத்தில்	தருநத்தில்
tharunatthil	தருணத்தில்	தருநத்தில்
dharun	தருண்	தருன்
tarun	தருண்	தருன்
tharun	தருண்	தருன்
dharumi	தருமி	தருமி
tharumi	தருமி	தருமி
tharum	தரும்	தரும்
dharmapuriyil	தர்மபுரியில்	தர்மபுரியில்
thalaimaiyaetru	தலைமையேற்று	தலைமையேற்று
thalaimaiyetru	தலைமையேற்று	தலைமையேற்று
thalaimaiyettru	தலைமையேற்று	தலைமையெற்று
talaivanin	தலைவனின்	தலைவனின்
thalaivanin	தலைவனின்	தலைவனின்
talaivaraavaar	தலைவராவார்	தலைவராவார்
thalaivaraavaar	தலைவராவார்	தலைவராவார்
thalaivaravaar	தலைவராவார்	தலைவரவார்
talaivarukku	தலைவருக்கு	தலைவருக்கு
thalaivarukku	தலைவருக்கு	தலைவருக்கு
thalaivali	தலைவலி	தலைவளி
thalaththirku	தளத்திற்கு	தலத்திற்கு
thalatthirku	தளத்திற்கு	தலத்திற்கு
thalaththilirunthu	தளத்திலிருந்து	தலத்திலிருந்து
thalatthilirunthu	தளத்திலிருந்து	தலத்திலிருந்து
thalaththilum	தளத்திலும்	தலத்திலும்
thalatthilum	தளத்திலும்	தலத்திலும்
thalap	தளப்	தலப்
thalamaana	தளமான	தலமான
thalavaadangalai	தளவாடங்களை	தலவாடங்களை
thalavaadangalay	தளவாடங்களை	தலவாடங்களை
thalavaadangkalai	தளவாடங்களை	தலவாடங்களை
thalavaadankalai	தளவாடங்களை	தலவாடங்களை
thalavaatankalay	தளவாடங்களை	தலவாடங்களை
thaviththa	தவித்த	தவித்த
thavittha	தவித்த	தவித்த
thaakku	தாக்கு	தாக்கு
thaadhukkal	தாதுக்கள்	தாதுக்கள்
thaathukkal	தாதுக்கள்	தாதுக்கள்
thaadhuvai	தாதுவை	தாதுவை
thaathuvai	தாதுவை	தாதுவை
thaano	தானோ	தானோ
thaamira	தாமிர	தாமிர
thamira	தாமிர	தமிரா
thaamae	தாமே	தாமே
thaame	தாமே	தாமே
thaamey	தாமே	தாமே
dam	தாம்	டாம்
dhaam	தாம்	தாம்
thaam	தாம்	தாம்
tambaram	தாம்பரம்	தம்பரம்
thaambaram	தாம்பரம்	தாம்பரம்
thaayaga	தாயக	தாயக
thayaga	தாயக	தயாக
thaayagathil	தாயகத்தில்	தாயகத்தில்
thaayagaththil	தாயகத்தில்	தாயகத்தில்
thaayagap	தாயகப்	தாயககப்
thaayagam	தாயகம்	தாயகம்
thaayumaanavar	தாயுமானவர்	தாயுமானவர்
thayumanavar	தாயுமானவர்	தயுமானவர்
taali	தாலி	தாலி
taalii	தாலி	தாலி
tali	தாலி	தலி
talii	தாலி	தலி
thaali	தாலி	தாலி
thaaliyai	தாலியை	தாளியை
thaal	தாழ்	தால்
thaazh	தாழ்	தாள்
thikaar	திகார்	திகார்
tihar	திகார்	திகர்
thittamidaludan	திட்டமிடலுடன்	திட்டமிடலுடன்
thittamiduthal	திட்டமிடுதல்	திட்டமிடுத்தல்
thinnanaar	திண்ணனார்	தின்னான்
deen	தின்	டீன்
dhin	தின்	தின்
diin	தின்	டின்
din	தின்	டின்
dyn	தின்	டின்
thin	தின்	தின்
tin	தின்	டின்
thinnum	தின்னும்	தின்னும்
dmkvil	திமுகவில்	திக்கில்
thimukavil	திமுகவில்	திமுகவில்
temoorr	திமோர்	டெமூர்
temor	திமோர்	டிமோர்
temorr	திமோர்	டிமர்்
timoor	திமோர்	டிமூர்
timoorr	திமோர்	டிமூர்
timor	திமோர்	டிமோர்
timorr	திமோர்	டிமர்
tymoor	திமோர்	டிமூர்
tymor	திமோர்	டிமர்
thiyaagaraajarin	தியாகராஜரின்	தியாகராஜரின்
thiyaakaraajarin	தியாகராஜரின்	தியாகராஜரின்
thiyagarajarin	தியாகராஜரின்	தியகரராஜின்
thyaagarajarin	தியாகராஜரின்	தியாகராஜரின்
thiyaagaraajaa	தியாகராஜா	தியாகராஜா
thiyaakaraaja	தியாகராஜா	தியாகராஜா
thiyaakaraajaa	தியாகராஜா	தியாகராஜா
thiyakaraja	தியாகராஜா	தியகராஜா
tiyaakaraaja	தியாகராஜா	தியாகராஜா
thirumulukkup	திருமுழுக்குப்	திருமுழுக்குப்
thirumulukup	திருமுழுக்குப்	திருமுழுக்குப்
tirumulukkup	திருமுழுக்குப்	திருமுழுக்குப்
thirumoorthi	திருமூர்த்தி	திருமூர்தி
thirumoorththi	திருமூர்த்தி	திருமூர்த்தி
thirumuurtthi	திருமூர்த்தி	திருமுர்த்தி
tiruumrthi	திருமூர்த்தி	திரும்தி
thiruvadi	திருவடி	திருவாடி
thiruvati	திருவடி	திருவாடி
thiruvadikalai	திருவடிகளை	திருவடிகளை
thiruvatikalai	திருவடிகளை	திருவடிகளை
tiruvatikalai	திருவடிகளை	திருவதிகளை
thiruvarangkaththil	திருவரங்கத்தில்	திருவரங்கத்தில்
thiruvarankkaththil	திருவரங்கத்தில்	திருவரங்கத்தில்
thiruvarangan	திருவரங்கன்	திருவரங்கன்
thiruvarangkan	திருவரங்கன்	திருவரங்கன்
thiruvarankan	திருவரங்கன்	திருவரங்கன்
tiruvarankan	திருவரங்கன்	திருவரங்கன்
maraivil	திரை	மரைவில்
thiraikalil	திரைகளில்	திரைகளில்
tiraikalil	திரைகளில்	திரைகளில்
thiraikal	திரைகள்	திரைகள்
tiraikal	திரைகள்	திரைகள்
thiraiyil	திரையில்	திரையில்
tiraiyil	திரையில்	திரையில்
thiraiyum	திரையும்	திரையும்
tiraiyum	திரையும்	திரையும்
thiraiyai	திரையை	திரையை
tiraiyai	திரையை	திரையை
thiranaal	திறனால்	திரணால்
thiranukku	திறனுக்கு	திரணுக்கு
thiranudan	திறனுடன்	திரணுடன்
thirangalai	திறன்களை	திரங்களை
thirankalai	திறன்களை	திரங்களை
divakar	திவாகர்	திவாகர்
diwakar	திவாகர்	டிவாகர்
thivaakar	திவாகர்	திவாகர்
deevan	திவான்	தேவன்
deewan	திவான்	டீவன்
diiwan	திவான்	டீவன்
divaan	திவான்	டிவான்
divan	திவான்	டிவன்
divann	திவான்	டிவன்
diwaan	திவான்	டிவான்
diwan	திவான்	டிவான்
diwann	திவான்	டிவன்
thivaan	திவான்	திவான்
tivan	திவான்	திவான்
theetchithar	தீட்சிதர்	தீட்சிதர்
thidshithar	தீட்சிதர்	திதிச்தர்
theendaamaikku	தீண்டாமைக்கு	தீண்டாமைக்கு
theeba	தீப	தீபா
theepa	தீப	தீபா
deepath	தீபத்	டீபாத்
dheepath	தீபத்	தீபத்
theepath	தீபத்	தீபத்
deepa	தீபா	தீபா
deepaa	தீபா	தீபா
dheepa	தீபா	தீபா
dheepaa	தீபா	தீபா
diipa	தீபா	திபா
diipaa	தீபா	திபா
dipa	தீபா	திபா
dipaa	தீபா	திபா
theepaa	தீபா	தீபா
tiipa	தீபா	திபா
theepparri	தீப்பற்றி	தீப்பர்ரி
theeppatri	தீப்பற்றி	தீப்பற்றி
theeppattri	தீப்பற்றி	தீப்பற்றி
theeparrik	தீப்பற்றிக்	தீபர்ரிக்
theepattrik	தீப்பற்றிக்	தீபாற்றிக்
theeppatrik	தீப்பற்றிக்	தீப்பற்றிக்
dheergadarisigal	தீர்க்கதரிசிகள்	தீர்கடடரிசிகள்
theerkkatharisikal	தீர்க்கதரிசிகள்	தீர்க்கத்தரிசிகள
theerppadhil	தீர்ப்பதில்	தீர்ப்பதில்
theerppathil	தீர்ப்பதில்	தீர்ப்பதில்
theerppadhu	தீர்ப்பது	தீர்ப்பது
theerppathu	தீர்ப்பது	தீர்ப்பது
theerppil	தீர்ப்பில்	தீர்ப்பில்
theerppai	தீர்ப்பை	தீர்ப்பை
theermaaniththadhu	தீர்மானித்தது	தீர்மானித்தது
theermaaniththathu	தீர்மானித்தது	தீர்மானித்தது
theermaaniththaar	தீர்மானித்தார்	தீர்மானித்தார்
theermaaniththu	தீர்மானித்து	தீர்மானித்து
theervaaga	தீர்வாக	தீர்வாக
theervaaka	தீர்வாக	தீர்வாக
theevana	தீவன	தீவன
theevanaththil	தீவனத்தில்	தீவநாத்தில்
theevaththil	தீவனத்தில்	தீவத்தில்
theevanam	தீவனம்	தீவனாம்
theeviravaadhi	தீவிரவாதி	தீவிரவாதி
theeviravaathi	தீவிரவாதி	தீவிரவாதி
theeviravaadhigalaal	தீவிரவாதிகளால்	தீவிரவாதிகளால்
theeviravaathigalaal	தீவிரவாதிகளால்	தீவிரவாதிகளால்
theeviravaathigazhaal	தீவிரவாதிகளால்	தீவிரவாதிகளால்
theeviravaathikalaal	தீவிரவாதிகளால்	தீவிரவாதிகளால்
theeviravaadhigalin	தீவிரவாதிகளின்	தீவிரவாதிகளின்
theeviravaathigalin	தீவிரவாதிகளின்	தீவிரவாதிகளின்
theeviravaathigazhin	தீவிரவாதிகளின்	தீவிரவாதிகளின்
theeviravaathikalin	தீவிரவாதிகளின்	தீவிரவாதிகளின்
theeviravaathigalay	தீவிரவாதிகளை	தீவிரவாதிகளை
theeviravaathigazhai	தீவிரவாதிகளை	தீவிரவாதிகளை
theeviravaathikalai	தீவிரவாதிகளை	தீவிரவாதிகளை
theeviravaathikalay	தீவிரவாதிகளை	தீவிரவாதிகளை
theeviravaathigal	தீவிரவாதிகள்	தீவிரவாதிகள்
theeviravaathikal	தீவிரவாதிகள்	தீவிரவாதிகள்
theeviravaadhiyaaga	தீவிரவாதியாக	தீவிரவாதியாக
theeviravaathiyaaga	தீவிரவாதியாக	தீவிரவாதியாக
theeviravaathiyaaka	தீவிரவாதியாக	தீவிரவாதியாக
thundaaga	துண்டாக	துண்டாக
thundaaka	துண்டாக	துண்டாக
thundai	துண்டை	துண்டை
thunburuthalil	துன்புறுத்தலில்	துன்புருத்தலில்
thunburuththalil	துன்புறுத்தலில்	துன்புருத்தலில்
thunpuruththalil	துன்புறுத்தலில்	துன்புருத்தலில்
thunburuththum	துன்புறுத்தும்	துன்புருத்தும்
thunburuthum	துன்புறுத்தும்	துன்புருத்தும்
thunpuruththum	துன்புறுத்தும்	துன்புருத்தும்
tumi	துமி	டுமி
tumii	துமி	டுமி
tuumi	துமி	டுமி
thuruva	துருவ	துருவா
thuruvangalil	துருவங்களில்	துருவங்களில்
thuruvangal	துருவங்கள்	துருவங்கள்
thuruvaththil	துருவத்தில்	துருவத்தில்
thuruvap	துருவப்	துருவப்
dhroanarin	துரோணரின்	திரானரின்
dronarin	துரோணரின்	டிரானின்
thuronarin	துரோணரின்	துரானரின்
thuravigalum	துறவிகளும்	துறவிகளும்
thuravikalum	துறவிகளும்	துறவிகளும்
thuravikku	துறவிக்கு	துறவிக்கு
thuraviyaaga	துறவியாக	துறவியாக
thuraviyaaka	துறவியாக	துறவியாக
thuraviyaana	துறவியான	துறவியான
thuraikku	துறைக்கு	துறைக்கு
thulaigalil	துளைகளில்	துலைகளில்
thulaikalil	துளைகளில்	துலைகளில்
thuvakka	துவக்க	துவக்க
thuvakkap	துவக்கப்	துவக்கப்
thuvakkappatta	துவக்கப்பட்ட	துவக்கப்பட்ட
thuvakkiya	துவக்கிய	துவக்கிய
thuvanga	துவங்க	துவங்க
thuvangga	துவங்க	துவங்க
thuvangka	துவங்க	துவங்க
thuvangapatu	துவங்கப்பட்டு	துவங்கப்பட்டு
thuvangappattu	துவங்கப்பட்டு	துவங்கப்பட்டு
thuvanggappattu	துவங்கப்பட்டு	துவங்கப்பட்டு
thuvangkappattu	துவங்கப்பட்டு	துவங்கப்பட்டு
thuvanggum	துவங்கும்	துவங்கும்
thuvangkum	துவங்கும்	துவங்கும்
thuvangum	துவங்கும்	துவங்கும்
thuvangguvatharku	துவங்குவதற்கு	துவங்குவதற்கு
thuvangkuvatharku	துவங்குவதற்கு	துவங்குவதற்கு
thuvanguvatharku	துவங்குவதற்கு	துவங்குவதற்கு
dvaitham	துவைதம்	தவவத்தம்
thuvaitham	துவைதம்	துவைதம்
thwaytham	துவைதம்	துவாத்தம்
thoodhuvar	தூதுவர்	தூதுவர்
thoothuvar	தூதுவர்	தூத்வுவர்
thoothuvargal	தூதுவர்கள்	தூத்வுவர்கள்
thoothuvarkal	தூதுவர்கள்	தூத்துவர்கள்
thoorvaari	தூர்வாரி	தூர்வாரி
thenasia	தென்னாசிய	தெனசியா
thennaasiya	தென்னாசிய	தென்னாசியா
therkil	தெற்கில்	தெர்கில்
therkkil	தெற்கில்	தெர்க்கில்
therkae	தெற்கே	தெர்கே
therke	தெற்கே	தெர்க்கே
therkke	தெற்கே	தெர்க்கே
thelivatra	தெளிவற்ற	தெளிவற்ற
dhegathil	தேகத்தில்	தேகத்தில்
thaegaththil	தேகத்தில்	தேகத்தில்
thaekaththil	தேகத்தில்	தேகத்தில்
thaekkam	தேக்கம்	தேக்கம்
thekkam	தேக்கம்	தேக்கம்
thaekku	தேக்கு	தேக்கு
thekku	தேக்கு	தெக்கு
thaekkum	தேக்கும்	தேக்கும்
thekkum	தேக்கும்	தேக்கும்
thaengaai	தேங்காய்	தேங்காய்
thaenkaai	தேங்காய்	தேங்காய்
thaenum	தேனும்	தேனும்
thenum	தேனும்	தெனும்
thaergal	தேர்கள்	தேர்கள்
thaerkal	தேர்கள்	தேர்கள்
therkal	தேர்கள்	தெர்கள்
teerth	தேர்த்	டீர்த்
thaerth	தேர்த்	தேர்த்
theerth	தேர்த்	தீர்த்
therth	தேர்த்	தெர்த்
thaernthaedukka	தேர்ந்தெடுக்க	தேர்ந்தேடுக்க
thaernthedukka	தேர்ந்தெடுக்க	தேர்ந்தெடுக்க
thernthedukka	தேர்ந்தெடுக்க	தெர்ந்தெடுக்க
thaernthedukkappada	தேர்ந்தெடுக்கப்பட	தேர்ந்தெடுக்கப்பட
thernthedukkappada	தேர்ந்தெடுக்கப்பட	தெர்ந்தெடுக்கப்பட
thaernthaedukkappadum	தேர்ந்தெடுக்கப்படும்	தேர்ந்தேடுக்கப்படும்
thaernthedukkappadum	தேர்ந்தெடுக்கப்படும்	தேர்ந்தெடுக்கப்படும்
thernthedukkappadum	தேர்ந்தெடுக்கப்படும்	தெர்ந்தெடுக்கப்படும்
devaalayanggalil	தேவாலயங்களில்	தேவாலயங்களில்
devalayangalil	தேவாலயங்களில்	தெவலாயங்களில்
thevaalayangalil	தேவாலயங்களில்	தேவாலயங்களில்
thevaalayangkalil	தேவாலயங்களில்	தேவாலயங்களில்
devaalayangal	தேவாலயங்கள்	தேவாலயங்கள்
devalayangal	தேவாலயங்கள்	தேவலயங்கள்
thevaalayangal	தேவாலயங்கள்	தேவாலயங்கள்
thevaalayangkal	தேவாலயங்கள்	தேவாலயங்கள்
devaalayaththin	தேவாலயத்தின்	தேவாலயத்தின்
devalayaththin	தேவாலயத்தின்	தேவலயத்தின்
thevaalayaththin	தேவாலயத்தின்	தேவாளயத்தின்
devaalayaththil	தேவாலயத்தில்	தேவாலயத்தில்
devalayaththil	தேவாலயத்தில்	தேவலயயத்தில்
thevaalayaththil	தேவாலயத்தில்	தேவாளயயத்தில்
devaalayaththai	தேவாலயத்தை	தேவாலயத்தை
devalayaththai	தேவாலயத்தை	தேவலயயத்தை
thevaalayaththai	தேவாலயத்தை	தேவாளயயத்தை
thoguththal	தொகுத்தல்	தொகுத்தல்
thoguththavar	தொகுத்தவர்	தொகுத்தவர்
thoguththullaar	தொகுத்துள்ளார்	தொகுத்துள்ளார்
thoguppinai	தொகுப்பினை	தொகுப்பினை
thokupinai	தொகுப்பினை	தொகுப்பினை
thokuppinai	தொகுப்பினை	தொகுப்பினை
thoguppai	தொகுப்பை	தொகுப்பை
thokupaip	தொகுப்பை	தொகுப்பைப்
thokuppai	தொகுப்பை	தொகுப்பை
thoguppaip	தொகுப்பைப்	தொகுப்பைப்
thokupaip	தொகுப்பைப்	தொகுப்பைப்
thokuppaip	தொகுப்பைப்	தொகுப்பைப்
thogai	தொகை	தொகை
thokai	தொகை	தொகை
tokai	தொகை	டொக்கை
thogaik	தொகைக்	தொகைக்
thokaik	தொகைக்	தொகைக்
tokaik	தொகைக்	டொக்க்
thogaip	தொகைப்	தொகைப்
thokaip	தொகைப்	தொகைப்
tokaip	தொகைப்	டொக்கைப்
thogaiyaaga	தொகையாக	தொகையாக
thokaiyaaka	தொகையாக	தொகையாக
thokaiyaka	தொகையாக	தொகையாக
thogaiyana	தொகையான	தொகையன
thokaiyaana	தொகையான	தொகையான
thokaiyana	தொகையான	தொகையன
thogaiyil	தொகையில்	தொகையில்
thokaiyil	தொகையில்	தொகையில்
tokaiyil	தொகையில்	தொகையில்
thogaiyudan	தொகையுடன்	தோகையுடன்
thokaiyudan	தொகையுடன்	தொகையுடன்
thokaiyutan	தொகையுடன்	தொகையுடன்
tokaiyutan	தொகையுடன்	தோகையுடன்
thogaiyum	தொகையும்	தொகையும்
thokaiyum	தொகையும்	தொகையும்
tokaiyum	தொகையும்	தொகையும்
thokaiyaich	தொகையைச்	தொகையைச்
tokaiyaich	தொகையைச்	டொகையைச்
thokaiyaiyum	தொகையையும்	தொகையையும்
tokaiyaiyum	தொகையையும்	தொகையையும்
thodandhu	தொடந்து	தொடந்து
thodanththu	தொடந்து	தொடந்து
thotanthu	தொடந்து	தொடந்து
totanthu	தொடந்து	தொடந்து
thodarbaana	தொடர்பான	தொடர்பான
thodarpaana	தொடர்பான	தொடர்பான
thotarpaana	தொடர்பான	தொடர்பான
thotarpana	தொடர்பான	தொடர்பன
thodarbaanathu	தொடர்பானது	தொடர்பானது
thodarpaanathu	தொடர்பானது	தொடர்பானது
thotarpaanathu	தொடர்பானது	தொடர்பானது
thotarpanathu	தொடர்பானது	தொடர்பனது
thodarbaanavai	தொடர்பானவை	தொடர்பானவை
thodarpaanavai	தொடர்பானவை	தொடர்பானவை
thotarpaanavai	தொடர்பானவை	தொடர்பானவை
thotarpanavai	தொடர்பானவை	தொடர்பனவை
thodarbu	தொடர்பு	தொடர்பு
thodarpu	தொடர்பு	தொடர்பு
thotarpu	தொடர்பு	தொடர்பு
totarpu	தொடர்பு	தொடர்பு
thodarbukalai	தொடர்புகளை	தொடர்புகளை
thodarpukalai	தொடர்புகளை	தொடர்புகளை
thotarpukalai	தொடர்புகளை	தொடர்புகளை
totarpukalai	தொடர்புகளை	தொடர்புகளை
thodarbukalaip	தொடர்புகளைப்	தொடர்புகளைப்
thodarpukalaip	தொடர்புகளைப்	தொடர்புகளைப்
thotarpukalaip	தொடர்புகளைப்	தொடர்புகளைப்
totarpukalaip	தொடர்புகளைப்	தொடர்புகளைப்
thodarbup	தொடர்புப்	தொடர்புப்
thodarpup	தொடர்புப்	தொடர்புப்
thodarbum	தொடர்பும்	தொடர்பும்
thodarpum	தொடர்பும்	தொடர்பும்
thoduthal	தொடுதல்	தொடுத்தல்
totuthal	தொடுதல்	தொடுத்தல்
thottuk	தொட்டுக்	தொட்டுக்
thotuk	தொட்டுக்	தொடுக்
thottum	தொட்டும்	தொட்டும்
thotum	தொட்டும்	தொடும்
tholaipaesigal	தொலைபேசிகள்	தொலைபேசிகள்
tholaipesigal	தொலைபேசிகள்	தொலைபெசிகள்
tholaipaesikku	தொலைபேசிக்கு	தொலைபேசிக்கு
tholaipesikku	தொலைபேசிக்கு	தொலைபெசிக்கு
tholaipaesiyil	தொலைபேசியில்	தொலைபேசியில்
tholaipesiyil	தொலைபேசியில்	தொலைபெசியில்
tholiyal	தொல்லியல்	தொழியல்
tholliyal	தொல்லியல்	தொல்லியல்
tholilathibarai	தொழிலதிபரை	தொழிலத்திபரை
thozhilathibarai	தொழிலதிபரை	தொழிலத்திபரை
thozhilathiparai	தொழிலதிபரை	தொழிலத்திபரை
tholilum	தொழிலும்	தொழிலும்
thozhilum	தொழிலும்	தொழிலும்
tolilum	தொழிலும்	தொலிலும்
tholilae	தொழிலே	தொழிலே
tholile	தொழிலே	தொலில்
tholilee	தொழிலே	தொலிலி
thozhile	தொழிலே	தொழில்
thoandappatta	தோண்டப்பட்ட	தோண்டப்பட்ட
thondappatta	தோண்டப்பட்ட	தொண்டப்பட்ட
thontapata	தோண்டப்பட்ட	தொண்டபாட
thoontappatta	தோண்டப்பட்ட	தூண்டப்பட்ட
thoaththiram	தோத்திரம்	தோத்திரம்
thootthiram	தோத்திரம்	தூத்திரம்
thothiram	தோத்திரம்	தொதிரம்
thoththiram	தோத்திரம்	தொத்திரம்
thondriyadhaaga	தோன்றியதாக	தொன்றியதாக
thondriyadhaaka	தோன்றியதாக	தொன்றியதாக
thondriyathaaga	தோன்றியதாக	தொன்றியதாக
thondriyathaaka	தோன்றியதாக	தொன்றியதாக
thontriyathaka	தோன்றியதாக	தொன்றியதாக
thoontriyathaaka	தோன்றியதாக	தூன்றியதாக
thondriyadhu	தோன்றியது	தொன்றியது
thondriyathu	தோன்றியது	தொன்றியது
thontriyathu	தோன்றியது	தொன்றியது
thoontriyathu	தோன்றியது	தூன்றியது
thondriyadhai	தோன்றியதை	தொன்றியதை
thondriyathai	தோன்றியதை	தொன்றியதை
thontriyathai	தோன்றியதை	தொன்றியதை
thoontriyathai	தோன்றியதை	தூன்றியதை
thondriyavar	தோன்றியவர்	தொன்றியவர்
thontriyavar	தோன்றியவர்	தொன்றியவர்
thoontriyavar	தோன்றியவர்	தூன்றியவர்
thondriyavai	தோன்றியவை	தொன்றியவை
thontriyavai	தோன்றியவை	தொன்றியவை
thoontriyavai	தோன்றியவை	தூன்றியவை
thoarum	தோறும்	தோரும்
thaotrtru	தோற்று	தோற்று
thoarru	தோற்று	தோர்று
thoatrtru	தோற்று	தோற்று
thoatru	தோற்று	தோற்று
thoattru	தோற்று	தோற்று
thoarruvikkappadum	தோற்றுவிக்கப்படும்	தோர்வுவிக்கப்படும்
thoatruvikkappadum	தோற்றுவிக்கப்படும்	தோற்றுவிக்கப்படும்
thoattruvikkappadum	தோற்றுவிக்கப்படும்	தோற்றுவிக்கப்படும்
thoarruvikkappatta	தோற்றுவிக்கப்பட்ட	தோர்வுவிக்கப்பட்ட
thoatruvikkappatta	தோற்றுவிக்கப்பட்ட	தோற்றுவிக்கப்பட்ட
thoattruvikkappatta	தோற்றுவிக்கப்பட்ட	தோற்றுவிக்கப்பட்ட
thoarruvikkum	தோற்றுவிக்கும்	தோர்வுவிக்கும்
thoatruvikkum	தோற்றுவிக்கும்	தோற்றுவிக்கும்
thoattruvikkum	தோற்றுவிக்கும்	தோற்றுவிக்கும்
thoarruviththa	தோற்றுவித்த	தோற்றுவித்த
thoatruviththa	தோற்றுவித்த	தோற்றுவித்த
thoattruviththa	தோற்றுவித்த	தோற்றுவித்த
thoarruviththathu	தோற்றுவித்தது	தோற்றுவித்தது
thoatruviththathu	தோற்றுவித்தது	தோற்றுவித்தது
thoattruviththathu	தோற்றுவித்தது	தோற்றுவித்தது
thoalaal	தோலால்	தோலால்
thaan	தோல்வி	தான்
thoalvi	தோல்வி	தோல்வி
tholvi	தோல்வி	தொல்வி
thoolvi	தோல்வி	தூல்வி
thoalvigalai	தோல்விகளை	தோல்விகளை
thoalvigazhai	தோல்விகளை	தோல்விகளை
tholvigalai	தோல்விகளை	தொல்விகளை
tholvikalai	தோல்விகளை	தொல்விகளை
thoolvikalai	தோல்விகளை	தூழ்விகளை
thoalvigalaiyum	தோல்விகளையும்	தோல்விகளையும்
thoalvigazhaiyum	தோல்விகளையும்	தோல்விகளையும்
tholvigalayum	தோல்விகளையும்	தொல்விகளையும்
tholvikalaiyum	தோல்விகளையும்	தொல்விகளையும்
tholvikalayum	தோல்விகளையும்	தொல்விகளையும்
thoolvikalaiyum	தோல்விகளையும்	தூல்விகளையும்
thoalvigal	தோல்விகள்	தோல்விகள்
thoalvigazh	தோல்விகள்	தோல்விகள்
tholvigal	தோல்விகள்	தொல்விகள்
tholvikal	தோல்விகள்	தொல்விகள்
thoolvikal	தோல்விகள்	தூல்விகள்
thoalviyaal	தோல்வியால்	தோல்வியால்
thoalviyin	தோல்வியின்	தோல்வியின்
thoalviyai	தோல்வியை	தோல்வியை
thriller	த்ரில்லர்	திரில்லர்
nadunilaimai	நடுநிலைமை	நடுநிலைமை
nadunilamai	நடுநிலைமை	நடுநிலமை
nadaipera	நடைபெற	நடைபெற
nadaiperakkoodiya	நடைபெறக்கூடிய	நடைபெறக்கோடிய
nadaiperath	நடைபெறத்	நடைபெறத்
nadiperath	நடைபெறத்	நடிபெறத்
nadaiperavillai	நடைபெறவில்லை	நடைபெறவில்லை
nadaiperrum	நடைபெறும்	நடைபெற்றும்
nadaiperum	நடைபெறும்	நடைபெறும்
nadaiperumbodhu	நடைபெறும்போது	நடைபெறும்போது
nadaiperumpoadhu	நடைபெறும்போது	நடைபெறும்போது
nadaiperumpothu	நடைபெறும்போது	நடைபெறும்போது
nadaiperuvadharku	நடைபெறுவதற்கு	நடைபெறுவுதறது
nadaiperuvatharku	நடைபெறுவதற்கு	நடைபெறுவுவதற்க
nadaiperuvadhu	நடைபெறுவது	நடைபெறுவு
nadaiperuvathu	நடைபெறுவது	நடைபெறுவு
nadhigalin	நதிகளின்	நதிகளின்
nadhigazhin	நதிகளின்	நதிகளின்
nadhikalin	நதிகளின்	நதிகளின்
nathigalin	நதிகளின்	நதிகளின்
nadhigalil	நதிகளில்	நதிகளில்
nadhigazhil	நதிகளில்	நதிகளில்
nadhikalil	நதிகளில்	நதிகளில்
nathigalil	நதிகளில்	நதிகளில்
nathikalil	நதிகளில்	நதிகளில்
nadhigalukku	நதிகளுக்கு	நதிகளுக்கு
nadhigazhukku	நதிகளுக்கு	நதிகழுக்கு
nadhikalukku	நதிகளுக்கு	நதிகளுக்கு
nathigalukku	நதிகளுக்கு	நதிகளுக்கு
nadhigal	நதிகள்	நதிகள்
nadhikal	நதிகள்	நதிகள்
nathigal	நதிகள்	நதிகள்
nadhikku	நதிக்கு	நதிக்கு
nathikku	நதிக்கு	நதிக்கு
nadhiyaaga	நதியாக	நதியாக
nadhiyaaka	நதியாக	நதியாக
nathiyaaga	நதியாக	நதியாக
nadhiyin	நதியின்	நதியின்
nathiyin	நதியின்	நதியின்
nadhiyum	நதியும்	நதியும்
nathiyum	நதியும்	நதியும்
nadhiyai	நதியை	நதியை
nathiyai	நதியை	நதியை
nanavili	நனவிலி	நணவிலி
nanmaigalum	நன்மைகளும்	நண்மைகளும்
nanmaigazhum	நன்மைகளும்	நண்மைகளும்
nanmaikalum	நன்மைகளும்	நண்மைகளும்
nanmaigalaiyum	நன்மைகளையும்	நண்மைகளையும்
nanmaigazhaiyum	நன்மைகளையும்	நண்மைகளையும்
nanmaikalaiyum	நன்மைகளையும்	நண்மைகளையும்
nanmaiyin	நன்மையின்	நண்மையின்
nanmaiyum	நன்மையும்	நண்மையும்
nanmaiyai	நன்மையை	நண்மையை
namo	நமோ	நாமோ
namoa	நமோ	நம்ோ
narachimma	நரசிம்ம	நரச்மிமா
narasima	நரசிம்ம	நரசிமா
narasimma	நரசிம்ம	நரசிம்மா
narachimmarin	நரசிம்மரின்	நரச்மிமரின்
narasimarin	நரசிம்மரின்	நரசிமரின்
narasimmarin	நரசிம்மரின்	நரசிமமமின்
narachimar	நரசிம்மர்	நரச்சிமர்
narachimmar	நரசிம்மர்	நரச்மிம்
narasimhar	நரசிம்மர்	நரசிமர்
narasimmar	நரசிம்மர்	நரசிம்மர்
narambu	நரம்பு	நரர்பு
narampu	நரம்பு	நரம்பு
narambugalin	நரம்புகளின்	நரம்புகளின்
narambukalin	நரம்புகளின்	நரம்புகளின்
narampukalin	நரம்புகளின்	நரம்புகளின்
narambugalil	நரம்புகளில்	நரம்புகளில்
narambukalil	நரம்புகளில்	நரம்புகளில்
narampukalil	நரம்புகளில்	நரம்புகளில்
narambuth	நரம்புத்	நரம்புத்
naramputh	நரம்புத்	நரம்புத்
narmadhai	நர்மதை	நர்மதை
narmathai	நர்மதை	நர்மதை
nalappanigal	நலப்பணிகள்	நலப்பணிகள்
nalappanikal	நலப்பணிகள்	நலப்பணிகள்
nalathu	நல்லது	நலத்து
nallathu	நல்லது	நல்லது
nalavan	நல்லவன்	நலலவன்
nallavan	நல்லவன்	நல்லவன்
raga	நவீன	ராகா
raka	நவீன	ராகா
naveenamaana	நவீனமான	நவீணமான
naagareega	நாகரீக	நாகரேக
naagareegaththin	நாகரீகத்தின்	நாகரேகத்தின்
naagarigaththin	நாகரீகத்தின்	நாகரிகத்தின்
naagareegam	நாகரீகம்	நாகரேகம்
naasaa	நாசா	நாசா
nasa	நாசா	நாசா
naashik	நாசிக்	நாஷிக்
naasik	நாசிக்	நாசிக்
naasiq	நாசிக்	நாசிக்
nashic	நாசிக்	நாசிக்
nashik	நாசிக்	நாசிக்
nasic	நாசிக்	நாசிக்
nasik	நாசிக்	நாசிக்
nasiq	நாசிக்	நாசிக்
naisism	நாசிசம்	நெசிஸ்
naisismm	நாசிசம்	நைசிம்ம்
najism	நாசிசம்	நாஜிஸ்
nasism	நாசிசம்	நாசிம்
nazism	நாசிசம்	நாஜிஸ்
nesismm	நாசிசம்	நெசிம்ம்
naadodikal	நாடோடிகள்	நாடோடிகள்
naadoodikal	நாடோடிகள்	நாடூடிகள்
nadoadigal	நாடோடிகள்	நடோடிகள்
naattavar	நாட்டவர்	நாட்டவர்
naattin	நாட்டின்	நாட்டின்
naattiyam	நாட்டியம்	நாட்டியம்
naathar	நாதர்	நாதர்
nathar	நாதர்	நாதர்
naangaam	நான்காம்	நாங்காம்
naankaam	நான்காம்	நாங்காம்
naatram	நாற்றம்	நாற்றம்
naattram	நாற்றம்	நாற்றம்
naalanthaa	நாலந்தா	நாளந்தா
naalanththaa	நாலந்தா	நாளந்தா
nalanda	நாலந்தா	நல்நாட்
nalantha	நாலந்தா	நலந்த
naalo	நாளோ	நாலோ
nallloa	நாளோ	நல்லோ
nigalththappatta	நிகழ்த்தப்பட்ட	நிகழ்த்தப்பட்ட
nigazhththappatta	நிகழ்த்தப்பட்ட	நிகழ்த்தப்பட்ட
nikazhththappatta	நிகழ்த்தப்பட்ட	நிகழ்த்தப்பட்ட
nigalththappattu	நிகழ்த்தப்பட்டு	நிகழ்த்தப்பட்டு
nigazhththappattu	நிகழ்த்தப்பட்டு	நிகழ்த்தப்பட்டு
nikazhththappattu	நிகழ்த்தப்பட்டு	நிகழ்த்தப்பட்டு
nigalththuvathu	நிகழ்த்துவது	நிகழ்த்துவது
nigazhththuvadhu	நிகழ்த்துவது	நிகழ்த்துவது
nigazhththuvathu	நிகழ்த்துவது	நிகழ்த்துவது
nikazhththuvathu	நிகழ்த்துவது	நிகழ்த்துவது
nigalvu	நிகழ்வு	நிகழ்வு
nigazhvu	நிகழ்வு	நிகழ்வு
nikazhvu	நிகழ்வு	நிகழ்வு
nigalvugalaaga	நிகழ்வுகளாக	நிகழ்வுகளாக
nigazhvugalaaga	நிகழ்வுகளாக	நிகழ்வுகளாக
nigazhvugazhaaga	நிகழ்வுகளாக	நிகழ்வுகளாக
nikazhvukalaaka	நிகழ்வுகளாக	நிகழ்வுகளாக
nigalvugalilum	நிகழ்வுகளிலும்	நிகழ்வுகளிலும்
nigazhvugalilum	நிகழ்வுகளிலும்	நிகழ்வுகளிலும்
nigazhvugazhilum	நிகழ்வுகளிலும்	நிகழ்வுகளிலும்
nikazhvukalilum	நிகழ்வுகளிலும்	நிகழ்வுகளிலும்
nigalvugalil	நிகழ்வுகளில்	நிகழ்வுகளில்
nigazhvugalil	நிகழ்வுகளில்	நிகழ்வுகளில்
nigazhvugazhil	நிகழ்வுகளில்	நிகழ்வுகளில்
nikazhvukalil	நிகழ்வுகளில்	நிகழ்வுகளில்
nigalvugalukku	நிகழ்வுகளுக்கு	நிகழ்வுகளுக்கு
nigazhvugalukku	நிகழ்வுகளுக்கு	நிகழ்வுகளுக்கு
nigazhvugazhukku	நிகழ்வுகளுக்கு	நிகழ்வுகளுக்கு
nikazhvukalukku	நிகழ்வுகளுக்கு	நிகழ்வுகளுக்கு
nigalvugalukkum	நிகழ்வுகளுக்கும்	நிகழ்வுகளுக்கும்
nigazhvugalukkum	நிகழ்வுகளுக்கும்	நிகழ்வுகளுக்கும்
nigazhvugazhukkum	நிகழ்வுகளுக்கும்	நிகழ்வுகளுக்கும்
nikazhvukalukkum	நிகழ்வுகளுக்கும்	நிகழ்வுகளுக்கும்
nigalvugaludan	நிகழ்வுகளுடன்	நிகழ்வுகளுடன்
nigazhvugaludan	நிகழ்வுகளுடன்	நிகழ்வுகளுடன்
nigazhvugazhudan	நிகழ்வுகளுடன்	நிகழ்வுகளுடன்
nikazhvukaludan	நிகழ்வுகளுடன்	நிகழ்வுகளுடன்
nigalvugalum	நிகழ்வுகளும்	நிகழ்வுகளும்
nigazhvugalum	நிகழ்வுகளும்	நிகழ்வுகளும்
nigazhvugazhum	நிகழ்வுகளும்	நிகழ்வுகளும்
nikazhvukalum	நிகழ்வுகளும்	நிகழ்வுகளும்
nigalvugalai	நிகழ்வுகளை	நிகழ்வுகளை
nigazhvugalai	நிகழ்வுகளை	நிகழ்வுகளை
nigazhvugazhai	நிகழ்வுகளை	நிகழ்வுகளை
nikazhvukalai	நிகழ்வுகளை	நிகழ்வுகளை
nigalvugalaich	நிகழ்வுகளைச்	நிகழ்வுகளைச்
nigazhvugalaich	நிகழ்வுகளைச்	நிகழ்வுகளைச்
nigazhvugazhaich	நிகழ்வுகளைச்	நிகழ்வுகளைச்
nikazhvukalaich	நிகழ்வுகளைச்	நிகழ்வுகளைச்
nigalvugal	நிகழ்வுகள்	நிகழ்வுகள்
nigazhvugal	நிகழ்வுகள்	நிகழ்வுகள்
nigazhvugazh	நிகழ்வுகள்	நிகழ்வுகள்
nikazhvukal	நிகழ்வுகள்	நிகழ்வுகள்
nigalvukku	நிகழ்வுக்கு	நிகழ்வுக்கு
nigazhvukku	நிகழ்வுக்கு	நிகழ்வுக்கு
nikazhvukku	நிகழ்வுக்கு	நிகழ்வுக்கு
nigalvukkup	நிகழ்வுக்குப்	நிகழ்வுக்குப்
nigazhvukkup	நிகழ்வுக்குப்	நிகழ்வுக்குப்
nikazhvukkup	நிகழ்வுக்குப்	நிகழ்வுக்குப்
nichayikapata	நிச்சயிக்கப்பட்ட	நிசையக்கப்பட்ட
nichchayikkappatta	நிச்சயிக்கப்பட்ட	நிச்சைக்கப்பட்ட
neenja	நிஞ்ஜா	நெஞ்சா
neenza	நிஞ்ஜா	நீன்சா
niinja	நிஞ்ஜா	நிஞ்சா
ninchjaa	நிஞ்ஜா	நிஞ்சா
ninja	நிஞ்ஜா	நிஞ்சா
ninjaa	நிஞ்ஜா	நிஞ்சா
ninza	நிஞ்ஜா	நின்சா
ninzaa	நிஞ்ஜா	நின்சா
nynjaa	நிஞ்ஜா	நஞ்சா
nynzaa	நிஞ்ஜா	நிஞா
ninaivaaga	நினைவாக	நினைவாக
ninaivaaka	நினைவாக	நினைவாக
ninaivvaaga	நினைவாக	நினைவ்வாக
ninaivaagavae	நினைவாகவே	நினைவாகவே
ninaivaagave	நினைவாகவே	நினைவாகவே
ninaivaakave	நினைவாகவே	நினைவாகவே
ninaivuchchinnam	நினைவுச்சின்னம்	நினைவுச்சின்மம்
niyamana	நியமன	நியமான
niyamanathil	நியமனத்தில்	நியமனத்தில்
niyamanaththil	நியமனத்தில்	நியமனத்தில்
niyamanatthil	நியமனத்தில்	நியமனத்தில்
niyamikapadum	நியமிக்கப்படும்	நியமிக்கப்படும்
niyamikkappadum	நியமிக்கப்படும்	நியமிக்கப்படும்
niyamikkappatum	நியமிக்கப்படும்	நியமிக்கப்பட்டும்
niyamikavum	நியமிக்கவும்	நியமிக்கவும்
niyamikkavum	நியமிக்கவும்	நியமிக்கவும்
niyamikkum	நியமிக்கும்	நியமிக்கும்
niyamikum	நியமிக்கும்	நியமிக்கும்
nirai	நிரை	நிறை
nirvagikkappadum	நிர்வகிக்கப்படும்	நிற்வகிக்கப்படும்
nirvakikkappadum	நிர்வகிக்கப்படும்	நிற்வக்கிக்கப்படும
nirvagikkappattu	நிர்வகிக்கப்பட்டு	நிற்வகிக்கப்பட்டு
nirvakikkappattu	நிர்வகிக்கப்பட்டு	நிற்வக்கிக்கப்பட்ட
nirvaagac	நிர்வாகச்	நிற்வாகச்
nirvaagach	நிர்வாகச்	நிற்வாகச்
nirvaagaththaal	நிர்வாகத்தால்	நிற்வாகத்தால்
nirvaagaththin	நிர்வாகத்தின்	நிர்வாகத்தின்
nirvaakaththin	நிர்வாகத்தின்	நிர்வாகத்தின்
nirvaagaththirku	நிர்வாகத்திற்கு	நிற்வாகத்திற்கு
nirvaagaththai	நிர்வாகத்தை	நிற்வாகத்தை
nirvaakaththai	நிர்வாகத்தை	நிற்வாகத்தை
nirvaakatthai	நிர்வாகத்தை	நிற்வாகத்தை
nirvakathai	நிர்வாகத்தை	நிற்வக்கதை
nirvaagaththaip	நிர்வாகத்தைப்	நிற்வாகத்தைப்
nirvaakaththaip	நிர்வாகத்தைப்	நிற்வாகத்தைப்
nirvaakatthaip	நிர்வாகத்தைப்	நிற்வாகத்தைப்
nirvakathaip	நிர்வாகத்தைப்	நிற்வக்கத்பைப்
nirvaagam	நிர்வாகம்	நிற்வாகம்
nirvaakam	நிர்வாகம்	நிற்வாகம்
nirvakam	நிர்வாகம்	நிற்வக்கம்
nilath	நிலத்	நிலத்
nilaththu	நிலத்து	நிலத்து
nilathu	நிலத்து	நிலது
nilatthu	நிலத்து	நிலத்து
nilaparapai	நிலப்பரப்பை	நிலப்பரப்பை
nilapparappai	நிலப்பரப்பை	நிலப்பரப்பை
nilainiluvaiyil	நிலுவையில்	நிலைநிலுவையில்
niluvaiyil	நிலுவையில்	நிலுவையில்
nilainiruththi	நிலைநிறுத்தி	நிலைநிருத்தி
neengalum	நீங்களும்	நீங்களும்
neengkalum	நீங்களும்	நீங்களும்
neengal	நீங்கள்	நீங்கள்
neengkal	நீங்கள்	நீங்கள்
neetti	நீட்டி	நீட்டி
neerilivu	நீரிழிவு	நீரிலிவு
neerizhivu	நீரிழிவு	நீரிழிவு
neeraetrtru	நீரேற்று	நேரேற்று
neeraetru	நீரேற்று	நீரேற்று
neereatru	நீரேற்று	நீரேற்று
neeraik	நீரைக்	நீரைக்
neeroatta	நீரோட்ட	நேரோட்டா
kneel	நீல்	கினல்
neal	நீல்	நேல்
neel	நீல்	நேல்
neiil	நீல்	நெல்
neil	நீல்	நெல்
nel	நீல்	நெல்
niil	நீல்	நில்
nulainthavudan	நுழைந்தவுடன்	நுலைந்தவுடன்
nuzhaindhavudan	நுழைந்தவுடன்	நுழைந்தவுடன்
nuzhinththavudan	நுழைந்தவுடன்	நுழிந்தவுடன்
nulainthu	நுழைந்து	நுளைந்து
nuzhaindhu	நுழைந்து	நுழைந்து
nuzhinththu	நுழைந்து	நுழிந்து
noolagak	நூலகக்	நூலகக்
noolakak	நூலகக்	நூலகக்
noolagangalai	நூலகங்களை	நூலகங்களை
noolakangalai	நூலகங்களை	நூலகங்களை
noolakangkalai	நூலகங்களை	நூலகங்களை
noolangangkalai	நூலகங்களை	நூலங்கங்களை
noolagaththin	நூலகத்தின்	நூலகத்தின்
noolakaththin	நூலகத்தின்	நூலகத்தின்
noolagaththukku	நூலகத்துக்கு	நூலகத்துக்கு
noolakaththukku	நூலகத்துக்கு	நூலகத்துக்கு
noolagamaaga	நூலகமாக	நூலகமாக
noolagamaaka	நூலகமாக	நூலகமாக
noolakamaaga	நூலகமாக	நூலகமாக
noolakamaaka	நூலகமாக	நூலகமாக
noolagam	நூலகம்	நூலகம்
noolakam	நூலகம்	நூலகம்
noolagar	நூலகர்	நூலகர்
noolakar	நூலகர்	நூலகர்
noolaar	நூலார்	நூலார்
noolaal	நூலால்	நோலால்
noolilirundhu	நூலிலிருந்து	நூலிலிருந்து
noolilirunthu	நூலிலிருந்து	நூலிலிருந்து
negili	நெகிழி	நெகிலி
negizhi	நெகிழி	நெகிழி
negizhyi	நெகிழி	நெகிழி
nekili	நெகிழி	நெக்கிலி
nediya	நெடிய	நெடியா
network	நெட்வொர்க்	நெட்வர்க்
nedharlaandhu	நெதர்லாந்து	நெதர்லாந்து
netharlaanthu	நெதர்லாந்து	நெதர்லாந்து
netherlaanththu	நெதர்லாந்து	நெதரர்லாந்து
netherland	நெதர்லாந்து	நெதர்லாண்ட்
netriyil	நெற்றியில்	நெற்றியில்
nettriyil	நெற்றியில்	நெற்றியில்
nel	நெல்	நெல்
nellai	நெல்லை	நெல்லை
nellaik	நெல்லைக்	நெல்லைக்
nellaip	நெல்லைப்	நெல்லைப்
naespid	நெஸ்பிட்	நேஸ்பிட்
nesbit	நெஸ்பிட்	நெஸ்பிட்
nesbitt	நெஸ்பிட்	நெஸ்பிட்
naethraa	நேத்ரா	நேத்ரா
nethra	நேத்ரா	நேத்ரா
neerittu	நேரிட்டு	நீரிட்டு
nerittu	நேரிட்டு	நெரிட்டு
neritu	நேரிட்டு	நேரிட்டு
naiirobii	நைரோபி	நைரோபி
nairobi	நைரோபி	நைரோபி
nairoobi	நைரோபி	நைரோபி
nairoopi	நைரோபி	நைரோப்பி
nerobi	நைரோபி	நெரோபி
nairobiyil	நைரோபியில்	நைரோபியில்
nairopiyil	நைரோபியில்	நைரோபியில்
nokich	நோக்கிச்	நாக்கிச்
nokkich	நோக்கிச்	நாக்கிச்
nookkich	நோக்கிச்	நூக்கிச்
nokin	நோக்கின்	நாக்கின்
nokkin	நோக்கின்	நாக்கின்
nookkin	நோக்கின்	நோக்கின்
nokiyum	நோக்கியும்	நோகியும்
nokkiyum	நோக்கியும்	நோக்கியும்
nookkiyum	நோக்கியும்	நூக்கியும்
nokilum	நோக்கிலும்	நோகிலும்
nokkilum	நோக்கிலும்	நோக்கிலும்
nooyinaal	நோயினால்	நூயினால்
noyinaal	நோயினால்	நோயினால்
noyinal	நோயினால்	நோயினல்
nooyuttra	நோயுற்ற	நூயுற்ற
noyutra	நோயுற்ற	நோயூற்ற
noyuttra	நோயுற்ற	நோயுற்ற
noaiththotrukal	நோய்த்தொற்றுகள்	நோய்தொற்றுகள்
noayththotrugal	நோய்த்தொற்றுகள்	நோத்தொற்றுகள்
noiththottrugal	நோய்த்தொற்றுகள்	நோத்தொற்றுகள்
pagirnthuk	பகிர்ந்துக்	பகிர்ந்துக்
pakirnthuk	பகிர்ந்துக்	பகிர்ந்துக்
bhagujan	பகுஜன்	பககஜன்
pagujan	பகுஜன்	பகுஜன்
pakujan	பகுஜன்	பககுஜன்
paguthiyai	பகுதியை	பகுதியை
pakuthiyai	பகுதியை	பகுதியை
paguthiyaich	பகுதியைச்	பகுதியைச்
pakuthiyaich	பகுதியைச்	பகுதியைச்
paguthiyaip	பகுதியைப்	பகுதியைப்
pakuthiyaip	பகுதியைப்	பகுதியைப்
paagoda	பகோடா	பாகோடா
paagooda	பகோடா	பாகோடா
pagoda	பகோடா	பகோடா
pagodaa	பகோடா	பகோடா
pagooda	பகோடா	பகோடா
pagoodaa	பகோடா	பகோதா
pagoovda	பகோடா	பகோவட்டா
pagoowda	பகோடா	பகோத்தா
pagovda	பகோடா	பகவவட்டா
pagowda	பகோடா	பகவடா
paguda	பகோடா	பகுடா
pakoadaa	பகோடா	பகோடா
pakoda	பகோடா	பகோடா
pakooda	பகோடா	பகோடா
pakootaa	பகோடா	பகோதா
pasukkalai	பசுக்களை	பசுக்களை
pasukkazhai	பசுக்களை	பசுக்கழை
pasukkazhil	பசுக்களை	பசுக்கழில்
padagai	படகை	படகை
padakai	படகை	படக்கை
padangalaaga	படங்களாக	படங்களாக
padangalaaka	படங்களாக	படங்களாக
padangkalaaka	படங்களாக	படங்களாக
padangalaana	படங்களான	படங்களான
padangkalaana	படங்களான	படங்களான
padangalil	படங்களில்	படங்களில்
padangkalil	படங்களில்	படங்களில்
pandangalil	படங்களில்	பண்டங்களில்
padangalukku	படங்களுக்கு	படங்களுக்கு
padangkalukku	படங்களுக்கு	படங்களுக்கு
padangalum	படங்களும்	படங்களும்
padanggalum	படங்களும்	படங்களும்
padappidippum	படப்பிடிப்பும்	படப்பிடிப்பும்
padarndha	படர்ந்த	படர்ந்த
padarntha	படர்ந்த	படர்ந்த
padalaththin	படலத்தின்	படலத்தின்
padalaththai	படலத்தை	படலத்தை
padi	படி	பாடி
padigalil	படிகளில்	படிகளில்
padikalil	படிகளில்	படிகளில்
padigalum	படிகளும்	படிகளும்
padikalum	படிகளும்	படிகளும்
padigalai	படிகளை	படிகளை
padikalai	படிகளை	படிகளை
padiththaal	படித்தால்	படித்தால்
paditthaal	படித்தால்	படித்தால்
padinilaigal	படிநிலைகள்	படினிலைகள்
padinilaikal	படிநிலைகள்	படினிலைகள்
padinilaiyil	படிநிலையில்	படினிலையில்
padippadiyaana	படிப்படியான	படிப்படியான
padipaip	படிப்பைப்	படிப்பைப்
padippaip	படிப்பைப்	படிப்பைப்
patippaip	படிப்பைப்	படிப்பைப்
padimangal	படிமங்கள்	படிமங்கள்
padimankal	படிமங்கள்	படிமங்கள்
patimankal	படிமங்கள்	பட்டிமங்கள
padimathai	படிமத்தை	படிமத்தை
padimaththai	படிமத்தை	படிமத்தை
padimatthai	படிமத்தை	படிமத்தை
patimatthai	படிமத்தை	படிமத்தை
padiyilum	படியிலும்	படியிலும்
patiyilum	படியிலும்	பட்டியும்
paduthoalvi	படுதோல்வி	படுத்தோல்வ
padutholvi	படுதோல்வி	படுத்தொவ்வ
paduthoolvi	படுதோல்வி	படுதோத்வி
patuthoolvi	படுதோல்வி	படுத்தூல்வ
paduthik	படுத்திக்	படுத்திக்
paduththik	படுத்திக்	படுத்திக்
padutthik	படுத்திக்	படுத்திக்
patutthik	படுத்திக்	படுத்திக்
padaitha	படைத்த	படைத்த
padaiththa	படைத்த	படைத்த
padaittha	படைத்த	படைத்த
pataittha	படைத்த	படைத்த
padaithathaga	படைத்ததாக	படைத்ததாக
padaithathaka	படைத்ததாக	படைத்ததாக
padaiththathaaga	படைத்ததாக	படைத்ததாக
padaiththathaaka	படைத்ததாக	படைத்ததாக
padaitthathaaka	படைத்ததாக	படைத்ததாக
pataitthathaaka	படைத்ததாக	படைத்ததாக
padaithal	படைத்தல்	படைத்தல்
padaiththal	படைத்தல்	படைத்தல்
padaitthal	படைத்தல்	படைத்தல்
pataitthal	படைத்தல்	படைத்தல்
padaithavan	படைத்தவன்	படைத்தவன்
padaiththavan	படைத்தவன்	படைத்தவன்
padaitthavan	படைத்தவன்	படைத்தவன்
pataitthavan	படைத்தவன்	படைத்தவன்
padaithar	படைத்தார்	படைத்தர்
padaiththaar	படைத்தார்	படைத்தார்
padaitthaar	படைத்தார்	படைத்தார்
pataitthaar	படைத்தார்	படைத்தார்
padaiththullathu	படைத்துள்ளது	படைத்துள்ளது
padaithulathu	படைத்துள்ளது	படைத்துளது
padaitthullathu	படைத்துள்ளது	படைத்துள்ளது
pataitthullathu	படைத்துள்ளது	படைத்துள்ளது
padaiththullaar	படைத்துள்ளார்	படைத்துள்ளார்
padaithular	படைத்துள்ளார்	படைத்துளர்
padaitthullaar	படைத்துள்ளார்	படைத்துள்ளார்
pataitthullaar	படைத்துள்ளார்	படைத்துள்ளார்
padaiyani	படையணி	படையணி
pataiyani	படையணி	படையணி
padaiyanigal	படையணிகள்	படையாணிகள்
padaiyanikal	படையணிகள்	படையாணிகள்
pataiyanikal	படையணிகள்	படையணிகள்
padaiyinaraal	படையினரால்	படையினரால்
padaiyinaral	படையினரால்	படையினரால்
pataiyinaraal	படையினரால்	படையினரால்
padaiyinarin	படையினரின்	படையினரின்
pataiyinarin	படையினரின்	படையினரின்
padaiyinarai	படையினரை	படையினரை
padayinarai	படையினரை	படையினரை
patayinarai	படையினரை	படையினரை
pattaalum	பட்டாலும்	பட்டாலும்
panayam	பணயம்	பணையம்
panigalilum	பணிகளிலும்	பணிகளிலும்
panigazhilum	பணிகளிலும்	பணிகளிலும்
panigalil	பணிகளில்	பணிகளில்
panigalukkaana	பணிகளுக்கான	பணிகளுக்கான
panigazhukkaana	பணிகளுக்கான	பணிகழுக்கான
panigalaich	பணிகளைச்	பணிகளைச்
panigazhaich	பணிகளைச்	பணிகளைச்
panik	பணிக்	பணிக்
panikku	பணிக்கு	பணிக்கு
panikkum	பணிக்கும்	பணிக்கும்
panit	பணித்	பாணிட்
panith	பணித்	பணித்
paniyagam	பணியகம்	பணியகம்
paniyakam	பணியகம்	பணியககம்
paniyaaga	பணியாக	பணியாக
paniyaaka	பணியாக	பணியாக
paniyaalarin	பணியாளரின்	பணியாளரின்
paniyil	பணியில்	பணியில்
paniyaiyum	பணியையும்	பணியையும்
panivum	பணிவும்	பணிவும்
panbaadugalil	பண்பாடுகளில்	பண்பாடுகளில்
panpaadugalil	பண்பாடுகளில்	பண்பாடுகளில்
panpaadugazhil	பண்பாடுகளில்	பண்பாடுகளில்
panpaadukalil	பண்பாடுகளில்	பண்பாடுகளில்
panbadugalai	பண்பாடுகளை	பண்படுகளை
panpaadugalai	பண்பாடுகளை	பண்பாடுகளை
panpaadugazhai	பண்பாடுகளை	பண்பாடுகளை
panpaadukalai	பண்பாடுகளை	பண்பாடுகளை
panbaadugal	பண்பாடுகள்	பண்பாடுகள்
panpaadugal	பண்பாடுகள்	பண்பாடுகள்
panpaadukal	பண்பாடுகள்	பண்பாடுகள்
panbaana	பண்பான	பண்பான
padhikka	பதிக்க	பதிக்க
pathikka	பதிக்க	பதிக்க
keelkkanakku	பதினெண்	கீழ்க்கணக்கு
keezhkkanakku	பதினெண்	கீழ்க்கணக்கு
kilkkanakku	பதினெண்	கிள்க்கணக்கு
padhinoaru	பதினோரு	பதினோரு
pathinoaru	பதினோரு	பதினோறு
padhipiththaar	பதிப்பித்தார்	பதிபித்தார்
pathippiththaar	பதிப்பித்தார்	பதிப்பித்தார்
pathippitthaar	பதிப்பித்தார்	பதிப்பித்தார்
padhipiththu	பதிப்பித்து	பதிபித்து
pathippiththu	பதிப்பித்து	பதிப்பித்து
pathippitthu	பதிப்பித்து	பதிப்பித்து
bathilaliththaan	பதிலளித்தான்	பதிலலித்தான்
pathilaliththaan	பதிலளித்தான்	பதிலலித்தான்
bathilaliththaar	பதிலளித்தார்	பதிலலித்தார்
pathilaliththaar	பதிலளித்தார்	பதிலலித்தார்
paththaandugalukku	பத்தாண்டுகளுக்கு	பத்தாண்டுகளுக்கு
paththaandukalukku	பத்தாண்டுகளுக்கு	பத்தாண்டுகளுக்கு
paththandukalukku	பத்தாண்டுகளுக்கு	பத்தன்டுகளுக்கு
paththaandugalukkum	பத்தாண்டுகளுக்கும்	பத்தாண்டுகளுக்கும்
paththaandukalukkum	பத்தாண்டுகளுக்கும்	பத்தாண்டுகளுக்கும்
paththin	பத்தின்	பத்தின்
paththo	பத்தோ	பத்தோ
paththoa	பத்தோ	பத்தோ
padmanaaba	பத்மநாப	பட்மானாப
pathmanaaba	பத்மநாப	பத்மானாப
pathmanaapa	பத்மநாப	பத்மானாப
pandhi	பந்தி	பந்தி
panthi	பந்தி	பந்தி
panththi	பந்தி	பந்தி
pandrikku	பன்றிக்கு	பண்றிக்கு
panrikku	பன்றிக்கு	பண்றிக்கு
payanitha	பயணித்த	பயனித்த
payaniththa	பயணித்த	பயணித்த
payanithar	பயணித்தார்	பயணிதர்
payaniththaar	பயணித்தார்	பயணித்தார்
payirgalaana	பயிர்களான	பயிர்களான
payirkalaana	பயிர்களான	பயிற்களான
payirgalai	பயிர்களை	பயிற்களை
payirkalai	பயிர்களை	பயிற்களை
paiyrkalaiyum	பயிர்களையும்	பயிற்களையும்
payirgalaiyum	பயிர்களையும்	பயிற்களையும்
payirkalaiyum	பயிர்களையும்	பயிற்களையும்
paiyrkal	பயிர்கள்	பைய்ற்கள்
payirkal	பயிர்கள்	பயிற்கள்
parappalavil	பரப்பளவில்	பரப்பலவில்
parappazhavil	பரப்பளவில்	பரப்பழவில்
parappuraigal	பரப்புரைகள்	பரப்புறைகள்
parappuraikal	பரப்புரைகள்	பரப்புறைகள்
parchinai	பரிசினை	பர்சினை
parichinai	பரிசினை	பரிசினை
parisinai	பரிசினை	பரிசினை
parindhuraikka	பரிந்துரைக்க	பரிந்துரைக்க
parinthuraikka	பரிந்துரைக்க	பரிந்துரைக்க
parindhuraikkappadum	பரிந்துரைக்கப்படும்	பரிந்துரைக்கப்படும்
parinthuraikkappadum	பரிந்துரைக்கப்படும்	பரிந்துரைக்கப்படும்
parinthuraikkappatum	பரிந்துரைக்கப்படும்	பரிந்துரைக்கப்படும்
parindhuraikkum	பரிந்துரைக்கும்	பரிந்துரைக்கும்
parinththuraikkum	பரிந்துரைக்கும்	பரிந்துரைக்கும்
parinthuraikkum	பரிந்துரைக்கும்	பரிந்துரைக்கும்
parimaatra	பரிமாற்ற	பரிமாற்ற
parimaattra	பரிமாற்ற	பரிமாற்ற
parimaatrangalai	பரிமாற்றங்களை	பரிமாற்றங்களை
parimaatrangkalai	பரிமாற்றங்களை	பரிமாற்றங்களை
parimaattrangalai	பரிமாற்றங்களை	பரிமாற்றங்களை
parimaattrankalai	பரிமாற்றங்களை	பரிமாற்றங்களை
parimaatrangal	பரிமாற்றங்கள்	பரிமாற்றங்கள்
parimaatrangkal	பரிமாற்றங்கள்	பரிமாற்றங்கள்
parimaattrangal	பரிமாற்றங்கள்	பரிமாற்றங்கள்
parimaattrangalai	பரிமாற்றங்கள்	பரிமாற்றங்களை
parimaattrankal	பரிமாற்றங்கள்	பரிமாற்றங்கள்
parimaattrankalai	பரிமாற்றங்கள்	பரிமாற்றங்களை
parimaatraththin	பரிமாற்றத்தின்	பரிமாற்றத்தின்
parimaattraththin	பரிமாற்றத்தின்	பரிமாற்றத்தின்
parimaatram	பரிமாற்றம்	பரிமாற்றம்
parimaattram	பரிமாற்றம்	பரிமாற்றம்
barma	பர்மா	பார்மா
barmaa	பர்மா	பர்மா
berma	பர்மா	பெர்மா
burma	பர்மா	புர்மா
burmaa	பர்மா	புர்மா
buurma	பர்மா	புர்மா
buurmaa	பர்மா	புர்மா
parma	பர்மா	பர்மா
parmaa	பர்மா	பர்மா
barmaavin	பர்மாவின்	பார்மாவின்
burmaavin	பர்மாவின்	புர்மாவின்
burmavin	பர்மாவின்	புர்மாவின்
parmaavin	பர்மாவின்	பர்மாவின்
barmaavil	பர்மாவில்	பர்மாவில்
burmaavil	பர்மாவில்	புர்மாவில்
burmavil	பர்மாவில்	புர்மாவில்
parmaavil	பர்மாவில்	பர்மாவில்
parmavil	பர்மாவில்	பர்மவில்
parappathu	பறப்பது	பரப்பது
parra	பற்ற	பரர்
patra	பற்ற	பற்ற
patrra	பற்ற	பற்ற
pattra	பற்ற	பற்ற
patraamal	பற்றாமல்	பற்றாமல்
patrraamal	பற்றாமல்	பற்றாமல்
pattraamal	பற்றாமல்	பற்றாமல்
patrinaal	பற்றினால்	பற்றினால்
pattrinaal	பற்றினால்	பற்றினால்
parrulla	பற்றுள்ள	பரருள்ள
patrulla	பற்றுள்ள	பற்றுள்ள
pattrulla	பற்றுள்ள	பற்றுள்ள
palagai	பலகை	பலகை
palakai	பலகை	பலகை
palagaigalil	பலகைகளில்	பலகைகளில்
palagaikalil	பலகைகளில்	பலகைகளில்
palakaikalil	பலகைகளில்	பலகைகளில்
palakaiyil	பலகைகளில்	பலகையில்
palacharakku	பலசரக்கு	பலசராக்கு
palasarakku	பலசரக்கு	பலசராக்கு
balanaaga	பலனாக	பலனாக
balanaaka	பலனாக	பலனாக
palanaaga	பலனாக	பலனாக
palanaaka	பலனாக	பலனாக
palavarrilum	பலவற்றிலும்	பலவர்றிலும்
palavatrilum	பலவற்றிலும்	பலவற்றிலும்
palavatrrilum	பலவற்றிலும்	பலவற்றிலும்
palavattrilum	பலவற்றிலும்	பலவற்றிலும்
pallakku	பல்லக்கு	பல்லக்கு
pallavar	பல்லவர்	பல்லவர்
pallavargalin	பல்லவர்களின்	பல்லவர்களின்
pallavargazhin	பல்லவர்களின்	பள்ளவர்களின்
pallina	பல்லின	பல்லினா
pavudar	பவுடர்	பவுடர்
povder	பவுடர்	பவட்டர்
powdar	பவுடர்	பவட்டர்
powder	பவுடர்	பவட்டர்
pavurnami	பவுர்ணமி	பவுர்ணமி
pournami	பவுர்ணமி	பூர்ணமி
pauli	பவுலி	பாலி
paulii	பவுலி	பாலி
pauuli	பவுலி	பூலி
pavuli	பவுலி	பவுளி
bowlin	பவுலின்	பாலின்
pavulin	பவுலின்	பவுலின்
paagupaadugal	பாகுபாடுகள்	பாகுபாடுகள்
paakupaadukal	பாகுபாடுகள்	பாகுபாடுகள்
paadalilum	பாடலிலும்	பாடலிலும்
paatalilum	பாடலிலும்	பாடலிலும்
paandavar	பாண்டவர்	பாண்டவர்
paantavar	பாண்டவர்	பாண்டவர்
pandavar	பாண்டவர்	பண்டவர்
paandavargalin	பாண்டவர்களின்	பாண்டவர்களின்
paandavarkalin	பாண்டவர்களின்	பாண்டவர்களின்
paantavarkalin	பாண்டவர்களின்	பாண்டவர்களின்
pandavargalin	பாண்டவர்களின்	பண்டவர்களின்
paandavargalukku	பாண்டவர்களுக்கு	பாண்டவர்களுக்கு
paandavarkalukku	பாண்டவர்களுக்கு	பாண்டவர்களுக்கு
paantavarkalukku	பாண்டவர்களுக்கு	பாண்டவர்களுக்கு
pandavargalukku	பாண்டவர்களுக்கு	பண்டவர்களுக்கு
paathagamaaka	பாதகமாக	பாதகமாக
paathakamaaka	பாதகமாக	பாதகமாக
paathaagamaana	பாதகமான	பாதாகமான
paathaakamaana	பாதகமான	பாதாகமான
paathagamaana	பாதகமான	பாதகமான
paathakamaana	பாதகமான	பாதகமான
paadhi	பாதி	பாதி
paathi	பாதி	பாதி
baathiththu	பாதித்து	பாதித்து
paathiththu	பாதித்து	பாதித்து
paadhiyei	பாதியை	பாதியே
paathiyai	பாதியை	பாதியை
baathaikalil	பாதைகளில்	பாதைகளில்
paathaikalil	பாதைகளில்	பாதைகளில்
baathaikalaiyum	பாதைகளையும்	பாதைகளையும்
paathaikalaiyum	பாதைகளையும்	பாதைகளையும்
baathaikal	பாதைகள்	பாதைகள்
paathaikal	பாதைகள்	பாதைகள்
baathaiyaaka	பாதையாக	பாதையாக
paathaiyaaka	பாதையாக	பாதையாக
paathaiyin	பாதையின்	பாதையின்
baathaiyilirinthu	பாதையிலிருந்து	பாதையிலிருந்து
paathaiyilirinthu	பாதையிலிருந்து	பாதையிலிருந்து
paathaiyilirunththu	பாதையிலிருந்து	பாதையிலிருந்து
paathaiyilirunthu	பாதையிலிருந்து	பாதையிலிருந்து
paathaiyum	பாதையும்	பாதையும்
bath	பாத்	பாத்
beth	பாத்	பெத்
pat	பாத்	பாட்
baanarji	பானர்ஜி	பானர்ஜி
banerji	பானர்ஜி	பானர்ஜி
paanarji	பானர்ஜி	பாணர்ஜி
baaba	பாபா	பாபா
baabaa	பாபா	பாபா
baba	பாபா	பாபா
babaa	பாபா	பாபா
baabpaa	பாப்பா	பாப்பா
paapa	பாப்பா	பாபா
paappaa	பாப்பா	பாப்பா
papa	பாப்பா	பாபா
papaa	பாப்பா	பாபா
pappa	பாப்பா	பப்பா
paamban	பாம்பன்	பாம்பன்
paampan	பாம்பன்	பாம்பன்
paaraattappatta	பாராட்டப்பட்ட	பாராட்டப்பட்ட
paaris	பாரிஸ்	பாரிஸ்
paeris	பாரிஸ்	பேரிஸ்
pariis	பாரிஸ்	பாரிஸ்
paris	பாரிஸ்	பாரிஸ்
pariss	பாரிஸ்	பாரஸஸ்
paarungal	பாருங்கள்	பாருங்கள்
paarungkal	பாருங்கள்	பாருங்கள்
paarunkal	பாருங்கள்	பாருங்கள்
baalan	பாலன்	பாலன்
baillon	பாலன்	பெல்லன்
bailon	பாலன்	பாலன்
bailun	பாலன்	பெல்
bailuun	பாலன்	பெல்
balan	பாலன்	பாலன்
ballon	பாலன்	பாலன்
balon	பாலன்	பாலன்
bellon	பாலன்	பெல்னன்
belun	பாலன்	பெலன்
paalan	பாலன்	பாலன்
palan	பாலன்	பலன்
baalu	பாலு	பாலு
balu	பாலு	பாலு
paalu	பாலு	பாலு
balaiya	பாலையா	பலலையா
paalaiyaa	பாலையா	பாலையா
bhaavangalai	பாவங்களை	பாவங்களை
paavangalai	பாவங்களை	பாவங்களை
paavangkalai	பாவங்களை	பாவங்களை
paavankalai	பாவங்களை	பாவங்களை
paavaththin	பாவத்தின்	பாவத்தின்
paavaththai	பாவத்தை	பாவத்தை
bhaavaththaith	பாவத்தைத்	பாவத்தைத்
paavaththaith	பாவத்தைத்	பாவத்தைத்
baavanaigal	பாவனைகள்	பாவனைகள்
bhaavanaigal	பாவனைகள்	பாவனைகள்
paavanaikal	பாவனைகள்	பாவனைகள்
paavam	பாவம்	பாவம்
pavam	பாவம்	பவம்
paavai	பாவை	பாவை
baav	பாவ்	பாவ்
paav	பாவ்	பாவ்
pav	பாவ்	பவ்
piggu	பிக்கு	பிக்கு
pikku	பிக்கு	பிக்கு
bjb	பிஜேபி	ப்ப்
bjp	பிஜேபி	ப்ப்
pidyuuddari	பிட்யூட்டரி	பிட்டுடரி
pituitari	பிட்யூட்டரி	பிட்டிடரி
pituitarii	பிட்யூட்டரி	பிட்டுடரி
pituitary	பிட்யூட்டரி	பிட்டிடர்
pitutari	பிட்யூட்டரி	பிட்டுதரி
pitutary	பிட்யூட்டரி	பிட்டர்
pituuitarii	பிட்யூட்டரி	பிடுடாடரி
pituuitary	பிட்யூட்டரி	பிட்டிடர்
pituutary	பிட்யூட்டரி	பிட்டாடர்
piththu	பித்து	பித்து
pinburaththil	பின்புறத்தில்	பின்புரத்தில்
pinpuraththil	பின்புறத்தில்	பின்புரத்தில்
pinburamulla	பின்புறமுள்ள	பின்புரமுள்ள
pinpuramulla	பின்புறமுள்ள	பின்புரமுள்ள
pinburam	பின்புறம்	பின்புரம்
pinpuram	பின்புறம்	பின்புறம்
binvaangi	பின்வாங்கி	பின்வாங்கி
binvaangki	பின்வாங்கி	பின்வாங்கி
pinvaangi	பின்வாங்கி	பின்வாங்கி
pinvaangki	பின்வாங்கி	பின்வாங்கி
pee	பியா	பீ
peea	பியா	பீ
peeia	பியா	பீயா
peeya	பியா	பீயா
pia	பியா	பியா
piaa	பியா	பியா
piia	பியா	பியா
piiaa	பியா	பியா
piiya	பியா	பியா
piya	பியா	பியா
piyaa	பியா	பியா
pirachurankalai	பிரசுரங்களை	பிரசுரங்களை
pirasurangalai	பிரசுரங்களை	பிரசுரங்களை
pirasurangkalai	பிரசுரங்களை	பிரசுரங்களை
prachurankalai	பிரசுரங்களை	பிரசுரங்களை
pirachuramaanathu	பிரசுரமானது	பிரசுரமானது
pirasuramaanathu	பிரசுரமானது	பிரசுரமானது
prachuramaanathu	பிரசுரமானது	பிரசுரமானது
prasuramaanathu	பிரசுரமானது	பிரசுரமானது
piradhaana	பிரதான	பிரதான
pirathaana	பிரதான	பிரதான
piradhaani	பிரதானி	பிரதானி
pirathaani	பிரதானி	பிரதானி
piraththyeaga	பிரத்யேக	பிரத்தியாக
pirathyaeka	பிரத்யேக	பிரதியேக
praththiyaeka	பிரத்யேக	பிரத்தியேக
bhrammatthin	பிரம்மத்தின்	பிரம்மத்தின்
biramatthin	பிரம்மத்தின்	பிரமத்தின்
pirammaththin	பிரம்மத்தின்	பிரம்மத்தின்
brammanin	பிரம்மனின்	பிராம்ணின்
pirammanin	பிரம்மனின்	பிரமம்னன்
brammanukku	பிரம்மனுக்கு	பிரம்மணுக்கு
pirammanukku	பிரம்மனுக்கு	பிரம்மனுக்கு
brahaman	பிரம்மன்	பிராமன்
brahamann	பிரம்மன்	பிராமன்
brahhman	பிரம்மன்	பிராஷ்
brahman	பிரம்மன்	பிராமன்
brahmun	பிரம்மன்	பிராமுன்
brahmuun	பிரம்மன்	பிராமன்
bramman	பிரம்மன்	பிராமன்
piramman	பிரம்மன்	பிரம்மன்
brush	பிரஷ்	பிரஸ்
fresh	பிரஷ்	பிரேஷ்
pirash	பிரஷ்	பிரசஸ்
prash	பிரஷ்	பிரஸ்
braamanar	பிராமணர்	பிராமனர்
piraamanar	பிராமணர்	பிராமனர்
praamanar	பிராமணர்	பிராமனர்
braamanargal	பிராமணர்கள்	பிராமனர்கள்
braamanarkal	பிராமணர்கள்	பிராமனர்கள்
piraamanarkal	பிராமணர்கள்	பிராமனர்கள்
praamanarkal	பிராமணர்கள்	பிராமனர்கள்
pirithadhu	பிரித்தது	பிரித்தது
piriththathu	பிரித்தது	பிரித்தது
priththathu	பிரித்தது	பிரித்தது
parant	பிறந்த	பாரண்ட்
perant	பிறந்த	பெரண்ட்
piaanta	பிறந்த	பியாண்டா
piraant	பிறந்த	பிராண்ட்
pirandha	பிறந்த	பிரந்த
piranta	பிறந்த	பிரண்ட
pirantha	பிறந்த	பிரந்த
pirandhadhum	பிறந்ததும்	பிரந்ததும்
piranthathum	பிறந்ததும்	பிரந்ததும்
pirandhadhai	பிறந்ததை	பிரந்ததை
piranthathai	பிறந்ததை	பிரந்ததை
pirandhavan	பிறந்தவன்	பிரந்தவன்
piranthavan	பிறந்தவன்	பிரந்தவன்
piranthaan	பிறந்தான்	பிரந்தான்
piranthaalum	பிறந்தாலும்	பிரந்தாலும்
piranthaal	பிறந்தால்	பிரந்தால்
pirarin	பிறரின்	பிரரின்
pirarum	பிறரும்	பிரரும்
pirarai	பிறரை	பிரரை
piravum	பிறவும்	பிரவும்
pirgaalach	பிற்காலச்	பிர்காலச்
pirkaalach	பிற்காலச்	பிர்காலச்
pirgaalaththil	பிற்காலத்தில்	பிர்காலத்தில்
pirkaalaththil	பிற்காலத்தில்	பிர்காலத்தில்
pirpaguthi	பிற்பகுதி	பிர்பகுதி
pirpakuthi	பிற்பகுதி	பிர்பக்துதி
pirpaguthiyil	பிற்பகுதியில்	பிற்பகுதியில்
pirpakuthiyil	பிற்பகுதியில்	பிற்பக்குதியில
filipinej	பிலிப்பைன்ஸ்	பிலிபின்ஸ்
filipines	பிலிப்பைன்ஸ்	பிலிபினஸ்
filipinez	பிலிப்பைன்ஸ்	பிலிபினேஸ்
filippines	பிலிப்பைன்ஸ்	பிலிப்பினஸ்
fillipinnez	பிலிப்பைன்ஸ்	பில்லிபின்ஸ்
philipines	பிலிப்பைன்ஸ்	பிலிபினஸ்
philipinez	பிலிப்பைன்ஸ்	பிலிபினேஸ்
philipinnez	பிலிப்பைன்ஸ்	பிலிபின்ன்
philippines	பிலிப்பைன்ஸ்	பிலிப்பினஸ்
phillipinez	பிலிப்பைன்ஸ்	பில்லிபினேஸ்
phillipinnej	பிலிப்பைன்ஸ்	பில்பிபின்ஸ்
phillipinnez	பிலிப்பைன்ஸ்	பில்லிபின்ஸ்
pilippains	பிலிப்பைன்ஸ்	பிளிப்பான்ஸ்
pilaikkum	பிழைக்கும்	பிளைக்கும்
pizhaikkum	பிழைக்கும்	பிழைக்கும்
pilaiyaana	பிழையான	பிளையான
pizhaiyaana	பிழையான	பிழையான
bisinas	பிஸினஸ்	பிசினஸ்
business	பிஸினஸ்	பிசினஸ்
pisinas	பிஸினஸ்	பிசினஸ்
beach	பீச்	பேச்
beaich	பீச்	பேக்
beaych	பீச்	பேச்
bech	பீச்	பேக்
beech	பீச்	பீக்
beechh	பீச்	பீச்
beich	பீச்	பெச்
beiich	பீச்	பெய்ச்
beych	பீச்	பெச்
bichh	பீச்	பிக்
biich	பீச்	பிக்
biichh	பீச்	பிச்
peach	பீச்	பேச்
pech	பீச்	பேக்
peech	பீச்	பீச்
pich	பீச்	பிக்
piich	பீச்	பிக்
fees	பீஸ்	பீஸ்
peace	பீஸ்	பேச்
peas	பீஸ்	பேஸ்
pees	பீஸ்	பீஸ்
peice	பீஸ்	பெய்க்
piece	பீஸ்	பீக்
pugalpetrtrathu	புகழ்பெற்றது	புகல்பெற்றது
pukalpetrtrathu	புகழ்பெற்றது	புகல்பெற்றது
pukalpettrathu	புகழ்பெற்றது	புகல்பெற்றது
pukazhpetrathu	புகழ்பெற்றது	புகழ்பெற்றது
pukazhpettrathu	புகழ்பெற்றது	புகழ்பெற்றது
pugalpetrtravar	புகழ்பெற்றவர்	புகல்பெற்றவர்
pukalpetrtravar	புகழ்பெற்றவர்	புகல்பெற்றவர்
pukalpettravar	புகழ்பெற்றவர்	புகல்பெற்றவர்
pukazhpetravar	புகழ்பெற்றவர்	புகழ்பெற்றவர்
pukazhpettravar	புகழ்பெற்றவர்	புகழ்பெற்றவர்
pugalpetrtru	புகழ்பெற்று	புகல்பெற்று
pukalpetrtru	புகழ்பெற்று	புகல்பெற்று
pukalpettru	புகழ்பெற்று	புகல்பெற்று
pukazhpetru	புகழ்பெற்று	புகழ்பெற்று
pukazhpettru	புகழ்பெற்று	புகழ்பெற்று
bookhari	புகாரி	பூகரி
bookharii	புகாரி	பூகரி
booqhari	புகாரி	பூகரி
bukhaari	புகாரி	புகாரி
bukhaarii	புகாரி	புகாரி
bukhari	புகாரி	புகரி
bukharii	புகாரி	புகரி
buqhaari	புகாரி	புகாரி
buqhari	புகாரி	புகரி
buqharii	புகாரி	புகாரி
buukhaari	புகாரி	புகாரி
buukhari	புகாரி	புகரி
buukharii	புகாரி	புகாரி
pokaari	புகாரி	போகாரி
pugaari	புகாரி	புகாரி
pukaari	புகாரி	புகாரி
pukari	புகாரி	புகரி
pujangal	புஜங்கள்	புஜங்கள்
pujankal	புஜங்கள்	புஜங்கள்
puduchcheariyin	புதுச்சேரியின்	புடுச்சேரியின்
puthuchchaeriyin	புதுச்சேரியின்	புதுச்சேறியின்
puthucheri	புதுச்சேரியின்	புதுசரி
padanggalil	புதுப்	படங்களில்
padankalil	புதுப்	படங்களில்
patankalil	புதுப்	படங்களில்
pudhumaiyaana	புதுமையான	புதுமையான
puthumaiyaana	புதுமையான	புதுமையான
pudhuvai	புதுவை	புதுவை
puthuvai	புதுவை	புதுவை
pudhaiththa	புதைத்த	புதைத்த
puthaiththa	புதைத்த	புதைத்த
buddha	புத்த	புத்த
budhdha	புத்த	புத்த
buththa	புத்த	புத்த
puththa	புத்த	புத்த
puththam	புத்தம்	புத்தம்
buddharukku	புத்தருக்கு	புத்தருக்கு
budhdharukku	புத்தருக்கு	புத்தருக்கு
buththarukku	புத்தருக்கு	புத்தருக்கு
puththaandu	புத்தாண்டு	புத்தாண்டு
punarvaalvu	புனர்வாழ்வு	புனர்வாள்வு
punarvaazhvu	புனர்வாழ்வு	புனர்வாள்வு
punidhargalin	புனிதர்களின்	புணிதர்களின்
punitharkalin	புனிதர்களின்	புணிதர்களின்
punae	புனே	புணே
pune	புனே	புணி
punea	புனே	புனே
punee	புனே	புணி
punii	புனே	புணி
puune	புனே	பூன்
puunee	புனே	புனி
punaeyil	புனேயில்	புணேயில்
puneayil	புனேயில்	புணியில்
puneiyl	புனேயில்	புணியில்
puneyil	புனேயில்	புணியில்
punaevil	புனேவில்	புணேவில்
puneavil	புனேவில்	புணேவில்
punevil	புனேவில்	புணேவில்
ciripputan	புன்	சிறிப்புடன்
pan	புன்	பான்
pon	புன்	போன்
pun	புன்	புன்
puun	புன்	பூன்
sirippudan	புன்	சிறிப்புடன்
purandu	புரண்டு	புரண்டு
puravi	புரவி	புரவி
kollaa	புரிந்து	கொலா
kollaalaam	புரிந்து	கொல்லாலம்
kollaatha	புரிந்து	கொள்ளாத
kollaavum	புரிந்து	கொல்லாவும்
kollalaam	புரிந்து	கொல்லாலம்
kollalam	புரிந்து	கொல்லாம்
kollata	புரிந்து	கொல்லாட்
kollavum	புரிந்து	கொல்வவும்
puribavargal	புரிபவர்கள்	புரிபவர்கள்
puriyum	புரியும்	புரியும்
purivadhai	புரிவதை	புரிவதை
purivathai	புரிவதை	புரிவதை
puruva	புருவ	புருவா
puruvam	புருவம்	புருவம்
pulampeyar	புலம்பெயர்	புலம்பெயர்
pulavargalaal	புலவர்களால்	புலவர்களால்
pulavarkalaal	புலவர்களால்	புலவர்களால்
pulavargalin	புலவர்களின்	புலவர்களின்
pulavarkalin	புலவர்களின்	புலவர்களின்
pulavargalil	புலவர்களில்	புலவர்களில்
pulavarkalil	புலவர்களில்	புலவர்களில்
pulavargalukku	புலவர்களுக்கு	புலவர்களுக்கு
pulavarkalukku	புலவர்களுக்கு	புலவர்களுக்கு
pulavargalum	புலவர்களும்	புலவர்களும்
pulavarkalum	புலவர்களும்	புலவர்களும்
bulet	புல்லட்	புலட்
bullat	புல்லட்	புல்டாட்
bullet	புல்லட்	பால்ட்
buulet	புல்லட்	பாலட்
buullet	புல்லட்	பால்ட்
pullad	புல்லட்	புல்லட்
pullat	புல்லட்	புல்லாட்
blue	புளூ	புலி
puloo	புளூ	புலோ
puluu	புளூ	புலு
puvikku	புவிக்கு	புவிக்கு
puviyin	புவியின்	புவியின்
puviyil	புவியில்	புவியில்
bushkar	புஷ்கர்	புஸ்கர்
pushkar	புஷ்கர்	புஸ்கர்
puskar	புஷ்கர்	புஸ்கர்
pusqar	புஷ்கர்	புஸ்கர்
puuskar	புஷ்கர்	பூஸ்கர்
pooshkin	புஷ்கின்	பூஸ்கின்
pooskin	புஷ்கின்	பூஸ்கின்
poosqin	புஷ்கின்	பூஸ்கின்
pushkeen	புஷ்கின்	புஸ்கேன்
pushkin	புஷ்கின்	புஸ்கின்
pushkinn	புஷ்கின்	புஷ்கின்
puskeen	புஷ்கின்	புஸ்கின்
puskiin	புஷ்கின்	புஸ்கின்
puskin	புஷ்கின்	புஸ்கின்
puskinn	புஷ்கின்	புஸ்கின்
pusqeen	புஷ்கின்	புஸ்கின்
pusqin	புஷ்கின்	புஸ்கின்
pusqinn	புஷ்கின்	புஸ்கின்
puuskeen	புஷ்கின்	புஸ்கின்
puuskin	புஷ்கின்	பாஸ்கின்
puuskinn	புஷ்கின்	பாஸ்கின்
bookambam	பூகம்பம்	பூகம்பம்
poogambam	பூகம்பம்	பூகம்பம்
pookambam	பூகம்பம்	பூகம்பம்
puukambam	பூகம்பம்	பூகம்பம்
puukampam	பூகம்பம்	பூகம்பம்
poojya	பூஜ்ய	பூஜியா
puujya	பூஜ்ய	பூஜ்யா
poojyam	பூஜ்யம்	பூஜியம்
puujiyam	பூஜ்யம்	பூஜியம்
puujyam	பூஜ்யம்	பூஜ்யம்
poonagari	பூநகரி	பூணகரி
poonakari	பூநகரி	பூணகரி
puunagari	பூநகரி	புணகரி
puunakari	பூநகரி	புணகரி
poonaigalai	பூனைகளை	பூணைகளை
poonaikalai	பூனைகளை	பூணைகளை
puunaigalai	பூனைகளை	பூணைகளை
puunaikalai	பூனைகளை	பூணைகளை
poonaigal	பூனைகள்	பூணைகள்
poonaikal	பூனைகள்	பூணைகள்
puunaigal	பூனைகள்	பூணைகள்
puunaikal	பூனைகள்	பூணைகள்
poonaiyai	பூனையை	பூணையை
poonaiyei	பூனையை	பூணையை
poorna	பூர்ணா	பூர்னா
poornaa	பூர்ணா	பூர்னா
puurnaa	பூர்ணா	பூர்னா
poolae	பூலே	பூலே
puulae	பூலே	பூலே
poolai	பூளை	பூலை
puulai	பூளை	பூலை
pennukku	பெண்ணுக்கு	பெண்ணுக்கு
pennnudan	பெண்ணுடன்	பெண்ணுடன்
pennudan	பெண்ணுடன்	பெண்ணுடன்
pennum	பெண்ணும்	பெண்ணும்
penmani	பெண்மணி	பெண்மனி
penmanigal	பெண்மணிகள்	பெண்மனிகள்
penmanikal	பெண்மணிகள்	பெண்மனிக்கள்
penmaniyaaga	பெண்மணியாக	பெண்மனியாக
penmaniyaaka	பெண்மணியாக	பெண்மனியாக
penmaniyin	பெண்மணியின்	பெண்மனியின்
penmaniyum	பெண்மணியும்	பெண்மனியும்
peyarum	பெயரும்	பெயரும்
peyarchchi	பெயர்ச்சி	பெயர்ச்சி
periyavan	பெரியவன்	பெரியவன்
periyavar	பெரியவர்	பெரியவர்
periyavargalukku	பெரியவர்களுக்கு	பெரியவர்களுக்கு
periyavargal	பெரியவர்கள்	பெரியவர்கள்
periyavai	பெரியவை	பெரியவை
periyoar	பெரியோர்	பெரியோர்
periyor	பெரியோர்	பெரியோர்
perugiya	பெருகிய	பெருகிய
perukiya	பெருகிய	பெருகிய
perumidham	பெருமிதம்	பெருமிதம்
perumitham	பெருமிதம்	பெருமிதம்
bart	பெர்ட்	பார்ட்
bert	பெர்ட்	பெர்ட்
paerd	பெர்ட்	பேர்ட்
bay	பே	பே
bee	பே	பே
beei	பே	பே
bei	பே	பெ
beii	பே	பெய்
faie	பே	பே
faye	பே	பே
fayee	பே	பே
pee	பே	பீ
phaye	பே	பே
paechupavar	பேசுபவர்	பேசுபவர்
paesubavar	பேசுபவர்	பேசுபவர்
pesupavar	பேசுபவர்	பேசுபவர்
paenalgal	பேனல்கள்	பேணல்கள்
paenalkal	பேனல்கள்	பேணல்கள்
peanalkal	பேனல்கள்	பேணல்கள்
penalkal	பேனல்கள்	பெணல்கள்
paep	பேப்	பேப்
pap	பேப்	பாப்
peap	பேப்	பேப்
peep	பேப்	பீப்
pep	பேப்	பெப்
bearaasiriyarin	பேராசிரியரின்	பேராசிரியரின்
paeraasiriyarin	பேராசிரியரின்	பேராசிரியரின்
pearaasiriyarin	பேராசிரியரின்	பேராசிரியரின்
paerunthil	பேருந்தில்	பேருந்தில்
pearunthil	பேருந்தில்	பேருந்தில்
perunthil	பேருந்தில்	பெருந்தில்
beal	பேல்	பேல்
bel	பேல்	பெல்
pael	பேல்	பேல்
pel	பேல்	பெல்
bealai	பேழை	பேலை
paelai	பேழை	பேலை
pelai	பேழை	பெலை
pezhai	பேழை	பெழை
paelaiyil	பேழையில்	பேலையில்
paezhaiyil	பேழையில்	பேழையில்
pezhaiyil	பேழையில்	பெழையில்
paigalai	பைகளை	பைகளை
paikalai	பைகளை	பைக்லா
podhunala	பொதுநல	பொதுநல
pothunala	பொதுநல	பொதுநலல
podhuvudamai	பொதுவுடமை	பொதுவுடமை
pothuvudamai	பொதுவுடமை	பொதுவுடமை
ponnai	பொன்னை	பொன்னை
pori	பொரி	போரி
porikkum	பொரிக்கும்	பொரிக்கும்
poriththa	பொரித்த	பொரித்த
ubayoagangkal	பொருட்கள்	உபயோகங்கள்
ubayoakangkal	பொருட்கள்	உபயோகங்கள்
upayokankal	பொருட்கள்	உபயோகங்கள்
poruththappatta	பொருத்தப்பட்ட	பொருத்தப்பட்ட
poruththappattulla	பொருத்தப்பட்டுள்ள	பொருத்தப்பட்டுள்ள
poruththappatulla	பொருத்தப்பட்டுள்ள	பொருத்தப்பட்டுள்ள
porundhakkoodiya	பொருந்தக்கூடிய	பொருந்தக்கூடிய
porundhdhakkoodiya	பொருந்தக்கூடிய	பொருந்தக்கூடிய
porunthakkoodiya	பொருந்தக்கூடிய	பொருந்தக்கூடிய
porundhaadha	பொருந்தாத	பொருந்தாத
porundhdhaadha	பொருந்தாத	பொருந்தாத
porunthaatha	பொருந்தாத	பொருந்தாத
porundhum	பொருந்தும்	பொருந்தும்
porunthum	பொருந்தும்	பொருந்தும்
porulaagavea	பொருளாகவே	பொருளாகவே
porulaakavae	பொருளாகவே	பொருளாகவே
porulukku	பொருளுக்கு	பொருளுக்கு
porulukkum	பொருளுக்கும்	பொருளுக்கும்
poraamaiyum	பொறாமையும்	பொராமையும்
poriththa	பொறித்த	பொரித்த
porimuraiyil	பொறிமுறையில்	பொரிமுறையில்
poriyiyal	பொறியியல்	பொரியியல்
poruththa	பொறுத்த	பொருத்த
poruththal	பொறுத்தல்	பொருத்தல்
poruththae	பொறுத்தே	பொருத்தே
poruththe	பொறுத்தே	பொருத்தே
poruththea	பொறுத்தே	பொருத்தே
poruppaettraar	பொறுப்பேற்றார்	பொருப்பேற்றார்
poruppetraar	பொறுப்பேற்றார்	பொருப்பெற்றார்
poruppettraar	பொறுப்பேற்றார்	பொருப்பெற்றார்
porupeattrullar	பொறுப்பேற்றுள்ளார்	பொருப்பெற்றுள்ளார்
poruppaettrullaar	பொறுப்பேற்றுள்ளார்	பொருப்பேற்றுள்ளார்
poruppetrullaar	பொறுப்பேற்றுள்ளார்	பொருப்பெற்றுள்ளார்
poakka	பொழுது	போக்கா
poluthu	பொழுது	பொழுது
pozhudhu	பொழுது	பொழுது
pozhuthu	பொழுது	பொழுது
poluthupokkukku	பொழுதுபோக்குக்கு	பொழுதுபோக்குக்கு
poluthupookkukku	பொழுதுபோக்குக்கு	பொலுத்புகோக்கு
pozhudhupoakkuk	பொழுதுபோக்குக்கு	பொழுதுபோக்குக்
baus	பொஸ்	பாஸ்
bauus	பொஸ்	பாஸ்
bos	பொஸ்	போஸ்
boss	பொஸ்	பாஸ்
bous	பொஸ்	போஸ்
bouus	பொஸ்	போஸ்
paoos	பொஸ்	பூஸ்
bogach	போகச்	பாகச்
poagach	போகச்	போகச்
pogach	போகச்	போகச்
pokach	போகச்	போகச்
poagath	போகத்	போகத்
pogath	போகத்	போகத்
pokath	போகத்	போகத்
bhoagam	போகம்	போகம்
boagam	போகம்	போகம்
bogam	போகம்	போகம்
bhoagar	போகர்	போகர்
boagar	போகர்	போகர்
bogar	போகர்	போகர்
poagavae	போகவே	போகவே
poagavea	போகவே	போகவே
pogave	போகவே	போகவே
poagaamal	போகாமல்	போகாமல்
poakkaaga	போக்காக	போக்காக
poakkaaha	போக்காக	போக்காக
poakkuvaraththin	போக்குவரத்தின்	போக்குவரத்தின்
poakkuvaraththirku	போக்குவரத்திற்கு	போக்குவரத்திற்கு
boassu	போசு	போஸ்
poasu	போசு	போசு
boadi	போடி	போடி
poadi	போடி	போடி
poattigalin	போட்டிகளின்	போட்டிகளின்
poattikalin	போட்டிகளின்	போட்டிகளின்
poattigalilum	போட்டிகளிலும்	போட்டிகளிலும்
poattikalilum	போட்டிகளிலும்	போட்டிகளிலும்
poattigalil	போட்டிகளில்	போட்டிகளில்
poattikalil	போட்டிகளில்	போட்டிகளில்
poattigalukkaana	போட்டிகளுக்கான	போட்டிகளுக்கான
poattikalukkaana	போட்டிகளுக்கான	போட்டிகளுக்கான
poattigalukku	போட்டிகளுக்கு	போட்டிகளுக்கு
poattikalukku	போட்டிகளுக்கு	போட்டிகளுக்கு
poattigalum	போட்டிகளும்	போட்டிகளும்
poattigalaiyuim	போட்டிகளையும்	போட்டிகளையும்
poattigalaiyum	போட்டிகளையும்	போட்டிகளையும்
poattikalaiyum	போட்டிகளையும்	போட்டிகளையும்
poattigal	போட்டிகள்	போட்டிகள்
poattikal	போட்டிகள்	போட்டிகள்
poattikku	போட்டிக்கு	போட்டிக்கு
poattith	போட்டித்	போட்டித்
tervil	போட்டித்	தெர்வில்
thaervil	போட்டித்	தேர்வில்
poattiyaaga	போட்டியாக	போட்டியாக
poattiyaaka	போட்டியாக	போட்டியாக
poattiyaalarkalin	போட்டியாளர்களின்	போட்டியாளர்களின்
poattiyalargalin	போட்டியாளர்களின்	போட்டியலர்களின்
poattiyaalargalai	போட்டியாளர்களை	போட்டியாளர்களை
poattiyaalarkalai	போட்டியாளர்களை	போட்டியாளர்களை
poattiyilirindhu	போட்டியிலிருந்து	போட்டியிலிருந்து
poattiyilirunthu	போட்டியிலிருந்து	போட்டியிலிருந்து
poattiyum	போட்டியும்	போட்டியும்
poattiayai	போட்டியை	போட்டியாய்
poattiyai	போட்டியை	போட்டியை
poattiyei	போட்டியை	போட்டியே
poattiyaith	போட்டியைத்	போட்டியைத்
poattiyeith	போட்டியைத்	போட்டியெத்
poathellaam	போதெல்லாம்	போதல்லாம்
poandrathu	போன்றது	போன்றது
poantrathu	போன்றது	போன்றது
poandravar	போன்றவர்	போன்றவர்
poantravar	போன்றவர்	போன்றவர்
poandravarkalukku	போன்றவர்களுக்கு	போன்றவர்களுக்கு
poantravargalukku	போன்றவர்களுக்கு	போன்றவர்களுக்கு
poantravarkalukku	போன்றவர்களுக்கு	போன்றவர்களுக்கு
poandravarkal	போன்றவர்கள்	போன்றவர்கள்
poanravarkal	போன்றவர்கள்	போன்றவர்கள்
poantravargal	போன்றவர்கள்	போன்றவர்கள்
poantravarkal	போன்றவர்கள்	போன்றவர்கள்
poandrum	போன்றும்	போன்றும்
poanrum	போன்றும்	போன்றும்
poantrum	போன்றும்	போன்றும்
poandrae	போன்றே	போன்றே
poanrae	போன்றே	போன்றே
poantrae	போன்றே	போன்றே
bauing	போயிங்	பாங்
bauuing	போயிங்	பாங்
boaing	போயிங்	போன்
boaying	போயிங்	போயிங்
boeengs	போயிங்	பீங்ஸ்
boeing	போயிங்	பாயங்
boiings	போயிங்	பாயங்ஸ்
boing	போயிங்	பாங்
booeengs	போயிங்	பூங்ஸ்
booeing	போயிங்	பூயங்
poaying	போயிங்	போயிங்
poayina	போயின	போயின
poyina	போயின	போயினா
poarkkaala	போர்க்கால	போர்க்கால
poarkkaalaththil	போர்க்காலத்தில்	போர்க்காலத்தில்
board	போர்ட்	போர்ட்
ford	போர்ட்	போர்ட்
poard	போர்ட்	போர்ட்
poart	போர்ட்	போர்ட்
poord	போர்ட்	போர்ட்
poort	போர்ட்	போர்ட்
port	போர்ட்	போர்ட்
poalak	போலக்	போலக்
polak	போலக்	போலக்
poalirukkum	போலிருக்கும்	போலிருக்கும்
polirukkum	போலிருக்கும்	பொலிருக்கும்
poalum	போலும்	போலும்
polum	போலும்	போலும்
bole	போலே	பால்
bolee	போலே	பாலி
boole	போலே	பூல்
fole	போலே	பால்
folee	போலே	போலி
foleey	போலே	பாலி
folei	போலே	பாலி
foley	போலே	பாலி
foli	போலே	பாலி
folii	போலே	பாலி
foole	போலே	போல்
foolee	போலே	போலி
fooley	போலே	பூலி
fooli	போலே	பூலி
foolii	போலே	பூலி
phole	போலே	போல்
pholee	போலே	போலி
pholey	போலே	பாலி
pholi	போலே	பாலி
pholii	போலே	போலி
poalae	போலே	போலே
poale	போலே	போல்
polae	போலே	போலே
poolee	போலே	பூலி
magalaai	மகளாய்	மகலாய்
magalaay	மகளாய்	மகலாய்
makalaai	மகளாய்	மகலாய்
makalaay	மகளாய்	மகலாய்
magalaiyum	மகளையும்	மகலையும்
makalaiyum	மகளையும்	மகலையும்
magaaraajan	மகாராஜன்	மகாராஜன்
mahaaraajan	மகாராஜன்	மகாராஜன்
maharajan	மகாராஜன்	மகாராஜன்
makaaraajan	மகாராஜன்	மகாராஜன்
magaalingam	மகாலிங்கம்	மகாலிங்கம்
magaalingkam	மகாலிங்கம்	மகாலிங்கம்
mahalingam	மகாலிங்கம்	மகாலிங்கம்
makaalingam	மகாலிங்கம்	மகாலிங்கம்
makaalingkam	மகாலிங்கம்	மகாலிங்கம்
magaal	மகால்	மகால்
mahal	மகால்	மகால்
makaal	மகால்	மகால்
magimai	மகிமை	மகிமை
makimai	மகிமை	மக்கிமை
magilchchiyai	மகிழ்ச்சியை	மகில்ச்சியை
makilchchiyai	மகிழ்ச்சியை	மகிழ்ச்சியை
makizhchchiyai	மகிழ்ச்சியை	மகிழ்ச்சியை
magilchchiyaiyum	மகிழ்ச்சியையும்	மகில்ச்சியையும்
makilchchiyaiyum	மகிழ்ச்சியையும்	மகில்ச்சியையும்
makizhchchiyaiyum	மகிழ்ச்சியையும்	மகிழ்ச்சியையும்
magilchchiyoadu	மகிழ்ச்சியோடு	மகில்ச்சியோடு
makilchchiyoadu	மகிழ்ச்சியோடு	மகில்ச்சியோடு
makizhchchiyoadu	மகிழ்ச்சியோடு	மகிழ்ச்சியோடு
maheshvari	மகேஸ்வரி	மகேஷ்வரி
maheswari	மகேஸ்வரி	மகேஸ்வரி
makaesvari	மகேஸ்வரி	மகேஸ்வரி
makkiya	மக்கிய	மக்கியா
maggum	மக்கும்	மக்கும்
makkum	மக்கும்	மக்கும்
machuuthi	மசூதி	மசுதி
masoodi	மசூதி	மசோடி
masoothi	மசூதி	மசோதி
masuthi	மசூதி	மசுதி
masuuthi	மசூதி	மசுதி
machuuthiukal	மசூதிகள்	மசுதியுகள்
masoothigal	மசூதிகள்	மசூதிகள்
masoothikal	மசூதிகள்	மசூதிகள்
masuthigal	மசூதிகள்	மசுதிகள்
masuuthigal	மசூதிகள்	மசுதிகள்
machuuthiyil	மசூதியில்	மச்துதியில்
masoothiyil	மசூதியில்	மசூதியில்
masuthiyil	மசூதியில்	மசுதியில்
masuuthiyil	மசூதியில்	மசுதியில்
madanthai	மடந்தை	மடந்தை
matanthai	மடந்தை	மடந்தை
madaalayam	மடாலயம்	மடாலயம்
mataalayam	மடாலயம்	மடாலாயம்
mattumae	மட்டுமே	மட்டுமே
manakka	மணக்க	மனக்க
manakkaal	மணக்கால்	மனக்கால்
manappathu	மணப்பது	மனப்பது
manamurivu	மணமுறிவு	மனமுரிவு
maninaera	மணிநேர	மனினேற
maninera	மணிநேர	மனினர்
maninaerangal	மணிநேரங்கள்	மணினேறங்கள்
maninaeranggal	மணிநேரங்கள்	மணினேறங்கள்
maninerangkal	மணிநேரங்கள்	மணினர்கங்கள்
maninaeraththirku	மணிநேரத்திற்கு	மணினேறத்திற்கு
manineraththirku	மணிநேரத்திற்கு	மணினரரத்திற்கு
maninaeram	மணிநேரம்	மனினேறம்
manineram	மணிநேரம்	மனினேரம்
manimuththaaru	மணிமுத்தாறு	மனிமுத்தாரு
manimuththaru	மணிமுத்தாறு	மனிமுத்தரு
manneeral	மண்ணீரல்	மன்னீரல்
manneeril	மண்ணீரல்	மன்னீரில்
madhar	மதர்	மதார்
mathar	மதர்	மதர்
mother	மதர்	மோதர்
madhurakavi	மதுரகவி	மதுரகவவி
madurakavi	மதுரகவி	மடுராகவி
mathurakavi	மதுரகவி	மதுரகவவி
maddhiyath	மத்தியத்	மத்தியத்
maththiyath	மத்தியத்	மத்தியத்
mandhamaaga	மந்தமாக	மந்தமாக
manthamaaga	மந்தமாக	மந்தமாக
manthamaaka	மந்தமாக	மந்தமாக
mandhar	மந்தர்	மந்தர்
manthar	மந்தர்	மந்தர்
manaaluththam	மனஅழுத்தம்	மனாளுத்தம்
manaalzhuththam	மனஅழுத்தம்	மனாள்ளுத்தம்
manaazhuththam	மனஅழுத்தம்	மனாழுத்தம்
manathoadu	மனதோடு	மனதோது
manappaadam	மனப்பாடம்	மனப்பாடம்
manam	மனம்	மனம்
manaigalil	மனைகளில்	மணைகளில்
manaikalil	மனைகளில்	மனைகளில்
manaiyil	மனையில்	மனையில்
mannarai	மன்னரை	மன்னரை
marakkattai	மரக்கட்டை	மரக்கட்டை
marakattaigalai	மரக்கட்டைகளை	மரகட்டைகளை
marakkattaikalai	மரக்கட்டைகளை	மரக்கட்டைகளை
maraththinaal	மரத்தினால்	மரத்தினால்
maraththin	மரத்தின்	மரத்தின்
marabuvali	மரபுவழி	மரபுவலி
marabuvazhi	மரபுவழி	மரபுவழி
maravalli	மரவள்ளி	மரவல்லி
mariyannai	மரியன்னை	மரியன்ணை
mariina	மரீனா	மரினா
mariinaa	மரீனா	மரினா
marina	மரீனா	மரினா
marinaa	மரீனா	மரினா
maru	மரு	மாரு
marukkal	மருக்கள்	மருக்கள்
maruththuvamanaigalukku	மருத்துவமனைகளுக்கு	மருத்துவமனைகளுக்கு
maruththuvamanaikalukku	மருத்துவமனைகளுக்கு	மருத்துவமனைகளுக்கு
maruththuvamanaikku	மருத்துவமனைக்கு	மருத்துவமானைக்கு
maruththuvamanaiyaaga	மருத்துவமனையாக	மருத்துவமானையாக
maruththuvamanaiyaaka	மருத்துவமனையாக	மருத்துவமானையாக
maruththuvamanaiyin	மருத்துவமனையின்	மருத்துவமணையின்
maruththuvamanaiyil	மருத்துவமனையில்	மருத்துவமணையில்
marundhae	மருந்தே	மருந்தே
marunthae	மருந்தே	மருந்தே
marunththae	மருந்தே	மருந்தே
marukkappatta	மறுக்கப்பட்ட	மருக்கப்பட்ட
marukkum	மறுக்கும்	மருக்கும்
maraivaal	மறைவால்	மறைவால்
matravar	மற்றவர்	மற்றவர்
matrtravar	மற்றவர்	மற்றவர்
mattravar	மற்றவர்	மற்றவர்
matravargalaal	மற்றவர்களால்	மற்றவர்களால்
matrtravargalaal	மற்றவர்களால்	மற்றவர்களால்
matrtravarkalaal	மற்றவர்களால்	மற்றவர்களால்
mattravarkalaal	மற்றவர்களால்	மற்றவர்களால்
matravargalukku	மற்றவர்களுக்கு	மற்றவர்களுக்கு
matrtravargalukku	மற்றவர்களுக்கு	மற்றவர்களுக்கு
matrtravarkalukku	மற்றவர்களுக்கு	மற்றவர்களுக்கு
mattravarkalukku	மற்றவர்களுக்கு	மற்றவர்களுக்கு
matravargalukkum	மற்றவர்களுக்கும்	மற்றவர்களுக்கும்
matrtravargalukkum	மற்றவர்களுக்கும்	மற்றவர்களுக்கும்
matrtravarkalukkum	மற்றவர்களுக்கும்	மற்றவர்களுக்கும்
mattravarkalukkum	மற்றவர்களுக்கும்	மற்றவர்களுக்கும்
matravargaludan	மற்றவர்களுடன்	மற்றவர்களுடன்
matrtravargaludan	மற்றவர்களுடன்	மற்றவர்களுடன்
matrtravarkaludan	மற்றவர்களுடன்	மற்றவர்களுடன்
mattravarkaludan	மற்றவர்களுடன்	மற்றவர்களுடன்
matravargalai	மற்றவர்களை	மற்றவர்களை
matrtravargalai	மற்றவர்களை	மற்றவர்களை
matrtravarkalai	மற்றவர்களை	மற்றவர்களை
mattravarkalai	மற்றவர்களை	மற்றவர்களை
matravargalaip	மற்றவர்களைப்	மற்றவர்களைப்
matrtravargalaip	மற்றவர்களைப்	மற்றவர்களைப்
matrtravarkalaip	மற்றவர்களைப்	மற்றவர்களைப்
mattravarkalaip	மற்றவர்களைப்	மற்றவர்களைப்
malattu	மலட்டு	மலட்டு
malarin	மலரின்	மலரின்
malaril	மலரில்	மலரில்
malarai	மலரை	மலரை
indraiya	மலர்	இன்றைய
inraiya	மலர்	இன்றைய
intraiya	மலர்	இன்றைய
malargalaal	மலர்களால்	மலர்களால்
malarkalaal	மலர்களால்	மலர்களால்
malargalin	மலர்களின்	மலர்களின்
malarkalin	மலர்களின்	மலர்களின்
malargalai	மலர்களை	மலர்களை
malarkalai	மலர்களை	மலர்களை
malargal	மலர்கள்	மலர்கள்
malarkal	மலர்கள்	மலர்கள்
malivaaga	மலிவாக	மலிவாக
malivaaka	மலிவாக	மலிவாக
maadangal	மாடங்கள்	மாடங்கள்
maadangkal	மாடங்கள்	மாடங்கள்
maatangkal	மாடங்கள்	மாடங்கள்
maadaththil	மாடத்தில்	மாடத்தில்
maataththil	மாடத்தில்	மாடத்தில்
maadam	மாடம்	மாடம்
maatam	மாடம்	மாடம்
maanikkak	மாணிக்கக்	மாணிக்கக்
manickkak	மாணிக்கக்	மணிக்கக்
maan	மாண்	மான்
maann	மாண்	மான்
maadhiriyaaga	மாதிரியாக	மாதிரியாக
maadhiriyaaka	மாதிரியாக	மாதிரியாக
maathiriyaaga	மாதிரியாக	மாதிரியாக
maathiriyaaka	மாதிரியாக	மாதிரியாக
maarkandaeya	மார்க்கண்டேய	மார்க்கண்டேய
maarkkandaeya	மார்க்கண்டேய	மார்க்கண்டேய
markandeya	மார்க்கண்டேய	மர்க்கண்டியா
markkandaeya	மார்க்கண்டேய	மர்க்கண்டேய
maarkkandaeyan	மார்க்கண்டேயன்	மார்க்கண்டேயன்
markandeyan	மார்க்கண்டேயன்	மர்க்கண்டியன்
maarban	மார்பன்	மார்பன்
maarpin	மார்பன்	மார்பின்
maarbil	மார்பில்	மார்பில்
maarpil	மார்பில்	மார்பில்
maaraagak	மாறாகக்	மாராகக்
maaraakak	மாறாகக்	மாராகக்
maaraagath	மாறாகத்	மாராகத்
maaraakath	மாறாகத்	மாராகத்
maattramadaintha	மாற்றமடைந்து	மாற்றமடைந்த
maattramadainthu	மாற்றமடைந்து	மாற்றமடைந்து
mattramadaindhu	மாற்றமடைந்து	மற்றமாடைந்து
maattru	மாற்று	மாற்று
maatrtruk	மாற்றுக்	மாற்றுக்
maattruk	மாற்றுக்	மாற்றுக்
maattruch	மாற்றுச்	மாற்றுச்
maatrum	மாற்றும்	மாற்றும்
maattrum	மாற்றும்	மாற்றும்
maalaimurasu	மாலைமுரசு	மாலைமுறசு
malaimurasu	மாலைமுரசு	மலைமுரசு
maalaiyilum	மாலையிலும்	மாலையிலும்
maalaiyil	மாலையில்	மாலையில்
maalaiyaiyum	மாலையையும்	மாலையையும்
maaligai	மாளிகை	மாலிகை
maalikai	மாளிகை	மாலிகை
maaligaigal	மாளிகைகள்	மாலிகைகள்
maalikaikal	மாளிகைகள்	மாலிகைகள்
maaligaikkul	மாளிகைக்குள்	மாலிகைக்குள்
maalikaikkul	மாளிகைக்குள்	மாலிகைக்குள்
maaligaiyin	மாளிகையின்	மாலிகையின்
maalikaiyin	மாளிகையின்	மாலிகையின்
maaligaiyai	மாளிகையை	மாலிகையை
maalikaiyai	மாளிகையை	மாலிகையை
maavilakku	மாவிளக்கு	மாவிலக்கு
maavoa	மாவோ	மாவோ
maavoo	மாவோ	மாவோ
mao	மாவோ	மோ
maoo	மாவோ	மோ
maoow	மாவோ	மோவ்
maov	மாவோ	மோவ்
maow	மாவோ	மோவ்
mau	மாவோ	மா
mavoo	மாவோ	மவோ
maavoavin	மாவோவின்	மாவோவின்
maavoovin	மாவோவின்	மாவூவின்
maasgoa	மாஸ்கோ	மாஸ்கோ
maaskoa	மாஸ்கோ	மாஸ்கோ
maaskoo	மாஸ்கோ	மாஸ்கோ
maskoo	மாஸ்கோ	மஸ்கோ
moosccoov	மாஸ்கோ	மூச்கோவ்
mooscoo	மாஸ்கோ	மோச்கோ
mooscoow	மாஸ்கோ	மூச்வு
mosccov	மாஸ்கோ	மாஸ்க்
mosccow	மாஸ்கோ	மாஸ்கோ
moscoo	மாஸ்கோ	மோச்கோ
moscov	மாஸ்கோ	மாஸ்கவ
moscow	மாஸ்கோ	மாஸ்கோ
moscu	மாஸ்கோ	மாஸ்கு
maaskoavil	மாஸ்கோவில்	மாஸ்கோவில்
maaskoovil	மாஸ்கோவில்	மாஸ்கூவில்
massgoavil	மாஸ்கோவில்	மஸ்கோவில்
moscowil	மாஸ்கோவில்	மாச்சில்
mikka	மிக்க	மிக்கா
mikkadhaaga	மிக்கதாக	மிக்கதாக
mikkathaaka	மிக்கதாக	மிக்கதாக
mikku	மிக்கு	மிக்கு
michchigan	மிச்சிகன்	மிச்சிகன்
michigan	மிச்சிகன்	மிக்கிகன்
midhakkum	மிதக்கும்	மிதக்கும்
mithakkum	மிதக்கும்	மிதக்கும்
midhappu	மிதப்பு	மிதப்பு
mithappu	மிதப்பு	மிதப்பு
midhavaadha	மிதவாத	மிதவாத
mithavaatha	மிதவாத	மிதவாத
midhilai	மிதிலை	மித்லிலை
mithilai	மிதிலை	மித்திலை
miyaanmar	மியான்மர்	மியான்மர்
myanmar	மியான்மர்	மியன்மர்
meov	மியாவ்	மேவ்
meow	மியாவ்	மோவ்
mev	மியாவ்	மேவ்
meva	மியாவ்	மேவா
mew	மியாவ்	மேவ்
mewa	மியாவ்	மேவா
meyaavu	மியாவ்	மெயாவு
miev	மியாவ்	மீவ்
miew	மியாவ்	மீவ்
miyaav	மியாவ்	மியாவ்
miyav	மியாவ்	மியாவ்
mirsaa	மிர்ஸா	மிர்சா
mirshaa	மிர்ஸா	மிர்ஷா
mirzaa	மிர்ஸா	மிர்சா
milagu	மிளகு	மிலகு
milaku	மிளகு	மிலகு
mee	மீ	மே
mie	மீ	மீ
mii	மீ	மி
miie	மீ	மீ
meenavargalin	மீனவர்களின்	மீனவர்களின்
meenavarkalin	மீனவர்களின்	மீனவர்களின்
meenavargal	மீனவர்கள்	மீனவர்கள்
meenavarkal	மீனவர்கள்	மீனவர்கள்
meena	மீனா	மீனா
meenaa	மீனா	மீனா
mena	மீனா	மேனா
miina	மீனா	மினா
miinaa	மீனா	மினா
mina	மீனா	மினா
meengalil	மீன்களில்	மீங்களில்
meenkalil	மீன்களில்	மீன்களில்
meengalum	மீன்களும்	மீங்களும்
meenkalum	மீன்களும்	மீங்களும்
meengalai	மீன்களை	மீங்களை
meenkalai	மீன்களை	மீன்களை
meengalaik	மீன்களைக்	மீங்களைக்
meenkalaik	மீன்களைக்	மீன்களைக்
meara	மீரா	மேர
meera	மீரா	மேர
meeraa	மீரா	மீரா
meiira	மீரா	மேர
meira	மீரா	மேர
miira	மீரா	மிரா
miiraa	மீரா	மீரா
mira	மீரா	மிரா
miraa	மீரா	மிரா
meeraan	மீரான்	மீரான்
meeran	மீரான்	மீரன்
meelaad	மீலாத்	மீலாட்
meelaath	மீலாத்	மீலாத்
mugam	முகம்	முகம்
mukam	முகம்	முகம்
thaan	முகம்	தான்
muguntha	முகுந்த	முகுந்த
mukunda	முகுந்த	முகுண்டா
mukundha	முகுந்த	முகுந்த
mukundhdha	முகுந்த	முகுந்த
mukuntha	முகுந்த	முகுந்த
thiruththum	முடி	திருத்தும்
tiruttum	முடி	திருட்டும்
mudigaludan	முடிகளுடன்	முடிகளுடன்
mudikaludan	முடிகளுடன்	முடிகளுடன்
mudigalum	முடிகளும்	முடிகளும்
mudikalum	முடிகளும்	முடிகளும்
mudigalai	முடிகளை	முடிகளை
mudikalai	முடிகளை	முடிகளை
mudigal	முடிகள்	முடிகள்
mudikal	முடிகள்	முடிகள்
boadhu	முடிக்கும்	போது
poadhu	முடிக்கும்	போது
poathu	முடிக்கும்	போது
potu	முடிக்கும்	போட்டு
mudindhdhana	முடிந்தன	முடிந்தன
mudinthana	முடிந்தன	முடிந்தன
mudiyaamal	முடியாமல்	முடியாமல்
mudiyaamai	முடியாமை	முடியாமை
mudiyin	முடியின்	முடியின்
mudiyil	முடியில்	முடியில்
mudiyai	முடியை	முடியை
mudivadaiyum	முடிவடையும்	முடிவடையும்
mudivin	முடிவின்	முடிவின்
mudivilum	முடிவிலும்	முடிவிலும்
mudivae	முடிவே	முடிவே
muthanilai	முதனிலை	முத்தாலிலை
muthalamaichchar	முதலமைச்சர்	முதலமைச்சர்
muthalamaichchargal	முதலமைச்சர்கள்	முதலமைச்சர்கள்
muthalamaichcharkal	முதலமைச்சர்கள்	முதலமைச்சர்ச்
muthaluthavi	முதலுதவி	முதலுதவி
muthaludhavip	முதலுதவிப்	முதலுதவிப்
muthaluthavip	முதலுதவிப்	முதலுதவிப்
munaivadhaaga	முனைவதாக	முனைவதாக
munaivathaaka	முனைவதாக	முனைவதாக
munnani	முன்னணி	முன்னனி
munnaniyil	முன்னணியில்	முன்னனியில்
munnaniyum	முன்னணியும்	முன்னனியும்
munnarae	முன்னரே	முன்னரே
padugindrana	முன்னெடுக்கப்	படுகின்றன
padukinrana	முன்னெடுக்கப்	படுக்கின்றன
padukintrana	முன்னெடுக்கப்	படுகின்றன
patukinrana	முன்னெடுக்கப்	பட்டுகின்றன
munnedukappatta	முன்னெடுக்கப்பட்ட	முன்னெடுக்கப்பட்ட
munnedukkappatta	முன்னெடுக்கப்பட்ட	முன்னெடுக்கப்பட்ட
munnetukkappatta	முன்னெடுக்கப்பட்ட	முன்னெடுக்கப்பட்ட
munnedukkum	முன்னெடுக்கும்	முன்னெடுக்கும்
munnetukkum	முன்னெடுக்கும்	முன்னெடுக்கும்
munmaadhiriyaga	முன்மாதிரியாக	முன்மாதிரியக
munmaadhiriyaka	முன்மாதிரியாக	முன்மாதிரியகக
munmaathiriyaaga	முன்மாதிரியாக	முன்மாதிரியாக
munmaathiriyaaka	முன்மாதிரியாக	முன்மாதிரியாக
munmadiriyaga	முன்மாதிரியாக	முன்மடிரியாக
munvaiththa	முன்வைத்த	முன்வைத்த
munvaiththaanr	முன்வைத்தனர்	முன்வைத்தான்
munvaiththanar	முன்வைத்தனர்	முன்வைத்தனர்
muppathu	முப்பது	முப்பது
muppathukkum	முப்பதுக்கும்	முப்பதுக்கும்
muyandra	முயன்ற	முயன்ற
muyanra	முயன்ற	முயன்ற
muyantra	முயன்ற	முயன்ற
muyandrathaaga	முயன்றதாக	முயன்றதாக
muyandrathaaha	முயன்றதாக	முயன்றதாத
muyandrathaaka	முயன்றதாக	முயன்றதாக
muyanrathaaka	முயன்றதாக	முயன்றதாக
muyantrathaaga	முயன்றதாக	முயன்றதாக
muyantrathaaka	முயன்றதாக	முயன்றதாக
muyandrathu	முயன்றது	முயன்றது
muyanrathu	முயன்றது	முயன்றது
muyantrathu	முயன்றது	முயன்றது
muyandrana	முயன்றன	முயன்றன
muyanrana	முயன்றன	முயன்றன
muyantrana	முயன்றன	முயன்றன
muyandraan	முயன்றான்	முயன்றான்
muyanraan	முயன்றான்	முயன்றான்
muyantraan	முயன்றான்	முயன்றான்
muyanru	முயன்று	முயன்று
muyantru	முயன்று	முயன்று
murachu	முரசு	முரசு
murasu	முரசு	முரசு
muraigaettil	முறைகேட்டில்	முறைகேட்டில்
muraikaettil	முறைகேட்டில்	முறைகேட்டில்
muraikettil	முறைகேட்டில்	முறைகெட்டில்
muraimai	முறைமை	முரைமை
muraimaiyaanathu	முறைமையானது	முறைமையானது
muraimaiyin	முறைமையின்	முறைமையின்
muraimaiyil	முறைமையில்	முறைமையில்
murpatta	முற்பட்ட	முற்பட்ட
murpattanar	முற்பட்டனர்	முற்பட்டனர்
murpattapoathu	முற்பட்டபோது	முற்பட்டபோபது
murpattapoothu	முற்பட்டபோது	முற்பட்டபோது
murpattapothu	முற்பட்டபோது	முற்பட்டப்பது
murpattaan	முற்பட்டான்	முர்ப்டாட்டன்
theevai	முல்லைத்	தீவை
tivai	முல்லைத்	திவை
mullum	முள்ளும்	முல்லும்
mullai	முள்ளை	முல்லை
mulunera	முழுநேர	முலுனேர
muzhunaera	முழுநேர	முழுநேர
muzhunera	முழுநேர	முழுநேர
moodupani	மூடுபனி	மூடுபனி
moondraavadhu	மூன்றாவது	மூன்றாவது
moondraavathu	மூன்றாவது	மூன்றாவது
moor	மூர்	மோர்
mur	மூர்	முர்
muur	மூர்	முர்
moolakkooru	மூலக்கூறு	மூலக்கூறு
moolakkoorugalin	மூலக்கூறுகளின்	மூலக்கூறுகளின்
moolakkoorukalin	மூலக்கூறுகளின்	மூலக்கூறுகளின்
moolakkoorugalai	மூலக்கூறுகளை	மூலக்கூறுகளை
moolakkoorukalai	மூலக்கூறுகளை	மூலக்கூறுகளை
mechchi	மெச்சி	மெச்சி
maegalai	மேகலை	மேகளை
maekalai	மேகலை	மேகளை
megalai	மேகலை	மேகளை
madein	மேட்டின்	மேடின்
maettin	மேட்டின்	மேட்டின்
mate	மேட்டின்	மேட்
matein	மேட்டின்	மேட்ன்
maeniyil	மேனியில்	மேனியில்
maembaalaththai	மேம்பாலத்தை	மேம்பாலத்தை
maempaalaththai	மேம்பாலத்தை	மேம்பாளத்தை
meampaalaththai	மேம்பாலத்தை	மேம்பாளத்தை
maicroa	மைக்ரோ	மைக்கோ
maikro	மைக்ரோ	மைக்கோ
maikroa	மைக்ரோ	மைக்கோ
maikroo	மைக்ரோ	மைக்கோ
maiqro	மைக்ரோ	மைக்கோ
mekro	மைக்ரோ	மெக்கோ
micro	மைக்ரோ	மிக்கோ
microo	மைக்ரோ	மிக்கோ
micru	மைக்ரோ	மிக்கு
mikro	மைக்ரோ	மிக்கோ
mykro	மைக்ரோ	மைக்கோ
mykroo	மைக்ரோ	மைக்கோ
myqro	மைக்ரோ	மிக்கோ
moe	மோ	மோ
moo	மோ	மோ
mooe	மோ	மோ
moasaeyin	மோசேயின்	மோசேயின்
moaseayin	மோசேயின்	மோசேயின்
mosaeyin	மோசேயின்	மோசேயின்
moad	மோட்	மோட்
moat	மோட்	மோட்
mod	மோட்	மோட்
mode	மோட்	மோட்
mood	மோட்	மோட்
mote	மோட்	மோட்டி
iaak	யாக்	யாக்
iacc	யாக்	ஐக்
iak	யாக்	யாக்
iakk	யாக்	ஐக்
iokk	யாக்	ஐக்
yaak	யாக்	யாக்
yaaq	யாக்	யாக்
yacc	யாக்	யாக்
yak	யாக்	யக்
yakk	யாக்	யாக்
yaq	யாக்	யக்
yaqq	யாக்	யக்க்
yok	யாக்	யாக்
yokk	யாக்	யாக்
yoqq	யாக்	யோக்
iaang	யாங்	யாங்
ianag	யாங்	இணாக்
iang	யாங்	யங்
yaang	யாங்	யாங்
yan	யாங்	யான்
yanag	யாங்	யணன்
yang	யாங்	யங்
yaadhavar	யாதவர்	யாதவர்
yaathavar	யாதவர்	யாதவர்
yaadhavarkal	யாதவர்கள்	யாதவர்கள்
yaathavargal	யாதவர்கள்	யாதவர்கள்
yaathavarkal	யாதவர்கள்	யாதவர்கள்
iaadav	யாதவ்	யாடவவ்
iadav	யாதவ்	யடடவ்
iaduv	யாதவ்	யடுவு
jadav	யாதவ்	ஜாடவவ்
jadaw	யாதவ்	ஜாடவ்
yaadav	யாதவ்	யாடவவ்
yaadaw	யாதவ்	யாடவவு
yaadhav	யாதவ்	யாதவ்
yaathav	யாதவ்	யாதவத்
yadav	யாதவ்	யடடவ்
yadaw	யாதவ்	யடட்
yaduuv	யாதவ்	யடுவ்
yaduv	யாதவ்	யடுவு
yaduw	யாதவ்	யடுவு
yatav	யாதவ்	யட்வாவ்
zadav	யாதவ்	ஜாடவவ்
yaavarum	யாவரும்	யாவரும்
yaahoo	யாஹூ	யாகோ
yahoo	யாஹூ	யாகோ
yaaka	யோக	யாகா
yoaga	யோக	யோகா
yoaka	யோக	யோகா
yoga	யோக	யோகா
yaakangkalai	யோகங்களை	யாகங்களை
yoagangkalai	யோகங்களை	யோகங்களை
yoakangalai	யோகங்களை	யோகங்களை
yoakangkalai	யோகங்களை	யோகங்களை
yoagaththil	யோகத்தில்	யோகத்தில்
yoakaththil	யோகத்தில்	யோகத்தில்
yookaththil	யோகத்தில்	யூகத்தில்
yoakaththai	யோகத்தை	யோகத்தை
yogaththai	யோகத்தை	யோகத்தை
yookaththai	யோகத்தை	யூகத்தை
yoagaa	யோகா	யோகா
yoakaa	யோகா	யோகா
yoga	யோகா	யோகா
yogaa	யோகா	யோகா
yooga	யோகா	யூகா
yookaa	யோகா	யூகா
youga	யோகா	யோகா
yoachanai	யோசனை	யோசனை
yoasanai	யோசனை	யோசனை
yoosanai	யோசனை	யூசனை
yoasanaiyin	யோசனையின்	யோசனையின்
yoosanaiyin	யோசனையின்	யூசனையின்
yoasanaiyai	யோசனையை	யோசனையை
yoosanaiyai	யோசனையை	யூசனையை
yosanaiyai	யோசனையை	யோசனையை
jordan	யோர்தான்	ஜோர்டன்
yoarthaan	யோர்தான்	யோர்தான்
yoorthaan	யோர்தான்	யூர்தான்
rachippathil	ரசிப்பதில்	ரசிப்பத்தில
rasippathil	ரசிப்பதில்	ரசிப்பத்தில
ranchi	ரஞ்சி	ராஞ்சி
ranjchi	ரஞ்சி	ரஞ்சி
ranji	ரஞ்சி	ரஞ்சி
ranchith	ரஞ்சித்	ராஞ்சித்
ranjchith	ரஞ்சித்	ரஞ்சித்
ranjeet	ரஞ்சித்	ராஞ்சிட்
ranjeit	ரஞ்சித்	ராஞ்செட்
ranjiit	ரஞ்சித்	ராஞ்சிட்
ranjit	ரஞ்சித்	ராஞ்சிட்
ranjith	ரஞ்சித்	ரஞ்சித்
ranjyt	ரஞ்சித்	ரஞ்சிட்
ranzeet	ரஞ்சித்	ராஞ்சிட்
ranzeit	ரஞ்சித்	ரா்ஜெய்ட
ranzit	ரஞ்சித்	ரா்ஜிட்
ranzyt	ரஞ்சித்	ராஞ்சிட்
runjeet	ரஞ்சித்	ருஞ்செட்
runjiit	ரஞ்சித்	ருஞ்சிட்
runzeet	ரஞ்சித்	ருந்சீட்
ruunjeet	ரஞ்சித்	ருஞ்செட்
rail	ரயில்	ரால்
raill	ரயில்	ரால்
raiyl	ரயில்	ரையில்
rayil	ரயில்	ரயில்
rayl	ரயில்	ராயல்
reil	ரயில்	ரெல்
rel	ரயில்	ரெல்
rell	ரயில்	ரெல்
ravikkai	ரவிக்கை	ரவிக்கை
ravudi	ரவுடி	ரவுடி
rovdy	ரவுடி	ராட்டி
rowdi	ரவுடி	ரோடி
rowdy	ரவுடி	ராட்
rashiya	ரஷ்ய	ரஷியா
rashya	ரஷ்ய	ரஷ்யா
rassia	ரஷ்ய	ரசியா
russia	ரஷ்ய	ரஷஷியா
raagul	ராகுல்	ராகுள்
raahul	ராகுல்	ராகுல்
raahuul	ராகுல்	ரால்
ragul	ராகுல்	ராகுல்
rahool	ராகுல்	ராஜல்
rahul	ராகுல்	ரால்
rahuul	ராகுல்	ரால்
rakul	ராகுல்	ராகுல்
raajan	ராஜன்	ராஜன்
rajan	ராஜன்	ராஜன்
raajaraaja	ராஜராஜ	ராஜராஜா
rajaraja	ராஜராஜ	ராஜராஜா
raajjiyam	ராஜ்ஜியம்	ராஜ்ஜியம்
rajjiyam	ராஜ்ஜியம்	ராஜ்ஜியம்
raanuvaththin	ராணுவத்தின்	ராணுவத்தின்
raanuvam	ராணுவம்	ராணுவம்
raat	ராத்	ராட்
raath	ராத்	ராத்
raamachchandhira	ராமச்சந்திர	ராமச்சந்திர
raamachchanthira	ராமச்சந்திர	ராமச்சந்திர
ramachandra	ராமச்சந்திர	ராமசா்்
raamu	ராமு	ராமு
ramu	ராமு	ராமு
raayin	ராயின்	ராயின்
raiyin	ராயின்	ரையின்
raavin	ராவின்	ராவின்
ravin	ராவின்	ரவின்
rawin	ராவின்	ராவின்
ring	ரிங்	ரிங்
reader	ரீடர்	ரேடர்
reedar	ரீடர்	ரீடர்
ruchi	ருசி	ருசி
rusi	ருசி	ரூசி
rendu	ரெண்டு	ரெண்டு
raadaun	ரேடான்	ராடுன்
raadauun	ரேடான்	ராடுன்
raadon	ரேடான்	ராடன்
radon	ரேடான்	ராடன்
reedan	ரேடான்	ரீடன்
raemand	ரேமண்ட்	ராமண்ட்
raemant	ரேமண்ட்	ராமண்ட்
raimond	ரேமண்ட்	ராம்ண்ட்
raymond	ரேமண்ட்	ராம்ண்ட்
reemand	ரேமண்ட்	ரிமாண்ட்
roo	ரோ	ரோ
roow	ரோ	ரூவ்
rov	ரோ	ரோ
row	ரோ	ரோ
landanin	லண்டனின்	லாண்டனின்
londanin	லண்டனின்	லாண்டனின்
londonin	லண்டனின்	லாண்டனன்
lav	லவ்	லாவ்
lov	லவ்	லோ
love	லவ்	லோவ்
low	லவ்	லோ
lowe	லவ்	லோ
luuv	லவ்	லூவ்
luv	லவ்	லூவ்
luw	லவ்	லூவ்
laak	லாக்	லாக்
lack	லாக்	லாக்
lock	லாக்	லாக்
laaba	லாப	லாபா
laba	லாப	லபா
laabam	லாபம்	லாபம்
laapam	லாபம்	லாபம்
laalu	லாலு	லாலு
lalu	லாலு	லலு
linam	லிங்கம்	லினம்
lingam	லிங்கம்	லிங்கம்
linggam	லிங்கம்	லிங்கம்
lingkam	லிங்கம்	லிங்கம்
linkam	லிங்கம்	லிங்கம்
lemeted	லிமிடெட்	லெமெட்டி
limidaed	லிமிடெட்	லிமிடேட்
limitade	லிமிடெட்	லிமிட்டா
limited	லிமிடெட்	லிமிட்டி
limitedd	லிமிடெட்	லிமிட்டட்
leeli	லில்லி	லேலி
leelii	லில்லி	லெலி
liili	லில்லி	லிலி
liilii	லில்லி	லிலி
liilly	லில்லி	லில்
liily	லில்லி	லில்
lilee	லில்லி	லிலி
lili	லில்லி	லிலி
lilii	லில்லி	லிலி
lilli	லில்லி	லில்லி
lilly	லில்லி	லில்
lily	லில்லி	லிலி
lyly	லில்லி	லிலி
leagueil	லீக்கில்	லேகியல்
leakkil	லீக்கில்	லேக்கில்
leena	லீனா	லீனா
leenaa	லீனா	லீனா
lena	லீனா	லெனா
liina	லீனா	லினா
lina	லீனா	லினா
looyi	லூயி	லூயி
louie	லூயி	லோய்
louis	லூயி	லோஸ்
louuie	லூயி	லூய்
luuyi	லூயி	லூயி
looyis	லூயிஸ்	லூயிஸ்
loues	லூயிஸ்	லோஸ்
louis	லூயிஸ்	லோஸ்
louues	லூயிஸ்	லோஸ்
louuis	லூயிஸ்	லூஸ்
lues	லூயிஸ்	லூஸ்
luis	லூயிஸ்	லூஸ்
luues	லூயிஸ்	லூஸ்
luuis	லூயிஸ்	லூஸ்
luuyis	லூயிஸ்	லூயிஸ்
leptinan	லெப்டினன்	லெப்டினன்
lace	லெஸ்	லாக்
laes	லெஸ்	லேஸ்
lais	லெஸ்	லேஸ்
laiss	லெஸ்	லைஸ்
lays	லெஸ்	லேஸ்
layss	லெஸ்	லாஸ்
leis	லெஸ்	லெஸ்
les	லெஸ்	லேஸ்
less	லெஸ்	லேஸ்
laac	லேக்	லாக்
laak	லேக்	லாக்
laakh	லேக்	லாக்
laaq	லேக்	லாக்
laaqh	லேக்	லாக்
lac	லேக்	லாக்
laek	லேக்	லேக்
lake	லேக்	லாக்
lakh	லேக்	லாக்
laqh	லேக்	லாக்
leek	லேக்	லீக்
vaguththanar	வகுத்தனர்	வகுத்தனர்
vakuththanar	வகுத்தனர்	வகுத்தனர்
vaguththulladhu	வகுத்துள்ளது	வகுத்துள்ளது
vaguththullathu	வகுத்துள்ளது	வகுத்துள்ளது
vakuththullathu	வகுத்துள்ளது	வகுத்துள்ளது
vagaith	வகைத்	வகைத்
vakaith	வகைத்	வகைத்
vakkiramaana	வக்கிரமான	வக்கிரமான
vakbu	வக்பு	வாக்கு
vakpu	வக்பு	வக்பு
vangadesa	வங்கதேச	வங்கடேச
vangathaesa	வங்கதேச	வங்கதேச
vangkadhaesa	வங்கதேச	வங்கதேச
vangadhaesaththil	வங்கதேசத்தில்	வங்கதேசத்தில்
vangathaesaththil	வங்கதேசத்தில்	வங்கதேசத்தில்
vangkadhaesaththil	வங்கதேசத்தில்	வங்கதேசத்தில்
vangaali	வங்காளி	வங்காலி
vangkaali	வங்காளி	வங்காலி
vasam	வசம்	வசாம்
vasiththa	வசித்த	வசித்த
vasiththaar	வசித்தார்	வசித்தார்
vadakkae	வடக்கே	வடக்கே
vadakke	வடக்கே	வடக்கே
vadamaerkae	வடமேற்கே	வடமேற்கே
vatamaerkae	வடமேற்கே	வடமேற்கே
vadikka	வடிக்க	வடிக்க
vadikkum	வடிக்கும்	வடிக்கும்
vadivaana	வடிவான	வடிவான
vadivil	வடிவில்	வடிவில்
vatti	வட்டி	வட்டி
vana	வண	வனன
ven	வண	வென்
wen	வண	வென்
vanigar	வணிகர்	வணிகர்
vanikar	வணிகர்	வணிகர்
vanigarkalukku	வணிகர்களுக்கு	வணிகர்களுக்கு
vanikarkalukku	வணிகர்களுக்கு	வணிகர்களுக்கு
vadhanam	வதனம்	வதனம்
vathanam	வதனம்	வதனம்
wadhanam	வதனம்	வதானம்
vanaviyal	வனவியல்	வணவியல்
vamsa	வம்ச	வாசா
vamsaththin	வம்சத்தின்	வம்சத்தின்
vamsaththu	வம்சத்து	வம்சத்து
vamchi	வம்சி	வாச்சி
vamsi	வம்சி	வாம்சி
vayathaagum	வயதாகும்	வயதாகும்
vayathaakum	வயதாகும்	வயதாகும்
vayathilum	வயதிலும்	வயதிலும்
vayathilaeyae	வயதிலேயே	வயதிலேயே
varagu	வரகு	வரகு
varadha	வரத	வரதா
varatha	வரத	வரத
vardha	வரத	வர்த
varadhar	வரதர்	வரதர்
varathar	வரதர்	வரதர்
varalaattru	வரலாற்று	வரலாற்று
varalaattruk	வரலாற்றுக்	வரலாற்றுக்
varalaattrukku	வரலாற்றுக்கு	வரலாற்றுக்கு
varalaattrudan	வரலாற்றுடன்	வரலாற்றுடன்
varalaattrup	வரலாற்றுப்	வரலாற்றுப்
varavaerka	வரவேற்க	வரவேற்க
varavaerkum	வரவேற்கும்	வரவேற்கும்
varigalin	வரிகளின்	வரிகளின்
varikalin	வரிகளின்	வரிகளின்
varigalil	வரிகளில்	வரிகளில்
varikalil	வரிகளில்	வரிகளில்
varigalukku	வரிகளுக்கு	வரிகளுக்கு
varikalukku	வரிகளுக்கு	வரிகளுக்கு
varigalum	வரிகளும்	வரிகளும்
varikalum	வரிகளும்	வரிகளும்
varikku	வரிக்கு	வரிக்கு
varich	வரிச்	வரிச்
varinum	வரினும்	வரினும்
panaththai	வரிப்	பணத்தை
panattai	வரிப்	பணட்டை
variyaaga	வரியாக	வரியாக
variyaaka	வரியாக	வரியாக
variyin	வரியின்	வரியின்
variyum	வரியும்	வரியும்
varumaaru	வருமாறு	வருமாறு
variya	வறிய	வரியா
valimaiyaanathu	வலிமையானது	வழிமையானது
valuvaaga	வலுவாக	வழுவாக
valuvaaka	வலுவாக	வழுவாக
valuvvaaga	வலுவாக	வழுவ்வாக
valaiyamaippai	வலையமைப்பை	வழையமைப்பை
valaiyamaippu	வலையமைப்பை	வழையமைப்பு
valaiththathu	வளைத்தது	வழைத்தது
valaivaaga	வளைவாக	வழைவாக
valaivaaka	வளைவாக	வழைவாக
valakkarignarum	வழக்கறிஞரும்	வழக்கரிகருமாம
valakkarinarum	வழக்கறிஞரும்	வழக்கரினரும்
vazhakkarinarum	வழக்கறிஞரும்	வழக்கரினரும்
valakkugalin	வழக்குகளின்	வழக்குகளின்
valakkukalin	வழக்குகளின்	வழக்குகளின்
vazhakkukalin	வழக்குகளின்	வழக்குகளின்
valakkugalai	வழக்குகளை	வழக்குகளை
valakkukalai	வழக்குகளை	வழக்குகளை
vazhakkukalai	வழக்குகளை	வழக்குகளை
valakkugal	வழக்குகள்	வழக்குகள்
valakkukal	வழக்குகள்	வழக்குகள்
vazhakkukal	வழக்குகள்	வழக்குகள்
valakkuth	வழக்குத்	வழக்குத்
vazhakkuth	வழக்குத்	வழக்குத்
valakkum	வழக்கும்	வழக்கும்
vazhakkum	வழக்கும்	வழக்கும்
valangappada	வழங்கப்பட	வழங்கப்பட
vazhangappada	வழங்கப்பட	வழங்கப்பட
vazhanggappada	வழங்கப்பட	வழங்கப்பட
valangappadaatha	வழங்கப்படாத	வழங்கப்படாத
vazhangappadaadha	வழங்கப்படாத	வழங்கப்படாத
vazhanggappattathaa	வழங்கப்படாத	வழங்கப்பட்டதா
valangappadum	வழங்கப்படும்	வழங்கப்படும்
valangkappadum	வழங்கப்படும்	வழங்கப்படும்
vazhanggappadum	வழங்கப்படும்	வழங்கப்படும்
vazhangkappadum	வழங்கப்படும்	வழங்கப்படும்
valangavillai	வழங்கவில்லை	வளங்கவில்லை
valangkavillai	வழங்கவில்லை	வளங்கவில்லை
vazhangkavillai	வழங்கவில்லை	வழங்கவில்லை
valinadaththa	வழிநடத்த	வழிநடத்த
vazhinadaththa	வழிநடத்த	வழிநடதத்த
valiyil	வழியில்	வளியில்
vazhiyil	வழியில்	வழியில்
valiyillai	வழியில்லை	வளியில்லை
vazhiyillai	வழியில்லை	வழியில்லை
valiyae	வழியே	வலியே
valiyea	வழியே	வலியா
vazhiyae	வழியே	வழியே
valukkum	வழுக்கும்	வழுக்கும்
vazhukkum	வழுக்கும்	வழுக்கும்
vavuniyaavil	வவுனியாவில்	வவுணியாவில்
vavuniyavil	வவுனியாவில்	வவுணியவில்
vastook	வஸ்தோக்	வாஸ்டோக்
vastuk	வஸ்தோக்	வாஸ்டுக்
voostook	வஸ்தோக்	வாஸ்டோக்
vostok	வஸ்தோக்	வாஸ்டோக்
vostook	வஸ்தோக்	வாஸ்டோக்
vostoq	வஸ்தோக்	வாஸ்டோக்
wastuk	வஸ்தோக்	வாஸ்டுக்
wastuq	வஸ்தோக்	வாஸ்டுக்
wastuuk	வஸ்தோக்	வாஸ்டுக்
woostook	வஸ்தோக்	வாஸ்டோக்
wostok	வஸ்தோக்	வாஸ்டாக்
wostook	வஸ்தோக்	வாஸ்டோக்
wostooq	வஸ்தோக்	வாஸ்டோக்
wostuk	வஸ்தோக்	வாஸ்டுக்
vaagana	வாகன	வாகன
vaakana	வாகன	வாகன
vaagananggalil	வாகனங்களில்	வாகணங்களில்
vaaganangkalil	வாகனங்களில்	வாகணங்களில்
vaakanangkalil	வாகனங்களில்	வாகனங்களில்
vaagananggalum	வாகனங்களும்	வாகணங்களும்
vaaganangkalum	வாகனங்களும்	வாகணங்களும்
vaakanangkalum	வாகனங்களும்	வாகனங்களும்
vaagananggalai	வாகனங்களை	வாகணங்களை
vaaganangkalai	வாகனங்களை	வாகணங்களை
vaakanangkalai	வாகனங்களை	வாகனங்களை
vaagananggal	வாகனங்கள்	வாகனங்கள்
vaaganangkal	வாகனங்கள்	வாகனங்கள்
vaakanangkal	வாகனங்கள்	வாகனங்கள்
vaaganaththin	வாகனத்தின்	வாகனத்தின்
vaakanaththin	வாகனத்தின்	வாகனத்தின்
vaaganaththilirunththu	வாகனத்திலிருந்து	வாகநத்திலிருந்து
vaaganaththilirunthu	வாகனத்திலிருந்து	வாகனத்திலிருந்து
vaakanaththilirunththu	வாகனத்திலிருந்து	வாகனத்திலிருந்து
vaakanaththilirunthu	வாகனத்திலிருந்து	வாகனத்திலிருந்து
vaaganaththil	வாகனத்தில்	வாகனத்தில்
vaakanaththil	வாகனத்தில்	வாகனத்தில்
vaaganap	வாகனப்	வாகனப்
vaakanap	வாகனப்	வாகன்ப்
vaaganamaana	வாகனமான	வாகனமான
vaaganamana	வாகனமான	வாகனமன
vaakanamaana	வாகனமான	வாகனமான
vaakanamana	வாகனமான	வாகனமன
vaak	வாக்	வாக்
vag	வாக்	வாக்
vak	வாக்	வாக்
wag	வாக்	வாக்
wak	வாக்	வாக்
walk	வாக்	வால்
vaangappatta	வாங்கப்பட்ட	வாங்கப்பட்ட
vaanggappatta	வாங்கப்பட்ட	வாங்கப்பட்ட
vaangkappatta	வாங்கப்பட்ட	வாங்கப்பட்ட
vaangalil	வாங்கலில்	வாங்களில்
vaanggalil	வாங்கலில்	வாங்களில்
vaangal	வாங்கல்	வாங்கள்
vaanggal	வாங்கல்	வாங்கள்
vaangguvatharku	வாங்குவதற்கு	வாங்குவதற்கு
vaangkuvatharku	வாங்குவதற்கு	வாங்குவதற்கு
vaangguvathu	வாங்குவது	வாங்குவது
vaangkuvathu	வாங்குவது	வாங்குவது
vaangguvathai	வாங்குவதை	வாங்குவதை
vaangkuvathai	வாங்குவதை	வாங்குவதை
vaasippavargal	வாசிப்பவர்கள்	வாசிப்பவர்கள்
vaachippil	வாசிப்பில்	வாசிப்பில்
vaasippil	வாசிப்பில்	வாசிப்பில்
vaachippai	வாசிப்பை	வாசிப்பை
vaasippai	வாசிப்பை	வாசிப்பை
vaadi	வாடி	வாடி
vadi	வாடி	வாடி
wadi	வாடி	வாடி
wadii	வாடி	வாடி
vaatch	வாட்ச்	வாட்ச்
watch	வாட்ச்	வாட்
vaani	வாணி	வானி
vani	வாணி	வணி
vaathittanar	வாதிட்டனர்	வாதிட்டனர்
vaathumai	வாதுமை	வாதுமை
vaamana	வாமன	வாமன
vamana	வாமன	வமன
vaayilaaga	வாயிலாக	வாயிலாக
vaayilaaka	வாயிலாக	வாயிலாக
vaayilaagath	வாயிலாகத்	வாயிலாகத்
vaayilaakath	வாயிலாகத்	வாயிலாகத்
vaayilaagap	வாயிலாகப்	வாயிலாகப்
vaayilaakap	வாயிலாகப்	வாயிலாகப்
vaariyaaga	வாரியாக	வாரியாக
vaariyaaka	வாரியாக	வாரியாக
vaalt	வால்ட்	வால்ட்
vald	வால்ட்	வால்ட்
valt	வால்ட்	வால்ட்
vaoolt	வால்ட்	வால்ட்
vault	வால்ட்	வால்ட்
vauult	வால்ட்	வால்ட்
volt	வால்ட்	வால்ட்
vult	வால்ட்	வுல்ட்
vuult	வால்ட்	வால்ட்
walt	வால்ட்	வால்ட்
waoolt	வால்ட்	வால்ட்
wault	வால்ட்	வால்ட்
wult	வால்ட்	வால்ட்
vaalidankal	வாழிடங்கள்	வாழிடங்கள்
vaazhidanggal	வாழிடங்கள்	வாழிடங்கள்
vaazhidangkal	வாழிடங்கள்	வாழிடங்கள்
vaazhitangkal	வாழிடங்கள்	வாழிடங்கள்
vaalidam	வாழிடம்	வாழிடம்
vaazhaidam	வாழிடம்	வாழைடம்
vaazhidam	வாழிடம்	வாழிடம்
vaazhitam	வாழிடம்	வாழிடம்
vaalai	வாழை	வாலை
vaazhai	வாழை	வாழை
vaalaiyaaga	வாழையாக	வாழையாக
vaazhaiyaaga	வாழையாக	வாழையாக
vaazhaiyaaka	வாழையாக	வாழையாக
vaazhga	வாழ்க	வாழ்கா
vaazhka	வாழ்க	வாழ்க
valamudan	வாழ்க	வலமுடன்
valamutan	வாழ்க	வலமுடன்
vaazhvathaaga	வாழ்வதாக	வாழ்வதாக
vaazhvathaal	வாழ்வதால்	வாழ்வதால்
vaalvukku	வாழ்வுக்கு	வாழ்வுக்கு
vaazhvukku	வாழ்வுக்கு	வாழ்வுக்கு
vaalvoar	வாழ்வோர்	வால்வோர்
vaazhvoar	வாழ்வோர்	வாழ்வோர்
vaas	வாஸ்	வாஸ்
vase	வாஸ்	வேசி
was	வாஸ்	வாஸ்
vigaaraiyil	விகாரையில்	விகாரையில்
viharaiyil	விகாரையில்	விராயில்
vikaaraiyil	விகாரையில்	விகாரையில்
vikkirama	விக்கிரம	விக்கிரமா
vikkrama	விக்கிரம	விக்கிராம
vikrama	விக்கிரம	விக்ராம
visaariththu	விசாரித்து	விசாரித்து
vichaesha	விசேஷ	விசேஷ
visaesha	விசேஷ	விசேஷா
vichaikal	விசைகள்	விசைகள்
visaigal	விசைகள்	விசைகள்
visaikal	விசைகள்	விசைகள்
vichaikku	விசைக்கு	விசைக்கு
visaikku	விசைக்கு	விசைக்கு
visaiyaal	விசையால்	விசையால்
visaiyil	விசையில்	விசையில்
visaiyum	விசையும்	விசையும்
visaiyai	விசையை	விசையை
vingngnaani	விஞ்ஞானி	விங்கானி
vinjnjaani	விஞ்ஞானி	விஞ்சானி
vinniaani	விஞ்ஞானி	வின்னியி
vingngnaanikalukku	விஞ்ஞானிகளுக்கு	விங்கானிகளுக்கு
vinjnjaanikalukku	விஞ்ஞானிகளுக்கு	விஞ்சானிகளுக்கு
vinniaanigalukku	விஞ்ஞானிகளுக்கு	விண்ணியாண்களுக்க
vingngnaanikal	விஞ்ஞானிகள்	விங்கானிகள்
vinjnjaanikal	விஞ்ஞானிகள்	விஞ்சானிகள்
vinniaanigal	விஞ்ஞானிகள்	விண்ணியான்கள்
vingngnaaniyaana	விஞ்ஞானியான	விங்கினாயினான
vinjnjaaniyaana	விஞ்ஞானியான	விஞ்சானியான
vinniaaniyaana	விஞ்ஞானியான	வின்னியாணியான
vidayangalil	விடயங்களில்	விடயாங்களில்
vidayanggalil	விடயங்களில்	விடயாங்களில்
vidayangkalil	விடயங்களில்	விடயாங்களில்
vidayanggalum	விடயங்களும்	விடயங்களும்
vidayangkalum	விடயங்களும்	விடயங்களும்
vitayangkalum	விடயங்களும்	விட்யங்களும்
vidayanggal	விடயங்கள்	விடயாங்கள்
vidayangkal	விடயங்கள்	விடயாங்கள்
vitayangkal	விடயங்கள்	விட்யாங்கள்
vidayaththil	விடயத்தில்	விடையத்தில்
vitayaththil	விடயத்தில்	விடையத்தில்
vidayaththaiyum	விடயத்தையும்	விடயத்தையும்
vitayaththaiyum	விடயத்தையும்	விடையத்தையும்
poaraattam	விடுதலைப்	போராட்டம்
porattam	விடுதலைப்	போரட்டம்
viduthalaip	விடுதலைப்	விடுதலைப்
vidum	விடும்	விடும்
vittaalum	விட்டாலும்	விட்டாலும்
vittup	விட்டுப்	விட்டுப்
viththiyaachangkal	வித்தியாசங்கள்	வித்தியாசங்கள்
viththiyaasanggal	வித்தியாசங்கள்	வித்தியாசங்கள்
viththiyaasangkal	வித்தியாசங்கள்	வித்தியாசங்கள்
viththiyaasankal	வித்தியாசங்கள்	வித்தியாசங்கள்
viththiyaachappadum	வித்தியாசப்படும்	வித்தியாசப்படும்
viththiyaasappadum	வித்தியாசப்படும்	வித்தியாசப்படும்
vidhdhiyaasaalai	வித்தியாசாலை	வித்தியாசாலை
vidhyaasaalai	வித்தியாசாலை	வித்தாசாலை
vidhyasalai	வித்தியாசாலை	வித்தசசை
vidyasalai	வித்தியாசாலை	விட்யசசை
viththiyaasaalai	வித்தியாசாலை	வித்தியாசாலை
vinaa	வினா	வினா
vinaavirku	வினாவிற்கு	விணாவிற்கு
vinaavukku	வினாவுக்கு	விணாவுக்கு
vibaththaal	விபத்தால்	விபத்தால்
vipaththaal	விபத்தால்	விபத்தால்
booshan	விபூதி	பூஷன்
vibhoodhi	விபூதி	விபோதி
viboodhi	விபூதி	விபோதி
viboothi	விபூதி	விபோதி
vimarisaiyaaga	விமரிசையாக	விமரிசையாக
vimarisaiyaaka	விமரிசையாக	விமரிசையாக
vimarsiththathu	விமர்சித்தது	விமர்சித்தது
vimarsiththatu	விமர்சித்தது	விமர்சித்தது
vimarsiththanar	விமர்சித்தனர்	விமர்சித்தனர்
vimarsiththu	விமர்சித்து	விமர்சித்து
vimaanangalil	விமானங்களில்	விமாணங்களில்
vimaananggalil	விமானங்களில்	விமாணங்களில்
vimaananggalai	விமானங்களை	விமாணங்களை
vimaanankalai	விமானங்களை	விமாணங்களை
veem	விம்	வேம்
viim	விம்	விம்
vim	விம்	விம்
vimm	விம்	விம்
weem	விம்	வீம்
wiim	விம்	விம்
wim	விம்	விம்
wimm	விம்	விம்
viyaabaari	வியாபாரி	வியாபாரி
viyaapaari	வியாபாரி	வியாபாரி
viyaabaarigalukkum	வியாபாரிகளுக்கும்	வியாபாரிகளுக்கும்
viyaapaarigalukkum	வியாபாரிகளுக்கும்	வியாபாரிகளுக்கும்
viyaabaarigal	வியாபாரிகள்	வியாபாரிகள்
viyaapaarigal	வியாபாரிகள்	வியாபாரிகள்
viyabaarigal	வியாபாரிகள்	வியபாரிகள்
viralaal	விரலால்	விரலால்
virivaagak	விரிவாகக்	விரிவாகக்
virivaagap	விரிவாகப்	விரிவாகப்
virivaagavum	விரிவாகவும்	விரிவாகவும்
virivagavum	விரிவாகவும்	விரிவகவும்
virivurai	விரிவுரை	விரிவுறை
virkum	விற்கும்	விற்கும்
virkumpoadhu	விற்கும்போது	விற்கும்போது
virkumpoathu	விற்கும்போது	விற்கும்போது
virpathum	விற்பதும்	விற்பதும்
vitrtra	விற்ற	விற்ற
vittra	விற்ற	விற்ற
villiamin	வில்லியமின்	வில்லிமின்
villiyamin	வில்லியமின்	வில்லியமின்
williamin	வில்லியமின்	வில்லியம்
villai	வில்லை	வில்லை
villaigalai	வில்லைகளை	விள்ளைகளை
villaikalai	வில்லைகளை	விள்ளைகளை
vilimbu	விளிம்பு	விளிம்பு
vilimpu	விளிம்பு	விளிம்பு
vilimbugalil	விளிம்புகளில்	விளிம்புகளில்
vilimbukalil	விளிம்புகளில்	விளிம்புகளில்
vilimpugalil	விளிம்புகளில்	விளிம்புகளில்
vilimpukalil	விளிம்புகளில்	விளிம்புகளில்
vilaindha	விளைந்த	விளைந்த
vilaintha	விளைந்த	விளைந்த
vilaindhadhu	விளைந்தது	விளைந்தது
vilaindhathu	விளைந்தது	விளைந்தது
vilainthadhu	விளைந்தது	விளைந்தது
vilainthathu	விளைந்தது	விளைந்தது
vilaindhu	விளைந்து	விளைந்து
vilainthu	விளைந்து	விளைந்து
vilaiyaadinaal	விளையாடினால்	விளையாடினால்
vilaiyaadum	விளையாடும்	விளையாடும்
vilaiyaadumpoadhu	விளையாடும்போது	விளையாடும்போது
vilaiyaadumpoathu	விளையாடும்போது	விளையாடும்போது
vilaiyaaduvadharku	விளையாடுவதற்கு	விளையாடுவதற்கு
vilaiyaaduvatharku	விளையாடுவதற்கு	விளையாடுவதற்கு
vilaiyaaduvadhu	விளையாடுவது	விளையாடுவது
vilaiyaaduvathu	விளையாடுவது	விளையாடுவது
vilaiyaattaaka	விளையாட்டாக	விளையாட்டாக
vilaiyattaaga	விளையாட்டாக	விளையட்டாக
vilaiyattaaka	விளையாட்டாக	விளையட்டாக
vilayaattaaga	விளையாட்டாக	விளையாட்டாக
vivariththa	விவரித்த	விவரித்த
vivariththu	விவரித்து	விவரித்து
vivaagaraththu	விவாகரத்து	விவாகரத்து
vivaakaraththu	விவாகரத்து	விவாகராத்து
vivakaaraththu	விவாகரத்து	விவகாரத்து
veesa	வீச	வேசா
veesi	வீசி	வீசி
veechinaar	வீசினார்	வீசினார்
veesinaan	வீசினார்	வீசினான்
veesinaar	வீசினார்	வீசினார்
veechum	வீசும்	வீசும்
veesum	வீசும்	வீசும்
veechumpoathu	வீசும்போது	வீசும்போது
veesumpoathu	வீசும்போது	வீசும்போது
veetirku	வீட்டிற்கு	வீடிற்கு
veettirgu	வீட்டிற்கு	வீட்டிர்கு
veettirku	வீட்டிற்கு	வீட்டிற்கு
veeraraagavan	வீரராகவன்	வீரராகவன்
veeraraakavan	வீரராகவன்	வீரராகவன்
veeraraghavan	வீரராகவன்	வீரரகவான்
veeraraagavum	வீரராகவும்	வீரராகவும்
veeraraakavum	வீரராகவும்	வீரராகவும்
veetriruntha	வீற்றிருந்த	வீற்றிருந்த
veetrtriruntha	வீற்றிருந்த	வீற்றிருந்த
veettriruntha	வீற்றிருந்த	வீற்றிருந்த
veelchchi	வீழ்ச்சி	வெள்ச்சி
veerzhchchi	வீழ்ச்சி	வீர்ச்சிசி
veezhchchi	வீழ்ச்சி	வீழ்ச்சி
veelchchikku	வீழ்ச்சிக்கு	வீழ்ச்சிக்கு
veerzhchchikku	வீழ்ச்சிக்கு	வீர்ச்ச்சிக்கு
veezhchchikku	வீழ்ச்சிக்கு	வீழ்ச்சிக்கு
veelchchiyaal	வீழ்ச்சியால்	வீழ்ச்சியால்
veezhchchiyaal	வீழ்ச்சியால்	வீழ்ச்சியால்
veelchchiyai	வீழ்ச்சியை	வீழ்ச்சியை
veezhchchiyai	வீழ்ச்சியை	வீழ்ச்சியை
veelnththa	வீழ்ந்த	வீழ்ந்த
veezhntha	வீழ்ந்த	வீழ்ந்த
veelnththathil	வீழ்ந்ததில்	வீழ்ந்ததில்
veezhnthathil	வீழ்ந்ததில்	வீழ்ந்ததில்
veelnththaar	வீழ்ந்தார்	வீழ்ந்தார்
veezhnthaar	வீழ்ந்தார்	வீழ்ந்தார்
veelnththu	வீழ்ந்து	வீழ்ந்து
veezhnthu	வீழ்ந்து	வீழ்ந்து
vekkai	வெக்கை	வெக்கை
vedikka	வெடிக்க	வெடிக்கா
vedikkaatha	வெடிக்காத	வெடிக்காத
vedikkumpoathu	வெடிக்கும்போது	வெடிக்கும்போது
vettiya	வெட்டிய	வெட்டிய
vettiyaan	வெட்டியான்	வெட்டியான்
veppa	வெப்ப	வெப்பா
veppak	வெப்பக்	வெப்பக்
calanam	வெப்பச்	கலனம்
chalanam	வெப்பச்	சலனம்
salanam	வெப்பச்	சலனம்
veppach	வெப்பச்	வெப்பாச்
veppath	வெப்பத்	வெப்பத்
veppaththaal	வெப்பத்தால்	வெப்பத்தால்
veppaththil	வெப்பத்தில்	வெப்பத்தில்
veppaththai	வெப்பத்தை	வெப்பத்தை
veppaththaik	வெப்பத்தைக்	வெப்பத்தைக்
veppamaana	வெப்பமான	வெப்பமான
veppamaanathu	வெப்பமானது	வெப்பமானது
veppamum	வெப்பமும்	வெப்பமும்
veppam	வெப்பம்	வெப்பம்
veruththu	வெறுத்து	வெறுத்து
verumaiyaana	வெறுமையான	வெறுமையான
vetrikaramaakath	வெற்றிகரமாகத்	வெற்றிகராமாகத்
vetrtrigaramaagath	வெற்றிகரமாகத்	வெற்றிகராமாகத்
vetrtrikaramaakath	வெற்றிகரமாகத்	வெற்றிகரகமாகத்
vetrikaramaakap	வெற்றிகரமாகப்	வெற்றிகராமாகப்
vetrtrigaramaagap	வெற்றிகரமாகப்	வெற்றிகராமாகப்
vetrtrikaramaakap	வெற்றிகரமாகப்	வெற்றிகரகமாகப்
velippadaiyaana	வெளிப்படையான	வெளிப்படையான
velippataiyaana	வெளிப்படையான	வெளிப்படையான
velipppadaiyaana	வெளிப்படையான	வெளிப்படையான
velippaadae	வெளிப்பாடே	வெளிப்பாடே
velippura	வெளிப்புற	வெளிப்புற
velippurak	வெளிப்புறக்	வெளிப்புறக்
velippurath	வெளிப்புறத்	வெளிப்புறத்
velippuraththil	வெளிப்புறத்தில்	வெளிப்புறத்தில்
velippuramaaga	வெளிப்புறமாக	வெளிப்புறமாக
veliyaagi	வெளியாகி	வெளியாகி
veliyaaki	வெளியாகி	வெளியாகி
veliyaagina	வெளியாகின	வெளியாகின
veliyaakina	வெளியாகின	வெளியாகின
veliyidappatta	வெளியிடப்பட்ட	வெளியிடப்பட்ட
veliyidappattadhu	வெளியிடப்பட்டது	வெளியிடப்பட்டது
veliyidappattathu	வெளியிடப்பட்டது	வெளியிடப்பட்டது
veliyidappattu	வெளியிடப்பட்டு	வெளியிடப்பட்டு
vaedkai	வேட்கை	வேட்கை
vaetgai	வேட்கை	வேட்கை
vaetkai	வேட்கை	வேட்கை
vaedkaiyil	வேட்கையில்	வேட்கையில்
vaetkaiyil	வேட்கையில்	வேட்கையில்
vaedhangkalin	வேதங்களின்	வேதங்களின்
vaethangalin	வேதங்களின்	வேதங்களின்
vaethangkalin	வேதங்களின்	வேதங்களின்
vaedhangkalai	வேதங்களை	வேதங்களை
vaethangalai	வேதங்களை	வேதங்களை
vaethangkalai	வேதங்களை	வேதங்களை
vaedhangkalaiyum	வேதங்களையும்	வேதங்களையும்
vaethangalaiyum	வேதங்களையும்	வேதங்களையும்
vaethangkalaiyum	வேதங்களையும்	வேதங்களையும்
vaedhangkal	வேதங்கள்	வேதங்கள்
vaethangal	வேதங்கள்	வேதங்கள்
vaethangkal	வேதங்கள்	வேதங்கள்
vaedham	வேதம்	வேதம்
vaetham	வேதம்	வேதம்
vedam	வேதம்	வேடம்
vedham	வேதம்	வேதம்
vaedhaala	வேதாள	வேதால
vaethaala	வேதாள	வேதால
vedhaala	வேதாள	வெதால
vaedhik	வேதிக்	வேதிக்
vaethik	வேதிக்	வேதிக்
vaedhiya	வேதிய	வேதிய
vaethiya	வேதிய	வேதிய
vaeyappatta	வேயப்பட்ட	வேயப்பட்ட
vaeril	வேரில்	வேரில்
giragavaasiyaa	வேற்று	கிரகவாசியா
gragavaasiyaa	வேற்று	கிரகவாசியா
kiragavaasiyaa	வேற்று	கிரகவாசியா
kirakavaasiyaa	வேற்று	கிறகவாசியா
kirakavaciya	வேற்று	கிறகவாசியா
vaeloor	வேலூர்	வேலூர்
vellore	வேலூர்	வெள்ரோர்
vaelaigalilum	வேலைகளிலும்	வேலைகளிலும்
vaelaikalilum	வேலைகளிலும்	வேலைகளிலும்
vaelaigalil	வேலைகளில்	வேலைகளில்
vaelaikalil	வேலைகளில்	வேலைகளில்
vaelaigalukku	வேலைகளுக்கு	வேலைகளுக்கு
vaelaikalukku	வேலைகளுக்கு	வேலைகளுக்கு
vaelaigalaiyum	வேலைகளையும்	வேலைகளையும்
vaelaikalaiyum	வேலைகளையும்	வேலைகளையும்
vaelaigal	வேலைகள்	வேலைகள்
vaelaikal	வேலைகள்	வேலைகள்
vaelaikkaaga	வேலைக்காக	வேலைக்காக
vaelaikkaaka	வேலைக்காக	வேலைக்காக
vaelaikku	வேலைக்கு	வேலைக்கு
chellavum	வேலைக்குச்	செல்லவும்
vaelaikkuch	வேலைக்குச்	வேலைக்குச்
vealaikkuch	வேலைக்குச்	வேலைக்குச்
thittangalukku	வேலைத்	திட்டங்களுக்கு
thittangkalukku	வேலைத்	திட்டங்களுக்கு
thittaththin	வேலைத்	திட்டத்தின்
tittankalukku	வேலைத்	திட்டங்களுக்கு
vaelaiththittangal	வேலைத்திட்டங்கள்	வேளைத்திட்டங்கள்
vaelaiththittanggal	வேலைத்திட்டங்கள்	வேளைத்திட்டங்கள்
vaelaiththittangkal	வேலைத்திட்டங்கள்	வேளைத்திட்டங்கள்
vaelaiyilirunththu	வேலையிலிருந்து	வேளையிலிருந்து
vaelaiyilirunthu	வேலையிலிருந்து	வேளையிலிருந்து
vealaiyilirunthu	வேலையிலிருந்து	வேளையிலிருந்து
vaelaiyum	வேலையும்	வேலையும்
vealaiyum	வேலையும்	வேலையும்
vaelaangganni	வேளாங்கண்ணி	வேலாங்கணின்
vaelaangkanni	வேளாங்கண்ணி	வேலாங்கணின்
vealaankanni	வேளாங்கண்ணி	வேலாங்கணி
velankanni	வேளாங்கண்ணி	வெளங்கனனி
vaiguntaththil	வைகுண்டத்தில்	வைகுந்தத்தில்
vaikundaththil	வைகுண்டத்தில்	வைக்குண்டத்தில்
vaiguntam	வைகுண்டம்	வைகுந்தம்
vaikundam	வைகுண்டம்	வைக்குண்டம்
vaiko	வைகோ	வைகோ
vaikoa	வைகோ	வைகோ
vaibava	வைபவ	வைபவ
vaipava	வைபவ	வைப்பவ
vaibav	வைபவ்	வைபவ்
vaibhav	வைபவ்	வைப்
vaipav	வைபவ்	வைப்பவ்
shaa	ஷா	ஷா
shah	ஷா	ஷா
shaavin	ஷாவின்	சாவின்
shahvin	ஷாவின்	ஷாவின்
shavin	ஷாவின்	ஷாவின்
scot	ஸ்காட்	ஸ்கோட்
scott	ஸ்காட்	ஸ்கோட்
skaat	ஸ்காட்	ஸ்காட்
skad	ஸ்காட்	ஸ்காட்
spais	ஸ்பைஸ்	ஸ்பைஸ்
spice	ஸ்பைஸ்	ஸ்பிக்
shreenivaacha	ஸ்ரீநிவாச	ஸ்ரீனிவாச
sreenivaasa	ஸ்ரீநிவாச	ஸ்ரீனிவாச
srinivaacha	ஸ்ரீநிவாச	ஸ்ரினிவாச
srinivaasa	ஸ்ரீநிவாச	ஸ்ரினிவாச
srinivasa	ஸ்ரீநிவாச	ஸ்ரீனிவசா
shreerangkam	ஸ்ரீரங்கம்	சிரீரங்கம்
sreerangam	ஸ்ரீரங்கம்	சிரீரங்கம்
srirangam	ஸ்ரீரங்கம்	சிரிரங்கம்
sriranggam	ஸ்ரீரங்கம்	ஸ்ரிரங்கம்
srirangkam	ஸ்ரீரங்கம்	சிறிரங்கம்
svaram	ஸ்வரம்	சுவராம்
swaram	ஸ்வரம்	சுவாரம்
sveet	ஸ்வீட்	ஸ்வீட்
sviid	ஸ்வீட்	ஸ்விட்
sweet	ஸ்வீட்	ஸ்வீட்
swiit	ஸ்வீட்	ஸ்வீட்
hangari	ஹங்கேரி	ஹங்கரி
hangary	ஹங்கேரி	ஹங்கரி
hanggaeri	ஹங்கேரி	ஹங்கேரி
hankeari	ஹங்கேரி	ஹங்கேரி
hankeeri	ஹங்கேரி	ஹங்கேரி
hungaeri	ஹங்கேரி	ஹுங்கேரி
hungari	ஹங்கேரி	ஹுங்கரி
hungarii	ஹங்கேரி	ஹுங்கரி
hungary	ஹங்கேரி	ஹங்கரி
hungeery	ஹங்கேரி	ஹங்கேரி
hungeri	ஹங்கேரி	ஹங்கரி
hungery	ஹங்கேரி	ஹங்கரி
huungarii	ஹங்கேரி	ஹுங்கரி
huungary	ஹங்கேரி	ஹங்கரி
huungery	ஹங்கேரி	ஹங்கரி
handar	ஹண்டர்	ஹாண்டர்
hantar	ஹண்டர்	ஹா்்டர்
hanter	ஹண்டர்	ஹாண்டர்
huntar	ஹண்டர்	ஹுண்டர்
huntarr	ஹண்டர்	ஹாண்டர்
hunter	ஹண்டர்	ஹுண்டர்
hunterr	ஹண்டர்	ஹாண்டர்
huuntar	ஹண்டர்	ஹாண்டர்
huunter	ஹண்டர்	ஹாண்டர்
huunterr	ஹண்டர்	ஹாண்டர்
hampi	ஹம்பி	ஹாம்பி
haam	ஹாம்	ஹாம்
haem	ஹாம்	ஹேம்
haim	ஹாம்	ஹேம்
ham	ஹாம்	ஹாம்
hamm	ஹாம்	ஹாம்
haum	ஹாம்	ஹாம்
hauum	ஹாம்	ஹாம்
haym	ஹாம்	ஹாம்
hom	ஹாம்	ஹாம்
home	ஹாம்	ஹாம்
haarisan	ஹாரிசன்	ஹாரிசன்
haarison	ஹாரிசன்	ஹாரிசன்
haarisun	ஹாரிசன்	ஹாரிசுன்
hareeson	ஹாரிசன்	ஹாரசன்
harisan	ஹாரிசன்	ஹரிசன்
harisaun	ஹாரிசன்	ஹரிசன்
harison	ஹாரிசன்	ஹாரிசன்
harreeson	ஹாரிசன்	ஹாரிசன்
harriison	ஹாரிசன்	ஹாரிசன்
harrisaun	ஹாரிசன்	ஹரரசின்
harrisauun	ஹாரிசன்	ஹரரசின்
harrison	ஹாரிசன்	ஹரரிசன்
he	ஹி	ஹே
hi	ஹி	ஹி
hills	ஹில்ஸ்	ஹில்ஸ்
hils	ஹில்ஸ்	ஹிஸ்
hook	ஹூக்	ஹாக்
hooq	ஹூக்	ஹூக்
huk	ஹூக்	ஹுக்
huuk	ஹூக்	ஹாக்
helsiinkii	ஹெல்சின்கி	ஹெல்சிங்கி
helsinki	ஹெல்சின்கி	ஹெல்சிங்கி
helsinqi	ஹெல்சின்கி	ஹெல்சிங்கி
health	ஹெல்த்	ஹெல்த்
haerath	ஹேரத்	ஹேரத்
hearath	ஹேரத்	ஹேரத்
herath	ஹேரத்	ஹேரத்
heyrath	ஹேரத்	ஹெரத்
haikkoo	ஹைக்கூ	ஹக்கோ
haiku	ஹைக்கூ	ஹைக்கு
hikkoo	ஹைக்கூ	ஹிக்கோ
haidrookarpan	ஹைட்ரோகார்பன்	ஹார்ரோகர்பன்
hidrocarbon	ஹைட்ரோகார்பன்	ஹிட்ரோக்பன்
hydrocarbon	ஹைட்ரோகார்பன்	ஹிட்ராக்பன்
hydroocarboon	ஹைட்ரோகார்பன்	ஹிட்ரூக்பான்
hoali	ஹோலி	ஹோலி
holee	ஹோலி	ஹாலி
holey	ஹோலி	ஹாலி
holi	ஹோலி	ஹாலி
holii	ஹோலி	ஹாலி
hollee	ஹோலி	ஹாலி
hollei	ஹோலி	ஹாலி
holley	ஹோலி	ஹாலி
holli	ஹோலி	ஹாலி
hollii	ஹோலி	ஹாலி
holly	ஹோலி	ஹாலி
holy	ஹோலி	ஹாலி
hooli	ஹோலி	ஹூலி
hoolii	ஹோலி	ஹூலி
hoollee	ஹோலி	ஹோலி
hoolley	ஹோலி	ஹாலி
hoolli	ஹோலி	ஹாலி
hoolly	ஹோலி	ஹாலி
hooly	ஹோலி	ஹாலி
huli	ஹோலி	ஹூலி
