Input	Target	Predicted
fire	ஃபயர்	பிரி
phayar	ஃபயர்	பயர்
baar	ஃபார்	பார்
bar	ஃபார்	பார்
far	ஃபார்	பார்
for	ஃபார்	போர்
hpaar	ஃபார்	ஹாப்
agatrtri	அகற்றி	அகற்றி
agattri	அகற்றி	அகற்றி
akatrtri	அகற்றி	அகற்றி
agatrtrinaar	அகற்றினார்	அகற்றிரான்
akatrinaar	அகற்றினார்	அகற்றினார்
akatrtrinaar	அகற்றினார்	அகற்றிரினார்
academi	அகாதமி	அகடமி
academy	அகாதமி	அசடேயி
angiekariththathu	அங்கீகரித்தது	அங்கிரித்தது
angkeekariththathu	அங்கீகரித்தது	அங்கிகரித்தது
angkeegaara	அங்கீகார	அங்கேகாக
angkeekaara	அங்கீகார	அங்கேகாக
angkeegaaraththai	அங்கீகாரத்தை	அங்கேகத்தை
angkeekaaraththai	அங்கீகாரத்தை	அங்கேகத்தைகளை
anggeegaaram	அங்கீகாரம்	அங்கேகரமம்
anggeekaaram	அங்கீகாரம்	அங்கேகரமம்
angiekaaram	அங்கீகாரம்	அங்கிகாமாம்
angkeekaaram	அங்கீகாரம்	அங்கேகரமம்
asan	அசன்	அசன்
aasin	அசின்	ஆசின்
asin	அசின்	அசின்
asaiyaadha	அசையாத	அசையாத
asaiyaatha	அசையாத	அசையாத
stationaree	அசையாத	ஸ்டாடியேன்
stationari	அசையாத	ஸ்டாடியிர்
stationarii	அசையாத	ஸ்டோடியிி
stationary	அசையாத	ஸ்டோடியா்
stationri	அசையாத	ஸ்டோடினிர்
stetionaree	அசையாத	ஸ்டீட்டியேன்
stetionary	அசையாத	ஸ்டீட்டியர்
stetionri	அசையாத	ஸ்டீட்டிரின்
asaiaamal	அசையாமல்	அசையால்
asaiyaamal	அசையாமல்	அசையாலம்
asaiyamal	அசையாமல்	அசையால்
ashoka	அசோக	அசோகா
asoga	அசோக	அசோகா
asoka	அசோக	அசோகா
ashokarin	அசோகரின்	அசோகரின்
asokarin	அசோகரின்	அசோகரின்
ashokar	அசோகர்	அசோகர்
asokar	அசோகர்	அசோகர்
ajai	அஜய்	ஆஜ்
ajaii	அஜய்	ஆஜ்சை
ajay	அஜய்	ஆஜ்ய்
aje	அஜய்	ஜேக்
azai	அஜய்	அழை
azay	அஜய்	அஜைய்
adakkinaar	அடக்கினார்	அடக்கினார்
adanggiyirukkum	அடங்கியிருக்கும்	அடங்கியிகுக்கும்
adangiyirukkum	அடங்கியிருக்கும்	அடங்கியுக்கிகும்
adankiyirukkum	அடங்கியிருக்கும்	அடங்கியுக்கிகும்
adangkiyullathu	அடங்கியுள்ளது	அடங்கியுள்ளது
adams	அடம்ஸ்	அடம்ஸ்
adigalaal	அடிகளால்	அடிகளால்
adigalin	அடிகளின்	அடிகளின்
adigalil	அடிகளில்	அடிகளில்
adikalil	அடிகளில்	அடிகளில்
adigalai	அடிகளை	அடிகளை
adigazhai	அடிகளை	அடிகளை
adikalai	அடிகளை	அடிகளை
adigal	அடிகள்	அடிகள்
adikal	அடிகள்	அடிகள்
adikkadip	அடிக்கடிப்	அடிக்கப்படி
adikkum	அடிக்கும்	அடிக்கும்
adippadaiyilaana	அடிப்படையிலான	அடிப்படையாளன
adippadaiyilaanadhu	அடிப்படையிலானது	அடிப்பையாளதுது
adippadaiyilaanathu	அடிப்படையிலானது	அடிப்பையாளதுது
adippadiyilaanathu	அடிப்படையிலானது	அடிப்பியாளதுதி
adiyaaga	அடியாக	அடியாக
adiyaga	அடியாக	அடியாக
adiyaka	அடியாக	அடியக
adiyin	அடியின்	அடியின்
adiyil	அடியில்	அடியில்
atiyil	அடியில்	அடியில்
adiye	அடியே	அடியே
adiyee	அடியே	அடியே
atiyee	அடியே	அடியே
adiyodu	அடியோடு	அடியோடு
adiyoodu	அடியோடு	அடியோடு
atiyootu	அடியோடு	அடியோடு
adivayirrai	அடிவயிற்றை	அடிவிறையர்
adivayitrai	அடிவயிற்றை	அடிவையிறை
adivayittrai	அடிவயிற்றை	அடிவையிற்ற
ativayirrai	அடிவயிற்றை	அடிவைறிறை
addes	அடிஸ்	அட்டிஸ்
addis	அடிஸ்	அட்டிஸ்
addiss	அடிஸ்	அட்டிஸ்
addys	அடிஸ்	அட்டிஸ்
addyss	அடிஸ்	அட்டிஸ்
ades	அடிஸ்	அடீஸ்
adis	அடிஸ்	அடிஸ்
adyss	அடிஸ்	அடிஸ்
adukka	அடுக்க	அடுக்க
adukkaaga	அடுக்காக	அடுக்காக
adukkaaka	அடுக்காக	அடுக்காக
atukkaaga	அடுக்காக	அடுக்காக
atukkaaka	அடுக்காக	அடுக்காக
aduththu	அடுத்து	அடுத்து
aduthu	அடுத்து	அடுது
adutthu	அடுத்து	அடுத்து
attaak	அட்டாக்	அட்டாக்
attack	அட்டாக்	அட்டச்க்
anivadhae	அணிவதே	அணிவதே
anivadhey	அணிவதே	அணிவதி
anivathae	அணிவதே	அணிவதே
anivathey	அணிவதே	அணிவதித்
adhigappadiyaana	அதிகப்படியான	அதிகப்படியான
athigappadiyaana	அதிகப்படியான	அதிகப்படியான
athikappatiyaana	அதிகப்படியான	அதிகப்படியான
adhikamaana	அதிகமான	அதிகமான
adikamaana	அதிகமான	அடிகமான
athikamaana	அதிகமான	அதிகமான
atikamaana	அதிகமான	அடிகமான
adhikamaanavai	அதிகமானவை	அதிகமாாவனை
athigamaanavai	அதிகமானவை	அதிகாானவை
athikamaanavai	அதிகமானவை	அதிகாாமைவ
adhikamaanoor	அதிகமானோர்	அதிகமாரும்
athigamaanoor	அதிகமானோர்	அதிகாமரும்
athikamaanoar	அதிகமானோர்	அதிகமாரும்
athiradith	அதிரடித்	அதிரித்தி
athiradip	அதிரடிப்	அதிராபிட்
adhilirundhdha	அதிலிருந்த	அதிரிலுந்த
athiliruntha	அதிலிருந்த	அதிரிலுந்த
adhilulla	அதிலுள்ள	அதில்லுள்
athilulla	அதிலுள்ள	அதில்லுள்
adele	அதிலே	அடேலி
adhilae	அதிலே	அதிலே
adhile	அதிலே	அதில்
athilae	அதிலே	அதிலே
athile	அதிலே	அதில்
adheedha	அதீத	அதீதா
adhidha	அதீத	அதிதா
atheetha	அதீத	அதீதா
athitha	அதீத	அதித்த
athaepoola	அதேபோல	அதீபோலா
atheepola	அதேபோல	அதீபால
athepola	அதேபோல	அதிபோலா
advaita	அத்வைத	அட்வைய
advaitha	அத்வைத	அட்வதை
athvaidha	அத்வைத	அத்வதை
athvaitha	அத்வைத	அத்வதை
advaidam	அத்வைதம்	அட்வடையம்
advaitham	அத்வைதம்	அட்வதைம்
adwaytham	அத்வைதம்	அட்வதயம்
athvaidham	அத்வைதம்	அத்வதைம்
athvaitham	அத்வைதம்	அத்வதைம்
andhach	அந்தச்	அந்தா
anthac	அந்தச்	அந்தா
anthach	அந்தச்	அந்தா
andhath	அந்தத்	அந்தத்
anthath	அந்தத்	அந்தத்
andham	அந்தம்	அந்தம்
antham	அந்தம்	அந்தம்
andhu	அந்து	அந்து
anthu	அந்து	அந்து
ana	அனா	அனா
anaa	அனா	அணா
anna	அனா	அன்ன
annaa	அனா	அண்ணா
anaadhai	அனாதை	அநாதை
anaathai	அனாதை	அநாதை
anaadhaiyaana	அனாதையான	அநதயாயன
anaathaiyaana	அனாதையான	அநாதயான
anupallavee	அனுபல்லவி	அணுபல்லேவே
anupallavi	அனுபல்லவி	அனுபல்பலி
anupazhavee	அனுபல்லவி	அனுபாலேவே
anupazhavi	அனுபல்லவி	அனுபாளவி
anubavikkum	அனுபவிக்கும்	அனுபவிக்கும்
anupavikkum	அனுபவிக்கும்	அனுபிக்கும்
anupavikum	அனுபவிக்கும்	அனுபாவிக்கும்
anuraadhapura	அனுராதபுர	அனுராதபாற
anuraathapura	அனுராதபுர	அனுராதபரு
anuradhapura	அனுராதபுர	அனுதரரப்ப
anurathapura	அனுராதபுர	அனுதரரப்ப
anushka	அனுஷ்கா	அனுச்க
anushkaa	அனுஷ்கா	அனுச்கா
andriyum	அன்றியும்	அன்றியும்
antriyum	அன்றியும்	அன்றியும்
abaabaa	அபாபா	அபாபா
ababa	அபாபா	அபபா
abbaba	அபாபா	அபபபா
apapa	அபாபா	அபபா
aboo	அபூ	அபோ
abu	அபூ	அபு
aboorva	அபூர்வ	அப்ரோவா
apoorva	அபூர்வ	அப்பர்
aboorvamaaga	அபூர்வமாக	அப்ரவமாக
aboorvamaaka	அபூர்வமாக	அப்ரவமாக
aburvamaaka	அபூர்வமாக	அபுர்மாகவ
apoorvamaaga	அபூர்வமாக	அப்பர்மாக
apoorvamaaka	அபூர்வமாக	அப்பர்மாக
abdhul	அப்துல்	அப்துல்
abdool	அப்துல்	அப்டோல்
abdul	அப்துல்	அப்புட்
abduul	அப்துல்	அப்புட்
abthul	அப்துல்	அப்துள்
appaguthiyil	அப்பகுதியில்	அப்பகுதியில்
appakuthiil	அப்பகுதியில்	அப்பகுதில்
appakuthiyil	அப்பகுதியில்	அப்பகுதியில்
appaguthiyai	அப்பகுதியை	அப்பகுதியை
appakuthiai	அப்பகுதியை	அப்பகுதியை
appakuthiyai	அப்பகுதியை	அப்பகுதியை
appadaththin	அப்படத்தின்	அப்படத்தின்
appadatthin	அப்படத்தின்	அப்படத்தின்
appadam	அப்படம்	அப்படம்
appen	அப்பெண்	அப்பின்
appenn	அப்பெண்	அப்பன்
appoluthuthaan	அப்பொழுதுதான்	அப்போதுதால்
appoluthuthan	அப்பொழுதுதான்	அப்பொழுத்தன
appozhuthuthaan	அப்பொழுதுதான்	அப்போதுத்தான்
apppozhuthuthaan	அப்பொழுதுதான்	அப்போதுத்தான்
aposthalar	அப்போஸ்தலர்	அப்போதர்
appoashthalar	அப்போஸ்தலர்	அப்போதர்ல்
appoosthalar	அப்போஸ்தலர்	அப்போர்ல்
apposthalar	அப்போஸ்தலர்	அப்போர்தல்
americargalin	அமெரிக்கர்களின்	அமீர்கிகளின்
americarkalin	அமெரிக்கர்களின்	அமீரிக்களின்
amerikkargalin	அமெரிக்கர்களின்	அமிர்க்கிகளின்
amerikkarkalin	அமெரிக்கர்களின்	அமிர்க்கிகளின்
americaavin	அமெரிக்காவின்	அமிராஜியா்
americavin	அமெரிக்காவின்	அமேரிக்கவின்
amerikkaavin	அமெரிக்காவின்	அமிர்க்கிவான்
americaavirkum	அமெரிக்காவிற்கும்	அமிரீச்கவியும்
americavirkkum	அமெரிக்காவிற்கும்	அமிரீச்கவிக்கும்
americavirkum	அமெரிக்காவிற்கும்	அமிரீக்கவிிம்
amerikkaavirkum	அமெரிக்காவிற்கும்	அமிர்க்கிவாக்கும்
americaavilum	அமெரிக்காவிலும்	அமிரீசாயவும்
americavilum	அமெரிக்காவிலும்	அமிரீசியவும்
amerikkaavilum	அமெரிக்காவிலும்	அமிர்க்கியாவும்
americaavilulla	அமெரிக்காவிலுள்ள	அமிரீச்களிலால்
americavilulla	அமெரிக்காவிலுள்ள	அமிரிய்லுவலலல்
amerikkaavilulla	அமெரிக்காவிலுள்ள	அமிரிக்களில்லால்
americaavudan	அமெரிக்காவுடன்	அமிராட்சாவு
americavudan	அமெரிக்காவுடன்	அமிரிட்வாடன்
amerikkaavudan	அமெரிக்காவுடன்	அமிர்க்கவாட்டன
americaavum	அமெரிக்காவும்	அமிராசியவும்
americavum	அமெரிக்காவும்	அமிரச்கவும்
amerikkaavum	அமெரிக்காவும்	அமிரிக்கவும்
amaichchu	அமைச்சு	அமைச்சு
amaichu	அமைச்சு	அமைச்
amaiththup	அமைத்துப்	அமைத்துப்
amaithup	அமைத்துப்	அமைத்துப்
amaitthup	அமைத்துப்	அமைத்துப்
amaiththum	அமைத்தும்	அமைத்தும்
amaithum	அமைத்தும்	அமைத்தும்
amaitthum	அமைத்தும்	அமைத்தும்
perrullatu	அமையப்	பெர்லுள்ளா
petrtrullathu	அமையப்	பெற்றுள்ளது
petrullathu	அமையப்	பெற்றுள்ளது
amsa	அம்ச	அம்சா
amchankalaaka	அம்சங்களாக	அம்சங்காக
amchankalaka	அம்சங்களாக	அம்சங்களாக
amsangalaaga	அம்சங்களாக	அம்சங்காக
amsangkalaaka	அம்சங்களாக	அம்சங்காக
amachankalin	அம்சங்களின்	அமசங்களின்
amasankalin	அம்சங்களின்	அமசங்களின்
amsangalin	அம்சங்களின்	அம்சங்களின்
amsangkalin	அம்சங்களின்	அம்சங்களின்
amchankalai	அம்சங்களை	அம்சங்களை
amsangalai	அம்சங்களை	அம்சங்களை
amsankalai	அம்சங்களை	அம்சங்களை
amsangalaiyum	அம்சங்களையும்	அம்சங்களையும்
amsangazhaiyum	அம்சங்களையும்	அம்சங்களையும்
amsanggalaiyum	அம்சங்களையும்	அம்சங்களையும்
amsangal	அம்சங்கள்	அம்சங்கள்
amsangazh	அம்சங்கள்	அம்சங்கள்
amsanggal	அம்சங்கள்	அம்சங்கள்
amsamaaga	அம்சமாக	அம்சாம
amcham	அம்சம்	அம்சம்
amsam	அம்சம்	அம்சம்
ammonium	அம்மோனியம்	அம்மோனியும்
ammoniumm	அம்மோனியம்	அம்மோனியம்
ammoniuum	அம்மோனியம்	அம்மோனியும்
ammoniuumm	அம்மோனியம்	அம்மோனியம்
ammoonium	அம்மோனியம்	அம்மோனியும்
ammooniumm	அம்மோனியம்	அம்மோனியம்
ammooniyam	அம்மோனியம்	அம்மோனியம்
amoniam	அம்மோனியம்	அமோனியம்
amoniamm	அம்மோனியம்	அமோனிமம்
amonium	அம்மோனியம்	அமோனியம்
amoniuum	அம்மோனியம்	அமோனியும்
amonnium	அம்மோனியம்	அம்னோமிய்
amonniuum	அம்மோனியம்	அம்னோயியும்
amooniamm	அம்மோனியம்	அமோனிமம்
amoonium	அம்மோனியம்	அமோனியம்
amoonnium	அம்மோனியம்	அமோன்னியம்
ammonia	அம்மோனியா	அம்மோனியா
ammoniaa	அம்மோனியா	அம்மோனாயா
ammoniia	அம்மோனியா	அம்மோனியா
ammoonia	அம்மோனியா	அம்மோனியா
ammooniaa	அம்மோனியா	அம்மோனாயா
ammooniia	அம்மோனியா	அம்மோனியா
ammooniya	அம்மோனியா	அம்மோனியா
amonia	அம்மோனியா	அமோனியா
amoniaa	அம்மோனியா	அமோனியா
amoniia	அம்மோனியா	அமோனியா
amoonia	அம்மோனியா	அமோனியா
arakkanai	அரக்கனை	அரக்கைன
arrakkanai	அரக்கனை	அறர்ககைன்
aruga	அருக	அருக
aruka	அருக	அருக
arugaaga	அருகாக	அருகாக
arukaaka	அருகாக	அருகாக
arukaka	அருகாக	அருககக
aarun	அருண்	ஆருன்
aaruun	அருண்	ஜருன்
aroon	அருண்	அரோன்
arrun	அருண்	அருர்
arruun	அருண்	அருர்
arun	அருண்	அருண்
arunn	அருண்	அருண்
aruun	அருண்	அருண்
aruunn	அருண்	ரருண்
vijai	அருண்	விஜை
vijay	அருண்	விஜய்
arundhi	அருந்தி	அருந்தி
arunthi	அருந்தி	அருந்தி
arppaniththaar	அர்ப்பணித்தார்	அர்ப்பிந்தார்
arppaniththu	அர்ப்பணித்து	அர்பிப்ந்து
arimuga	அறிமுகம	அரிமுக
arimugama	அறிமுகம	அறிமுமாக
arimuka	அறிமுகம	அரிமுக
mudikirathu	அறிய	முடிகிறது
mudiyaatha	அறிய	முடியாத
mutikiratu	அறிய	முடிகிற்றது
mutiyata	அறிய	முடியாட
ariyak	அறியக்	அரியக்
ariyakkoodiya	அறியக்கூடிய	அரியாக்கோடிய
ariyappadum	அறியப்படும்	அறியப்படும்
ariyappattavar	அறியப்பட்டவர்	அறியப்பட்டர்
ariyappattaar	அறியப்பட்டார்	அறியப்பட்டார்
ariyappattaalum	அறியப்பட்டாலும்	அறியப்பட்டாலும்
ariyappattulladhu	அறியப்பட்டுள்ளது	அறியப்பட்டுள்ளது
ariyappattullathu	அறியப்பட்டுள்ளது	அறியப்பட்டுள்ளது
ariyavillai	அறியவில்லை	அறியவில்லை
ariyavum	அறியவும்	அறியவும்
ariyaa	அறியா	அரியா
ariyaamal	அறியாமல்	அரியாலம்
arivadhil	அறிவதில்	அறிவதில்
arivathaal	அறிவதில்	அறிவதால்
arivathil	அறிவதில்	அறிவதில்
arivaar	அறிவார்	அரிவார்
arivaal	அறிவால்	அறிவால்
arivippu	அறிவிப்பு	அரிவிப்பு
arivippugal	அறிவிப்புகள்	அறிவிப்புகள்
arivippukal	அறிவிப்புகள்	அறிவிப்புகள்
arivippup	அறிவிப்புப்	அரிவிப்புப்
arivae	அறிவே	அரிவே
arupathu	அறுபது	அருபது
ali	அலி	அலி
alii	அலி	அலி
aligaar	அலிகார்	அழிகார்
aligar	அலிகார்	அளிகர்
aligarh	அலிகார்	அழிகர்
alikaar	அலிகார்	அழிகார்
aliyin	அலியின்	அலியின்
aliyai	அலியை	அழியை
alboansaa	அல்போன்சா	அல்போனா
alphonse	அல்போன்சா	அல்போன்
alpoansaa	அல்போன்சா	அல்போனா
alavu	அளவு	அளவு
alavugalail	அளவுகளில்	அளவுகளைல்
alavugalil	அளவுகளில்	அளவுகளில்
alavukalil	அளவுகளில்	அவளுகளில்
alavugalaik	அளவுகளைக்	அளவுகளை
alavukalaik	அளவுகளைக்	அளவுகளைக்
alavugalaiyum	அளவுகளையும்	அளவுகளையும்
alavukalaiyum	அளவுகளையும்	அளவுகளையும்
alavukkaana	அளவுக்கான	அளவுக்கான
alavukku	அளவுக்கு	அளவுக்கு
alavudan	அளவுடன்	அளவுடன்
alavum	அளவும்	அவலும்
azhiththa	அழித்த	அழித்த
azhiththal	அழித்தல்	அழித்தல்
alaippugalai	அழைப்புகளை	அளைப்புகளை
alaippukalai	அழைப்புகளை	அளைப்புகளை
azhaippukalai	அழைப்புகளை	அழைப்புகளை
alaippugal	அழைப்புகள்	அளைப்புகள்
alaippukal	அழைப்புகள்	அளைப்புகள்
azhaippukal	அழைப்புகள்	அழைப்புகள்
avadhaara	அவதார	அவதார
avathaara	அவதார	அவதார
avathaaranggalai	அவதாரங்களை	அவதர்களைகள்
avathaarangkalai	அவதாரங்களை	அவதர்களைகள்
avathaaramaaga	அவதாரமாக	அதவராமாக
avathaaramaaka	அவதாரமாக	அதவராமாக
avathaaramaana	அவதாரமான	அதவராான
avadhaaram	அவதாரம்	அதவராம்
avathaaram	அவதாரம்	அதவராம்
avaraagavae	அவராகவே	அவரகாவே
avaraakavae	அவராகவே	அவரகாவே
avaridamae	அவரிடமே	அவரிதமே
avaritamae	அவரிடமே	அவரிதேயம்
avatrtrul	அவற்றுள்	அவற்றுள்
avatrul	அவற்றுள்	அவற்று
avattrul	அவற்றுள்	அவற்றுள்
avalum	அவளும்	அவலும்
avalai	அவளை	அவலை
astro	அஸ்ட்ரோ	அஸ்டர்
astroa	அஸ்ட்ரோ	அஸ்டோர
aagindradhu	ஆகின்றது	ஆகின்றது
aagindrathu	ஆகின்றது	ஆகின்றது
aakinrathu	ஆகின்றது	ஆகின்றது
aakintrathu	ஆகின்றது	ஆகின்றது
aasirama	ஆசிரம	ஆசிரமா
aasiramaththin	ஆசிரமத்தின்	ஆசிரமத்தின்
aachiramaththai	ஆசிரமத்தை	ஆசிரம்தைத்
aasiramaththai	ஆசிரமத்தை	ஆசரிமத்தை
aachiriyaraaka	ஆசிரியராக	ஆசிரியாரா
aasiriyaraaga	ஆசிரியராக	ஆசிரியாக
aasiriyaraaka	ஆசிரியராக	ஆசிரியாக
assiriyaraaga	ஆசிரியராக	அச்சிரியா
aasiriyaraakak	ஆசிரியராகக்	ஆசிரியாகக்
assiriyaraagak	ஆசிரியராகக்	அச்சிரியாக
asar	ஆசேர்	அசர்
aseer	ஆசேர்	அசீர்
aser	ஆசேர்	அசர்
ashar	ஆசேர்	அசர்
asher	ஆசேர்	அசர்
iser	ஆசேர்	ஹேர்
ysar	ஆசேர்	சார்
yseer	ஆசேர்	சேர்
yser	ஆசேர்	சேர்
ysher	ஆசேர்	சேர்
aadi	ஆடி	ஆடி
aadii	ஆடி	ஆடி
adi	ஆடி	அடி
adii	ஆடி	அடி
aodi	ஆடி	அடி
aodii	ஆடி	அடிடி
audi	ஆடி	ஆடி
audii	ஆடி	ஆடி
auudi	ஆடி	ஆடி
avdi	ஆடி	அவ்டி
awdi	ஆடி	அவ்டி
awdii	ஆடி	அவ்டி
maatham	ஆடி	மாதம்
matam	ஆடி	மடாம்
aadu	ஆடு	ஆடு
aadukalin	ஆடுகளின்	ஆடுகளின்
aadugalukku	ஆடுகளுக்கு	ஆடுகளுக்கு
aadukalukku	ஆடுகளுக்கு	ஆடுகளுக்கு
aadugalai	ஆடுகளை	ஆடுகளை
aadukalai	ஆடுகளை	ஆடுகளை
aadugal	ஆடுகள்	ஆடுகள்
aadukal	ஆடுகள்	ஆடுகள்
aanaagap	ஆணாகப்	ஆணாகப்
aanaakap	ஆணாகப்	ஆணாகப்
kulantai	ஆண்	குழந்தை
kulanthai	ஆண்	குழந்தை
kuzhandhai	ஆண்	குழந்தை
aangalil	ஆண்களில்	ஆங்களில்
aankalil	ஆண்களில்	ஆங்களில்
aangalikku	ஆண்களுக்கு	ஆங்களிக்கு
aangalukku	ஆண்களுக்கு	ஆங்களுக்கு
aangalukkum	ஆண்களுக்கும்	ஆங்களுக்கும்
aankalukkum	ஆண்களுக்கும்	ஆங்களுக்கும்
aangaludan	ஆண்களுடன்	ஆங்களுடன்
aankaludan	ஆண்களுடன்	ஆங்களுடன்
aangalai	ஆண்களை	ஆங்களை
aankalai	ஆண்களை	ஆங்களை
aangalaiyum	ஆண்களையும்	ஆங்களையும்
aankalaiyum	ஆண்களையும்	ஆங்களையும்
aankaliayum	ஆண்களையும்	ஆங்களியமும்
aandaan	ஆண்டான்	ஆண்டான்
aantaan	ஆண்டான்	ஆந்தான்
aandaar	ஆண்டார்	ஆந்தார்
aantaar	ஆண்டார்	ஆந்தார்
aadhanaal	ஆதனால்	ஆதானல்
aathanaal	ஆதனால்	ஆதானல்
aatharavaliththa	ஆதரவளித்த	ஆதரவிலத்த
aatharavaliththu	ஆதரவளித்து	ஆதரவில்து
aatharavaagap	ஆதரவாகப்	ஆதரவாகப்
aatharavaakap	ஆதரவாகப்	ஆதரவாகப்
aatharavaap	ஆதரவாகப்	ஆதராவப்
aatharavaagavum	ஆதரவாகவும்	ஆதரவாகவும்
aatharavaakavum	ஆதரவாகவும்	ஆதரவவாகும்
aatharavin	ஆதரவின்	ஆதரவின்
aatharavil	ஆதரவில்	ஆதரவில்
aatharikka	ஆதரிக்க	ஆதரிக்க
aatharikkum	ஆதரிக்கும்	ஆதரிக்கும்
aathmaavum	ஆத்மாவும்	ஆத்மாவும்
aathmaavai	ஆத்மாவை	ஆத்மாவை
aanthaigal	ஆந்தைகள்	ஆந்தைகள்
aanthaikal	ஆந்தைகள்	ஆந்தைகள்
aanththaigal	ஆந்தைகள்	ஆந்தைகள்
aanththaikal	ஆந்தைகள்	ஆந்தைகள்
aanand	ஆனந்த்	ஆணண்ட்
aananth	ஆனந்த்	ஆணந்த்
aananthdh	ஆனந்த்	ஆணந்தி
aananthth	ஆனந்த்	ஆநந்த்
anand	ஆனந்த்	அணந்த்
anandd	ஆனந்த்	அணந்தி
anandh	ஆனந்த்	அணந்த்
anannd	ஆனந்த்	அணந்தின்
annt	ஆனந்த்	அன்்
aanmaavin	ஆன்மாவின்	ஆண்மாவின்
aanmaavai	ஆன்மாவை	ஆண்மாவை
aabathaithk	ஆபத்தைக்	ஆபதத்தை
aabaththaik	ஆபத்தைக்	ஆபத்தைக்
aapaththaik	ஆபத்தைக்	ஆபத்தைக்
aapgaaniya	ஆப்கானிய	ஆப்பானியா
aapkaaniya	ஆப்கானிய	ஆப்கானியா
afghaaniya	ஆப்கானிய	ஆப்கானியா
afghaniya	ஆப்கானிய	ஆப்கினாய
aappirikkaa	ஆப்பிரிக்கா	ஆப்பிரிக்கா
aaprikkaa	ஆப்பிரிக்கா	ஆப்ரிக்கா
affrica	ஆப்பிரிக்கா	ஆப்பிராஸ்
afreca	ஆப்பிரிக்கா	ஆப்ரிஸ்
africa	ஆப்பிரிக்கா	ஆப்ரிகா
africaa	ஆப்பிரிக்கா	ஆப்ரியாக்
afrika	ஆப்பிரிக்கா	ஆபிர்கா
afriqa	ஆப்பிரிக்கா	ஆப்ரிகா
aphphrica	ஆப்பிரிக்கா	அப்பிராஷ்
aphreca	ஆப்பிரிக்கா	அப்ரிஸ்
aphrica	ஆப்பிரிக்கா	அபிர்சா
aphricaa	ஆப்பிரிக்கா	அபிர்சா
aphrika	ஆப்பிரிக்கா	அபிர்கி
appirikka	ஆப்பிரிக்கா	அப்பிரிக்க
appricaa	ஆப்பிரிக்கா	அப்பிராசி
efrica	ஆப்பிரிக்கா	எரிப்சா
ephrica	ஆப்பிரிக்கா	எபிர்சா
aappirikkaavin	ஆப்பிரிக்காவின்	ஆப்பிர்கிவாகின்
africaavin	ஆப்பிரிக்காவின்	ஆப்ரிசாவின்
aappirikkaavil	ஆப்பிரிக்காவில்	ஆப்பிர்கிவாகில்
africaavil	ஆப்பிரிக்காவில்	ஆப்ரிசாவில்
africavil	ஆப்பிரிக்காவில்	ஆப்ரிச்கவில்
ain	ஆயின்	அன்
ainn	ஆயின்	அன்
ayin	ஆயின்	அயின்
ein	ஆயின்	என்
einn	ஆயின்	என்
en	ஆயின்	என்
enn	ஆயின்	என்
aayerak	ஆயிரக்	ஆயரக்
aayirak	ஆயிரக்	ஆயிரக்
aayeraththil	ஆயிரத்தில்	ஏயரத்தில்
aayiraththil	ஆயிரத்தில்	ஆயிரத்தில்
aayut	ஆயுட்	ஆயுட்
out	ஆயுட்	ஓட்
aaivu	ஆய்வு	ஆய்வு
aayvu	ஆய்வு	ஆய்வு
aaivukalilum	ஆய்வுகளிலும்	ஆய்வுகளுள்ளம்
aayvugalilum	ஆய்வுகளிலும்	ஆய்வுகளிலும்
aayvukalilum	ஆய்வுகளிலும்	ஆய்வுகளிலும்
aaivukalil	ஆய்வுகளில்	ஆய்வுகளில்
aayvugalil	ஆய்வுகளில்	ஆய்வுகளில்
aayvukalil	ஆய்வுகளில்	ஆய்வுகளில்
aaivukalum	ஆய்வுகளும்	ஆய்வுகளும்
aayvugalum	ஆய்வுகளும்	ஆய்வுகளும்
aayvukalum	ஆய்வுகளும்	ஆய்வுகளும்
aaivukalai	ஆய்வுகளை	ஆய்வுகளை
aayvugalai	ஆய்வுகளை	ஆய்வுகளை
aayvukalai	ஆய்வுகளை	ஆய்வுகளை
aaivukkum	ஆய்வுக்கும்	ஆய்வுக்கும்
aayvukkum	ஆய்வுக்கும்	ஆய்வுக்கும்
aaivuch	ஆய்வுச்	ஆய்வுச்
aayvuch	ஆய்வுச்	ஆய்வுச்
aaivup	ஆய்வுப்	ஆய்வுப்
aayvup	ஆய்வுப்	ஆய்வுப்
aaraathanaa	ஆராதனா	ஆராதான
aradhana	ஆராதனா	அரதன
aaraayndha	ஆராய்ந்த	ஆராய்ந்த
aaraayntha	ஆராய்ந்த	ஆராய்ந்த
aaraaynththa	ஆராய்ந்த	ஆராய்ந்த
aaraayndhanar	ஆராய்ந்தனர்	ஆராயந்தனர்
aaraaynthanar	ஆராய்ந்தனர்	ஆராயந்தனர்
aaraaynththanar	ஆராய்ந்தனர்	ஆராய்ந்தனர்
aaraainthaar	ஆராய்ந்தார்	ஆராய்ந்தார்
aaraaynthaar	ஆராய்ந்தார்	ஆராய்ந்தார்
aaraaynththaar	ஆராய்ந்தார்	ஆராய்ந்தார்
aaraainthu	ஆராய்ந்து	ஆராய்ந்து
aaraaynthu	ஆராய்ந்து	ஆராய்ந்து
araaynththu	ஆராய்ந்து	அரைய்ந்து
aariyargalaal	ஆரியர்களால்	ஆரியர்களால்
aariyarkalaal	ஆரியர்களால்	ஆரியர்களால்
aariyargal	ஆரியர்கள்	ஆரியர்கள்
aariyarkal	ஆரியர்கள்	ஆரியர்கள்
aardar	ஆர்டர்	ஆர்டர்
ardar	ஆர்டர்	அர்டர்
arder	ஆர்டர்	அர்டர்
ordar	ஆர்டர்	ஒர்டர்
order	ஆர்டர்	ரா்டர்
aarppaattaththil	ஆர்ப்பாட்டத்தில்	ஆர்பாட்தப்தில்
aarva	ஆர்வ	ஆர்வா
aarvaththaal	ஆர்வத்தால்	ஆர்வத்தால்
aarvaththin	ஆர்வத்தின்	ஆர்வத்தின்
aarvaththukku	ஆர்வத்துக்கு	ஆர்வத்துக்கு
aarvaththudan	ஆர்வத்துடன்	ஆர்வத்துடன்
aarvaththutan	ஆர்வத்துடன்	ஆர்வத்துடன்
aarvaththaiyum	ஆர்வத்தையும்	ஆர்வத்தையும்
aarvamaaga	ஆர்வமாக	ஆர்வமாக
aarvamaaka	ஆர்வமாக	ஆர்வமாக
aarvam	ஆர்வம்	ஆர்வம்
aarvalarum	ஆர்வலரும்	ஆர்வாளும்
aarvee	ஆர்வி	ஆர்வே
aarvi	ஆர்வி	ஆர்வி
harvey	ஆர்வி	ஹர்வி
aaraam	ஆறாம்	ஆராம்
aaruthal	ஆறுதல்	ஆருதல்
aatralaaka	ஆற்றலாக	ஆற்றால
aatrtralaaga	ஆற்றலாக	ஆற்றாளாக
aatrtralaaka	ஆற்றலாக	ஆற்றாளாக
aatrtralum	ஆற்றலும்	ஆற்றாலும்
aattralum	ஆற்றலும்	ஆற்றாலும்
aatrtralae	ஆற்றலே	ஆற்றாலே
aatrtralilae	ஆற்றலே	ஆற்றிலேலை
aattralae	ஆற்றலே	ஆற்றால
aattrale	ஆற்றலே	ஆற்றால்
aatri	ஆற்றி	ஆற்றி
aatrtri	ஆற்றி	ஆற்றி
aattree	ஆற்றி	ஆற்றே
aattri	ஆற்றி	ஆற்றி
aatrtrinaar	ஆற்றினார்	ஆற்றினார்
aattrinaar	ஆற்றினார்	ஆற்றினார்
aatrtrin	ஆற்றின்	ஆற்றின்
aattrin	ஆற்றின்	ஆற்றின்
aatrtril	ஆற்றில்	ஆற்றில்
aattril	ஆற்றில்	ஆற்றில்
aatrtruppaduththum	ஆற்றுப்படுத்தும்	ஏற்றப்படுத்தும்
aattruppaduththum	ஆற்றுப்படுத்தும்	ஏற்றப்படுத்தும்
aattruppadutthum	ஆற்றுப்படுத்தும்	ஏற்றப்படுத்தும்
aatrtrum	ஆற்றும்	ஆற்றும்
aattrum	ஆற்றும்	ஆற்றும்
aalaya	ஆலய	ஆலாய
aalayangalil	ஆலயங்களில்	ஆலயங்களில்
aalayanggalil	ஆலயங்களில்	ஆலயங்களில்
aalayangkalil	ஆலயங்களில்	ஆலயங்களில்
aalayankalil	ஆலயங்களில்	ஆலயங்களில்
aalayangal	ஆலயங்கள்	ஆயலங்கள்
aalayanggal	ஆலயங்கள்	ஆயலங்கள்
aalayangkal	ஆலயங்கள்	ஆயலங்கள்
aalayankal	ஆலயங்கள்	ஆயலங்கள்
aalayach	ஆலயச்	ஆலைச்
aalayaththin	ஆலயத்தின்	ஆலதைத்தின்
aalayatthin	ஆலயத்தின்	ஆலயத்தின்
aalayaththil	ஆலயத்தில்	ஆலத்தில்
aalayaththai	ஆலயத்தை	ஆலைத்தை
aalayamaaga	ஆலயமாக	ஆலாயமாக
aalayamaaka	ஆலயமாக	ஆலாயமாக
aalayam	ஆலயம்	ஆலாயம்
aaloachanai	ஆலோசனை	ஆலோசனை
aaloasanai	ஆலோசனை	ஆலோசனை
aalosanai	ஆலோசனை	ஆலோசனை
aaloachanaikalai	ஆலோசனைகளை	ஆலோசனைகளை
aaloasanaigalai	ஆலோசனைகளை	ஆலோசனைகளை
aaloasanaikalai	ஆலோசனைகளை	ஆலோசனைகளை
aalosanaigalai	ஆலோசனைகளை	ஆலோசனைகளை
aalosanaikalai	ஆலோசனைகளை	ஆலோசனைகளை
aaloachanaik	ஆலோசனைக்	ஆலோசனைக்
aaloasanaik	ஆலோசனைக்	ஆலோசனைக்
aalosanaik	ஆலோசனைக்	ஆலோசனைக்
aaloasanaiyin	ஆலோசனையின்	ஆலோசனையின்
aalosanaiyin	ஆலோசனையின்	ஆலோசனையின்
aalosanaiyinpadi	ஆலோசனையின்	ஆலோசனையிடை
aaloasanaiyai	ஆலோசனையை	ஆலோசனையை
aalosanaiyai	ஆலோசனையை	ஆலோசனையை
aashis	ஆஷிஷ்	ஆசிஸ்
aashish	ஆஷிஷ்	ஆசிஷ்
aasis	ஆஷிஷ்	ஆசிஸ்
asees	ஆஷிஷ்	அசீஸ்
asheesh	ஆஷிஷ்	அசேஷ்
ashish	ஆஷிஷ்	அசிஷ்
asiis	ஆஷிஷ்	அசிஸ்
asis	ஆஷிஷ்	அசிஸ்
aash	ஆஷ்	ஆச்
ash	ஆஷ்	அச்
engkae	இங்கே	இங்கே
ingae	இங்கே	இங்கே
ingkae	இங்கே	இங்கே
engkaeyae	இங்கேயே	இங்கேயே
ingaeyae	இங்கேயே	இங்கேயே
ingkaeyae	இங்கேயே	இங்கேயே
ichaikkaruvikalin	இசைக்கருவிகளின்	இசைக்குவரிக்கின்
isaikkaruvigalin	இசைக்கருவிகளின்	இசைக்குரரிகளின்
ichaikkaruvikal	இசைக்கருவிகள்	இசைக்குவர்கள்
isaikkaruvigal	இசைக்கருவிகள்	இசைக்குவர்கள்
isaiyamaippaalar	இசையமைப்பாளர்	இசையமைப்பால்
isaiymaippaalar	இசையமைப்பாளர்	இசையமைப்பால்
isaiyamaippaalargalin	இசையமைப்பாளர்களின்	இசையமைப்பாளர்களில்
isaiyamaippaalargalil	இசையமைப்பாளர்களில்	இசையமைப்பளர்களில்
isaiyamaippaalargal	இசையமைப்பாளர்கள்	இசையமைப்பாளர்கள்
echchaalai	இச்சாலை	இச்சாலை
ichchaalai	இச்சாலை	இச்சாலை
echchaalaiyil	இச்சாலையில்	இச்சாலையில்
ichchaalaiyil	இச்சாலையில்	இச்சாளையில்
idaththilulla	இடத்திலுள்ள	இடத்திலுள்ள
idamaagavum	இடமாகவும்	இடமாகவும்
idamthaan	இடம்தான்	இடம்தான்
idampeyarum	இடம்பெயரும்	இடம்பெயரும்
idugai	இடுகை	இடுகை
idugaigal	இடுகைகள்	இடுகைகள்
idaik	இடைக்	இடைக்
idaiyae	இடையே	இடையே
idaiyaeyum	இடையேயும்	இடையையும்
inaiyaana	இணையான	இணையான
idhanathu	இதனது	இதனது
ithanathu	இதனது	இதனது
idhanil	இதனில்	இதனில்
ithanil	இதனில்	இதனில்
idhanpoathu	இதன்போது	இதன்போது
ithanpoathu	இதன்போது	இதன்போது
idazhaalar	இதழாளர்	இதலார்
idhazhaalar	இதழாளர்	இதலார்
ithalaalar	இதழாளர்	இதலாலர்
ithazhaalar	இதழாளர்	இதலார்
iththiraippadaththil	இத்திரைப்படத்தில்	இத்திரப்பத்தில்
iththiraippadam	இத்திரைப்படம்	இத்திரப்படைம்
iththirappadam	இத்திரைப்படம்	இத்திரப்படம்
iththeevin	இத்தீவின்	இத்தீவின்
iththaervil	இத்தேர்வில்	இத்தேர்வில்
iththervil	இத்தேர்வில்	இத்திர்வில்
iththoguppil	இத்தொகுப்பில்	இத்துக்போபில்
iththokuppil	இத்தொகுப்பில்	இத்துக்போபில்
iththogaiyai	இத்தொகையை	இத்தோகையை
iththokaiyai	இத்தொகையை	இத்தோகையை
india	இந்தியா	இந்தியா
indiia	இந்தியா	இந்தியா
indiiaa	இந்தியா	இந்தியா
indiya	இந்தியா	இந்திய
indiyaa	இந்தியா	இந்தியா
inthiyaa	இந்தியா	இந்தியா
inththiyaa	இந்தியா	இந்தியா
intiya	இந்தியா	இந்தியா
indiavin	இந்தியாவின்	இந்தியாவின்
inthiyaavin	இந்தியாவின்	இந்தியாவின்
inththiyaavin	இந்தியாவின்	இந்தியாவின்
indiavilum	இந்தியாவிலும்	இந்தியவிலும்
inthiyaavilum	இந்தியாவிலும்	இந்தியாவிலும்
inththiyaavilum	இந்தியாவிலும்	இந்தியாவிலும்
indiavilulla	இந்தியாவிலுள்ள	இந்தியில்லால்
inthiyaavilulla	இந்தியாவிலுள்ள	இந்தியிலுள்ளாள்
inththiyaavilulla	இந்தியாவிலுள்ள	இந்தியில்லுள்ள
indiavukkaana	இந்தியாவுக்கான	இந்திவுக்கான
inthiyaavukkaana	இந்தியாவுக்கான	இந்தியாவுக்கா
inththiyaavukkaana	இந்தியாவுக்கான	இந்தியாவுவாக
indiavukku	இந்தியாவுக்கு	இந்திவுக்கு
inthiyaavukku	இந்தியாவுக்கு	இந்தியாவுக்கு
inththiyaavukku	இந்தியாவுக்கு	இந்தியாவுக்கு
indiavudan	இந்தியாவுடன்	இந்டியாடுவது
inthiyaavudan	இந்தியாவுடன்	இந்தியாவுட்ட
inththiyaavudan	இந்தியாவுடன்	இந்தியாவுடன்
indiavum	இந்தியாவும்	இந்தியாவும்
inthiyaavum	இந்தியாவும்	இந்தியாவும்
inththiyaavum	இந்தியாவும்	இந்தியாவும்
indhukkalaal	இந்துக்களால்	இந்துகள்லால்
indhukkalin	இந்துக்களின்	இந்துகளின்
indhukkalil	இந்துக்களில்	இந்துகளில்
indhukkalin	இந்துக்களில்	இந்துகளின்
indhukkalum	இந்துக்களும்	இந்துகளும்
hindukkalaiyum	இந்துக்களையும்	இிந்துக்களையும்
indhukkalaiyum	இந்துக்களையும்	இந்துகளையும்
hindukkal	இந்துக்கள்	இந்திக்கள்
indhukkal	இந்துக்கள்	இந்துக்கள்
inthoa	இந்தோ	இந்தோ
inththoa	இந்தோ	இந்தோ
innaattin	இந்நாட்டின்	இந்நாட்டின்
inthnaattin	இந்நாட்டின்	இந்தான்டின்
innigazhvu	இந்நிகழ்வு	இந்நிகழு
inthnikalvu	இந்நிகழ்வு	இந்திகளுவ்
inniruvanaththin	இந்நிறுவனத்தின்	இந்றினுவதின்த்
inthniruvanaththin	இந்நிறுவனத்தின்	இந்திருந்தவின்
inniruvanaththil	இந்நிறுவனத்தில்	இந்நிருவதித்தில்
inthniruvanaththil	இந்நிறுவனத்தில்	இந்திருந்திவதில்
inaththavargalin	இனத்தவர்களின்	இநத்தவர்களின்
inaththavarkalin	இனத்தவர்களின்	இநத்தவர்களின்
inaththavargal	இனத்தவர்கள்	இநத்தவர்கள்
inaththavarkal	இனத்தவர்கள்	இநத்தவர்கள்
inaam	இனாம்	இநாம்
inimai	இனிமை	இணிமை
inimaiyaaga	இனிமையாக	இணியமாய
inimaiyaaka	இனிமையாக	இணியமையாக
inimaiyaana	இனிமையான	இணிமையான
innalgalukku	இன்னல்களுக்கு	இந்லங்களுக்கு
innelkalukku	இன்னல்களுக்கு	இந்நெல்குக்கு
innalgalai	இன்னல்களை	இந்லங்களை
innalkalai	இன்னல்களை	இந்நலைகள்
innelkalai	இன்னல்களை	இந்நல்களை
indriyae	இன்றியே	இந்திரிய
inriya	இன்றியே	இன்றிய
intriyae	இன்றியே	இந்திரிய
ippayir	இப்பயிர்	இப்பாயிர்
ippalliyin	இப்பள்ளியின்	இப்பல்லியில்
ippoathellaam	இப்போதெல்லாம்	இப்போல்லாலம்
ippothellaam	இப்போதெல்லாம்	இப்போல்லலம்
imayamalai	இமயமலை	இமையால
imayamalaiyil	இமயமலையில்	இமையமலையில்
imchai	இம்சை	இம்சை
imsai	இம்சை	இம்சை
eemfal	இம்பால்	ஏம்பால்
eemphal	இம்பால்	எம்பால்
emfal	இம்பால்	எம்பால்
emphal	இம்பால்	எம்பால்
iimphal	இம்பால்	இம்பால்
imfal	இம்பால்	இம்பால்
impal	இம்பால்	இம்பால்
imphal	இம்பால்	இம்பால்
immaraththin	இம்மரத்தின்	இம்மாதத்தின்
eiyakkum	இயக்கும்	இயக்கும்
iyakkum	இயக்கும்	இயக்கும்
eiyanra	இயன்ற	இயன்ற
iyandra	இயன்ற	இயன்ற
iyantra	இயன்ற	இயன்ற
eiyanrathu	இயன்றது	இயன்றது
iyandradhu	இயன்றது	இயன்றது
iyantrathu	இயன்றது	இயன்றது
eiyalpai	இயல்பை	இயல்பை
iyalbai	இயல்பை	இயல்பை
iyalbhai	இயல்பை	இயல்பை
iyalpai	இயல்பை	இயல்பை
eiyalpaik	இயல்பைக்	இயல்பைக்
iyalbaik	இயல்பைக்	இயல்பைக்
iyalpaik	இயல்பைக்	இயல்பைக்
eraani	இராணி	இராணி
iraani	இராணி	இராணி
raani	இராணி	ராணி
irukkakkoodiya	இருக்கக்கூடிய	இருக்கோக்கியோ
irukkath	இருக்கத்	இருக்கத்
irukkavum	இருக்கவும்	இருக்கவும்
irukkavae	இருக்கவே	இருக்கவே
irukkavea	இருக்கவே	இருக்கவே
irunooru	இருநூறு	இருநோரு
irunoorukkum	இருநூறுக்கும்	இருநோருக்கும்
irupaal	இருபால்	இருபால்
iruppu	இருப்பு	இருப்பு
irrupputh	இருப்புத்	இருப்புத்
irupputh	இருப்புத்	இருப்புத்
irruppup	இருப்புப்	இருப்புப்
iruppup	இருப்புப்	இருப்புப்
iruppaik	இருப்பைக்	இருப்பைக்
iruma	இரும	இருமா
irumbu	இரும்பு	இரும்பு
irumpu	இரும்பு	இரும்பு
irumbuk	இரும்புக்	இரும்புக்
irumpuk	இரும்புக்	இரும்புக்
irumbuch	இரும்புச்	இரும்புச்
irumpuch	இரும்புச்	இரும்புச்
irul	இருள்	இருல்
erangku	இறங்கு	இரங்கு
irangku	இறங்கு	இரங்கு
irangu	இறங்கு	இரங்கு
erangkum	இறங்கும்	இரங்கும்
irangkum	இறங்கும்	இரங்கும்
irangum	இறங்கும்	இரங்கும்
erappai	இறப்பை	இரப்பை
irappai	இறப்பை	இரப்பை
iravaadha	இறவாத	இரவாத
iravaatha	இறவாத	இரவாத
iruga	இறுக	இருக
iruka	இறுக	இருக
irugiya	இறுகிய	இருகிய
irukiya	இறுகிய	இருகிய
irukkiya	இறுகிய	இருக்கிய
irugum	இறுகும்	இருகும்
irukum	இறுகும்	இருகும்
iraivan	இறைவன்	இரைவன்
ilakkangal	இலக்கங்கள்	இலக்கங்கள்
ilakkangkal	இலக்கங்கள்	இலக்கங்கள்
ilakkana	இலக்கண	இலக்கன
ilakkanangkalai	இலக்கணங்களை	இலகங்கங்களை
ilakkanangkali	இலக்கணங்களை	இலகங்கங்களில்
ilakkanankalai	இலக்கணங்களை	இலக்கங்களை
ilakkanangkal	இலக்கணங்கள்	இலகங்கங்கள்
ilakkanankal	இலக்கணங்கள்	இலக்கங்களன்
ilakkanach	இலக்கணச்	இலக்கசன்
ilakkanaththil	இலக்கணத்தில்	இலக்கத்தில்
ilakkanaththai	இலக்கணத்தை	இலக்கத்தை
ilakkanap	இலக்கணப்	இலக்கப்பன்
ilakkanamum	இலக்கணமும்	இலக்கமமம்
ilakkanam	இலக்கணம்	இலக்கமம்
ilakkai	இலக்கை	இலக்கை
ilatcham	இலட்சம்	இளச்சம்
latcham	இலட்சம்	லட்சம்
ilaa	இலா	இலா
ilaechaana	இலேசான	இளசசான
ilaesaana	இலேசான	இலசானா
laesaana	இலேசான	லேசான
leasaana	இலேசான	லேசானா
pengaludan	இளம்	பெங்களுடன்
penkalutan	இளம்	பெங்களுடன்
ilampen	இளம்பெண்	இலம்பென்
ilampengalai	இளம்பெண்களை	இலம்பங்களை
ilampengaludan	இளம்பெண்களை	இளம்பங்களுடன்
ilampenkalai	இளம்பெண்களை	இலம்பெங்களை
ilampengal	இளம்பெண்கள்	இலம்பங்கள்
ilampenkal	இளம்பெண்கள்	இலம்பெங்கள்
ilavayadhu	இளவயது	இளவையு
ilavayath	இளவயது	இளவையத்
ilavayathu	இளவயது	இளவையது
izhaiya	இழைய	இழைய
ivanaal	இவனால்	இவாால்
evatrtrukku	இவற்றுக்கு	இவற்றுக்கு
ivatrtrukku	இவற்றுக்கு	இவற்றுக்கு
ivattrukku	இவற்றுக்கு	இவற்றுக்கு
evatrtrul	இவற்றுள்	இவற்றுள்
ivatrtrul	இவற்றுள்	இவற்றுள்
ivatrul	இவற்றுள்	இவற்று
evaikalin	இவைகளின்	இவைகளின்
ivaigalin	இவைகளின்	இவைகளின்
evaikalilirunthu	இவைகளிலிருந்து	இவைகளிிிருந்து
ivaigalilirundhu	இவைகளிலிருந்து	இவைகளிிிருந்து
evaikalum	இவைகளும்	இவைகளும்
ivaigalum	இவைகளும்	இவைகளும்
evaikal	இவைகள்	இவைகள்
ivaigal	இவைகள்	இவைகள்
evaiyum	இவையும்	இவையும்
ivaiyum	இவையும்	இவையும்
ivvaiyum	இவையும்	இவ்வையும்
eekkal	ஈக்கள்	எக்கல்
eesanai	ஈசனை	இசனை
eeyam	ஈயம்	ஏயம்
iiyam	ஈயம்	இயம்
iyam	ஈயம்	இயம்
eerppuch	ஈர்ப்புச்	ஏற்புப்
ugandhadhu	உகந்தது	ககந்தது
uganthathu	உகந்தது	ககந்தது
ukandhathu	உகந்தது	உகந்தது
hussain	உசேன்	ஹச்சன்
usaen	உசேன்	சசன்
udanpaadu	உடன்பாடு	உடன்பாடு
udalin	உடலின்	உடலின்
udalaith	உடலைத்	உடலைத்
udalaip	உடலைப்	உடலைப்
udalaiyum	உடலையும்	உடலையும்
udalnala	உடல்நல	உடல்லா
udalnalathai	உடல்நலத்தை	உடல்லைை
udalnalaththai	உடல்நலத்தை	உடல்லைத்தை
udalnalththai	உடல்நலத்தை	உடல்நத்தை
udalnalan	உடல்நலன்	உடல்லனன்
udalnalap	உடல்நலப்	உடல்லாப்
udaindha	உடைந்த	உடைந்த
udaintha	உடைந்த	உடைந்த
udaindhaal	உடைந்தால்	உடைந்தல்
udainthaal	உடைந்தால்	உடைந்தல்
udaindhu	உடைந்து	உடைந்து
udainththu	உடைந்து	உடைந்து
udainthu	உடைந்து	உடைந்து
vaendum	உட்கொள்ள	வேண்டும்
vendum	உட்கொள்ள	வெண்டும்
ventum	உட்கொள்ள	வெண்டும்
utkollaamal	உட்கொள்ளாமல்	உட்கொல்லாலம்
utkolluvathan	உட்கொள்வதன்	உட்கொலுவதல்
utkolvathan	உட்கொள்வதன்	உட்கோலதவன்
utkolvathaal	உட்கொள்வதால்	உட்கொல்லாதல்
udpura	உட்புற	உடுப்
utpura	உட்புற	உட்புர
udpurach	உட்புறச்	உடுப்ரச்
utpurach	உட்புறச்	உட்பருச்
udpuraththil	உட்புறத்தில்	உடுப்திதில்
utpuraththil	உட்புறத்தில்	உட்பத்திர்ல்
udpuraththai	உட்புறத்தை	உடுப்ததை
utpuraththai	உட்புறத்தை	உட்பத்துரை
udpuramulla	உட்புறமுள்ள	உடுப்புரலும்
utpuramulla	உட்புறமுள்ள	உட்புறுள்ளா
unarvadhu	உணர்வது	உரண்வது
unarvathu	உணர்வது	உணர்வது
unavugalilum	உணவுகளிலும்	உணவுகளிலும்
unavukalilum	உணவுகளிலும்	உணவுகளிலும்
unavugalai	உணவுகளை	உணவுகளை
unavukalai	உணவுகளை	உணவுகளை
unavugal	உணவுகள்	உணவுகள்
unavukal	உணவுகள்	உணவுகள்
unavukkaaga	உணவுக்காக	உணவுகககக
unavukkaaka	உணவுக்காக	உணவுகககக
unavukku	உணவுக்கு	உணவுக்கு
thurai	உணவுத்	துரை
turai	உணவுத்	துரை
unavupporutkal	உணவுப்பொருட்கள்	உணவுப்பட்டுள்ள
unavupporuttkal	உணவுப்பொருட்கள்	உணவுப்பட்டுகள்
unavum	உணவும்	உணவும்
undadhaal	உண்டதால்	உண்டால்
undathaal	உண்டதால்	உண்டால்
untathaal	உண்டதால்	உண்டால்
unadanar	உண்டனர்	உணடனர்
undanar	உண்டனர்	உண்டனர்
untanar	உண்டனர்	உண்டனர்
undaana	உண்டான	உண்டான
untaana	உண்டான	உண்டான
undi	உண்டி	உண்டி
uththiyoaga	உத்தியோக	உத்தியோக
uththiyoaka	உத்தியோக	உத்தியோக
ubachaara	உபசார	உபசார
ubasaara	உபசார	உபாார
upasaara	உபசார	உபாார
ubanidatham	உபநிடதம்	உபணிடத்தம்
ubanitatham	உபநிடதம்	உபணிடத்தம்
upanidatham	உபநிடதம்	உணபிடத்தம்
upanitatham	உபநிடதம்	உணபித்தம்
uppin	உப்பின்	உப்பின்
uppugal	உப்புகள்	உப்புகள்
uppukal	உப்புகள்	உப்புகள்
uppuk	உப்புக்	உப்புக்
uppukkal	உப்புக்கள்	உப்புக்கள்
uppukku	உப்புக்கு	உப்புக்கு
ubbusam	உப்புசம்	பபு்சம்
uppusam	உப்புசம்	உப்பும்
uppudan	உப்புடன்	உப்புடன்
umakku	உமக்கு	அமக்கு
umilum	உமிழும்	உமிழும்
umizhum	உமிழும்	உமிழும்
uyirina	உயிரின	உயிரினா
uyirinaththin	உயிரினத்தின்	உயிரிந்ததின்
uyirinaththai	உயிரினத்தை	உயிரிந்தை
uyirinamaana	உயிரினமான	உயிரினமான
urachiya	உரசிய	உரச்யி
urasiya	உரசிய	உரசிய
urugiya	உருகிய	உருகிய
urukiya	உருகிய	உருகிய
uruvappadangkalai	உருவப்படங்களை	உருவப்படங்களை
uruvappadankalai	உருவப்படங்களை	உருவப்படங்களை
uruvappatangkalai	உருவப்படங்களை	உருவப்படங்கள்
uruvaaga	உருவாக	உருவாக
uruvaaka	உருவாக	உருவாக
uruvaagaamal	உருவாகாமல்	உருவாகமால்
uruvaagiyulladhaaga	உருவாகியுள்ளதாக	உருவாயிக்குளதால்
uruvaagiyullathaaga	உருவாகியுள்ளதாக	உருவாயிக்குளதால்
uruvaagiyulladhu	உருவாகியுள்ளது	உருவாகியுள்ளது
uruvaagiyullathu	உருவாகியுள்ளது	உருவாயிகளுதுது
uruvaagiyullana	உருவாகியுள்ளன	உருவாயிகளுள்ள
uruvaagum	உருவாகும்	உருவாகும்
uruvaagumboadhu	உருவாகும்போது	உருவாகும்போது
uruvaagumpoathu	உருவாகும்போது	உருவாகும்பது
urvaagumpoathu	உருவாகும்போது	உர்வாக்குமோது
uruvaaguvadhai	உருவாகுவதை	உருவாகுவதை
uruvaaguvathai	உருவாகுவதை	உருவாகுதை
vaendum	உருவாக்க	வேண்டும்
veendum	உருவாக்க	வெண்டும்
veentum	உருவாக்க	வெண்டும்
vendum	உருவாக்க	வெண்டும்
ventum	உருவாக்க	வெண்டும்
uruvaakkak	உருவாக்கக்	உருவாக்க்
uruvaakkakkoodiya	உருவாக்கக்கூடிய	உருவாக்கோடியக்கோ
uruvaakkath	உருவாக்கத்	உருவாக்கத்
uruvaakkaththi	உருவாக்கத்தில்	உருவாக்கத்தி
uruvaakkaththil	உருவாக்கத்தில்	உருவாக்கத்தில்
uruvaakkaththai	உருவாக்கத்தை	உருவாக்கத்தை
uruvaakkam	உருவாக்கம்	உருவாக்கம்
uruvaakkavum	உருவாக்கவும்	உருவாகக்கும்
uruvaakkuthal	உருவாக்குதல்	உருவாக்குதல்
uruvaakkum	உருவாக்கும்	உருவாக்கும்
uruvaakkumpoathu	உருவாக்கும்போது	உருவாக்கும்போது
uruvaakkuvathai	உருவாக்குவதை	உருவாக்குதை
uraiyaadal	உரையாடல்	உரையாடல்
uraiyaatal	உரையாடல்	உரையாடல்
uraiyaadalgal	உரையாடல்கள்	உரையாளத்கள்
uraiyaadalkal	உரையாடல்கள்	உரையாளத்்கள்
uraiyaatalkal	உரையாடல்கள்	உரையாடல்கள்
urangaatha	உறங்காத	உரங்காத
urangkaatha	உறங்காத	உரங்காத
urangku	உறங்கு	உரங்கு
urangu	உறங்கு	உரங்கு
urangkum	உறங்கும்	உரங்கும்
urangum	உறங்கும்	உரங்கும்
urangkumpoathu	உறங்கும்போது	உரங்கும்போது
urangumpoathu	உறங்கும்போது	உரங்கும்போது
uravaal	உறவால்	உரவால்
uruthunaiyaaga	உறுதுணையாக	உருதனுயாக
uruthunaiyaaka	உறுதுணையாக	உருதனையாக
uruthunaiyaga	உறுதுணையாக	உருதனையுக
uruppugali	உறுப்புகளில்	உருப்புகளி
uruppugalil	உறுப்புகளில்	உருப்புகளில்
uruppugalum	உறுப்புகளும்	உருப்புகளும்
uruppugalai	உறுப்புகளை	உருப்புகளை
utrtru	உற்று	உற்று
uttru	உற்று	உற்று
ulagaich	உலகைச்	உலகைச்
ulunththu	உளுந்து	உழுந்து
ulunthu	உளுந்து	உழுந்து
ullaga	உள்ளக	உள்ளக
ullaka	உள்ளக	உள்ளக
ullagap	உள்ளகப்	உள்ளகப்
ullakap	உள்ளகப்	உள்ளகப்
ulladakkangalai	உள்ளடக்கங்களை	உள்ளடங்களைக்
ulladakkangkalai	உள்ளடக்கங்களை	உள்ளடங்களைக்க
ullatakkangkali	உள்ளடக்கங்களை	உள்ளடங்களகக்கி
ulladakkangal	உள்ளடக்கங்கள்	உள்ளடங்ககள்
ulladakkangkal	உள்ளடக்கங்கள்	உள்ளடங்ககக்க்
ullatakkangkal	உள்ளடக்கங்கள்	உள்ளடங்ககக்க்
ulladakkaththai	உள்ளடக்கத்தை	உள்ளதக்கத்தை
ullatakkaththai	உள்ளடக்கத்தை	உள்ளதக்கத்தை
ulladakkam	உள்ளடக்கம்	உள்ளடக்கம்
ullatakkam	உள்ளடக்கம்	உள்ளத்காம்
ulladakki	உள்ளடக்கி	உள்ளடக்கி
ullatakki	உள்ளடக்கி	உள்ளாடகிக்
ullapadi	உள்ளபடி	உள்ளபாடி
ullavaraaga	உள்ளவராக	உள்ளவராக
ullavaraaka	உள்ளவராக	உள்ளவராக
ulleedu	உள்ளீடு	உள்ளிடு
ulleedugalai	உள்ளீடுகளை	உள்ளுடிகளை
ulleedukalai	உள்ளீடுகளை	உள்ளுடைகளை
ulleedugal	உள்ளீடுகள்	உள்ளிடுகள்
ulleedukal	உள்ளீடுகள்	உள்ளிடுகள்
ulvaanggum	உள்வாங்கும்	உள்வாங்கும்
ulvaangkum	உள்வாங்கும்	உள்வாங்கும்
ulvaankum	உள்வாங்கும்	உள்வாங்கும்
ulaippil	உழைப்பில்	உலைப்பில்
uzhaippil	உழைப்பில்	உழைப்பில்
uavar	உவர்	உவர்
uvar	உவர்	உவர்
ookkuvippathu	ஊக்குவிப்பது	ஒக்குவிப்பது
uookkuvippathu	ஊக்குவிப்பது	ஊக்குவிப்புது
uukkuvippathu	ஊக்குவிப்பது	உக்குவிப்புது
ookkuvippu	ஊக்குவிப்பு	ஒக்குவிப்பு
uookkuvippu	ஊக்குவிப்பு	ஊக்குவிப்பு
uukkuvippu	ஊக்குவிப்பு	ஊக்குபிப்பு
oosal	ஊசல்	ஹோல்
uoosal	ஊசல்	சோல்
uusal	ஊசல்	சசல்
oonchal	ஊஞ்சல்	ஒன்சல்
oonchchal	ஊஞ்சல்	ஒன்சல்
unchal	ஊஞ்சல்	உஞ்சல்
uunchchal	ஊஞ்சல்	உஞ்சசல்
uunjsal	ஊஞ்சல்	உஞ்சல்
oodagath	ஊடகத்	ஊடகத்
oodakath	ஊடகத்	ஊடககத்
udakath	ஊடகத்	உடகத்
uudakath	ஊடகத்	ஊடகத்
oodagaththin	ஊடகத்தின்	ஊடகத்தின்
oodakaththin	ஊடகத்தின்	ஊகடத்தின்
udagaththin	ஊடகத்தின்	உடகத்தின்
uudakaththin	ஊடகத்தின்	ஊடகத்தின்
oodagamaaga	ஊடகமாக	ஊடகமாக
oodakamaaka	ஊடகமாக	ஊடகமாக
udakamaaka	ஊடகமாக	உடகமாக
uudakamaaka	ஊடகமாக	ஊடகமாக
oodaadum	ஊடாடும்	ஓடாடும்
uoodaadum	ஊடாடும்	ஊடாடும்
uudaadum	ஊடாடும்	ஊடாடும்
oothaak	ஊதாக்	ஊதாக்
uuthaak	ஊதாக்	ஊதாக்
ooran	ஊரன்	ஒரான்
uooran	ஊரன்	ஊரான்
uuraan	ஊரன்	உராண்
uuran	ஊரன்	உரான்
ooraar	ஊரார்	ஒரார்
uuraar	ஊரார்	ஊரார்
oorilirunththu	ஊரிலிருந்து	ஒரிலிருந்து
oorilirunthu	ஊரிலிருந்து	ஒரிலிருந்து
uurilirunththu	ஊரிலிருந்து	உரிலிருந்து
uurilirunthu	ஊரிலிருந்து	உரிலிருந்து
oorilaeyae	ஊரிலேயே	ஒரிலேயே
urilaeyae	ஊரிலேயே	உரிலேயே
uurilaeyae	ஊரிலேயே	உரிலேயே
oorvalanggal	ஊர்வலங்கள்	ஒர்வங்கள்கள்
oorvalangkal	ஊர்வலங்கள்	ஒர்வங்கள்கள்
uurvalangkal	ஊர்வலங்கள்	உர்வங்கள்கள்
oorvalaththil	ஊர்வலத்தில்	ஒர்வலத்தில்
uurvalaththil	ஊர்வலத்தில்	உர்வத்தலில்
oorvalam	ஊர்வலம்	ஒர்வலம்
uurvalam	ஊர்வலம்	உர்வலம்
ootrtruvathu	ஊற்றுவது	ஒற்றுவது
ootruvathu	ஊற்றுவது	ஒற்றுவது
uutrtruvathu	ஊற்றுவது	உற்றுவது
accon	எகான்	அக்சன்
akkon	எகான்	அக்கோன்
akon	எகான்	அக்ன்
akonn	எகான்	அக்னன்
aqon	எகான்	அக்னோ
aqonn	எகான்	அகோன்
aqqon	எகான்	அக்கோன்
yekan	எகான்	எக்ன்
edisan	எடிசன்	எடிசன்
edison	எடிசன்	எடிஸ்
idison	எடிசன்	டிஸ்டன்
yedisan	எடிசன்	எடிசன்
edukkappada	எடுக்கப்பட	எடுக்கப்பட்ட
yedukappatta	எடுக்கப்பட	எடுகப்பட்ட
etta	எட்ட	ஏட்ட
ettavillai	எட்டவில்லை	ஏட்டிவலில்
yettavillai	எட்டவில்லை	ஏட்டியலில்
ettaatha	எட்டாத	எட்டாத
ettiya	எட்டிய	எட்டிய
yettiya	எட்டிய	எட்டிய
ennikkaigal	எண்ணிக்கைகள்	எண்ணிக்ககள்
ennikkaikal	எண்ணிக்கைகள்	எண்ணிக்ககள்
yennikkaigal	எண்ணிக்கைகள்	எண்ணிக்ககள்
ennikkaikku	எண்ணிக்கைக்கு	எண்ணிக்கைக்கு
yennikkaikku	எண்ணிக்கைக்கு	எண்ணிக்கைக்கு
ennikkaiyin	எண்ணிக்கையின்	எண்ணிக்கையின்
ennikkaiyum	எண்ணிக்கையும்	எண்ணிக்கையும்
ennikkaiyai	எண்ணிக்கையை	எண்நிக்கையை
ennikkaiyaiyum	எண்ணிக்கையையும்	எண்நிக்கையையும்
ennima	எண்ணிம	என்னிம
ethirkatchiyaaga	எதிர்கட்சியாக	எதிர்க்டியாக
ethirkatchiyaaka	எதிர்கட்சியாக	எதிர்க்டியாக
yedhirkatchiyaaga	எதிர்கட்சியாக	எதிர்க்கிடாயாக
edhirpaarppugalai	எதிர்பார்ப்புகளை	எதிர்ப்பாளப்பாகு
ethirpaarppugalai	எதிர்பார்ப்புகளை	எதிர்ப்பாளப்பாகு
ethirpaarppukalai	எதிர்பார்ப்புகளை	எதிர்ப்பாள்புகளை
eththanaiyo	எத்தனையோ	எத்தாணைய
eththanaiyoa	எத்தனையோ	எத்தானைய
paeyar	எனப்	பேயர்
payar	எனப்	பயர்
peyar	எனப்	பெயர்
enil	எனில்	எனில்
endroa	என்றோ	என்றோ
entroa	என்றோ	என்றோ
em	எம்	எம்
yem	எம்	எம்
emdan	எம்டன்	எட்மன்
emdon	எம்டன்	அட்மன்
emtan	எம்டன்	எட்மன்
emton	எம்டன்	அட்டன்
yemtan	எம்டன்	எட்மான்
eythinaar	எய்தினார்	எத்திரான்
yeithinaar	எய்தினார்	எத்தினார்
eythiya	எய்திய	எத்தியா
yeithiya	எய்திய	எத்தியா
eythu	எய்து	எத்து
yeithu	எய்து	எத்து
eru	எரு	ஈரு
yeru	எரு	ஏறு
eruvai	எருவை	இருவை
yeruvai	எருவை	ஏறுவை
elaktraan	எலக்ட்ரான்	எல்கார்டன்
electron	எலக்ட்ரான்	எலெக்டர்
ilektraan	எலக்ட்ரான்	இல்க்றான்
ilektron	எலக்ட்ரான்	இல்க்ரூட்
ileqtraan	எலக்ட்ரான்	இல்க்ராட்டன்
ileqtron	எலக்ட்ரான்	இலிக்ரோட்
ilictron	எலக்ட்ரான்	இலிஸ்டர்
iliktraan	எலக்ட்ரான்	இலிக்றான்
iliktron	எலக்ட்ரான்	இலிக்ரோட்
yelakdran	எலக்ட்ரான்	எலக்கரன்
yelaktraan	எலக்ட்ரான்	எல்காற்ன்
elaktraankalai	எலக்ட்ரான்களை	எல்்கராண்களை
electronkalai	எலக்ட்ரான்களை	எலெக்ரெஸ்கிலா
yekaltraankalai	எலக்ட்ரான்களை	ஏல்க்றாளைகளை
ellaippura	எல்லைப்புற	எல்லைப்புர
yellaippura	எல்லைப்புற	எல்லைப்புர
elithaakkum	எளிதாக்கும்	எழித்தாகும்
yelidhaakkum	எளிதாக்கும்	எழித்தாகும்
yelithaakkum	எளிதாக்கும்	எழித்தாகும்
elimaiyaakavum	எளிமையாகவும்	எளிமையாகவும்
yelimaiyaagavum	எளிமையாகவும்	எலிமையாகவும்
yelimaiyaakavum	எளிமையாகவும்	எலிமையாகவும்
ezhuthiyullaar	எழுதியுள்ளார்	எழுதியிலுள்ள
yeluthiyullaar	எழுதியுள்ளார்	எழுதியிலுள்ள
evvakai	எவ்வகை	இவ்வகை
yavvakai	எவ்வகை	இவ்கவை
evvaaraana	எவ்வாறான	இவ்வாான
yavvaaraana	எவ்வாறான	இவ்வாாரா
aa	ஏ	ஆ
ae	ஏ	ஹே
e	ஏ	ஹே
ee	ஏ	ஈ
acre	ஏக்கர்	அக்ரி
aekkar	ஏக்கர்	ஏக்கர்
ekkar	ஏக்கர்	எக்கர்
aesiyaa	ஏசியா	செய்யா
asia	ஏசியா	அசியா
esia	ஏசியா	எசியா
angeles	ஏஞ்சல்ஸ்	அங்கேலிஸ்
angels	ஏஞ்சல்ஸ்	அங்கில்
angilis	ஏஞ்சல்ஸ்	அங்கிலிஸ்
aden	ஏடன்	அடீன்
adenn	ஏடன்	அடென்
aidan	ஏடன்	அடைன்
edan	ஏடன்	எடன்
eden	ஏடன்	எடின்
edenn	ஏடன்	எடின்
eedan	ஏடன்	ஈடன்
eton	ஏடன்	டோட்
iton	ஏடன்	டோட்
eetan	ஏதன்	ஏட்டன்
eithaan	ஏதன்	எத்தான்
eithan	ஏதன்	எத்தான்
ethan	ஏதன்	எத்னா
ethann	ஏதன்	எதனன்
eythan	ஏதன்	எத்தன்
iithaan	ஏதன்	இதாதன்
ithan	ஏதன்	இதன்
ithann	ஏதன்	இதன்
iythan	ஏதன்	இத்தன்
aerpada	ஏற்பட	ஏற்பட
yerpada	ஏற்பட	ஏற்பட
aerpadath	ஏற்படத்	ஏற்படத்
yerpadath	ஏற்படத்	ஏற்படத்
aerpadap	ஏற்படப்	ஏற்படப்
yerpadap	ஏற்படப்	ஏற்படப்
aerpadin	ஏற்படின்	ஏற்படின்
earpadin	ஏற்படின்	ஏற்படின்
yerpadin	ஏற்படின்	ஏற்படின்
aerpaduththina	ஏற்படுத்தின	ஏற்படுத்தின
yaerpaduththina	ஏற்படுத்தின	ஏற்படுத்தின
yerpaduththina	ஏற்படுத்தின	ஏற்படுத்தின
aerpadumpoathu	ஏற்படும்போது	ஏற்படும்போது
yaerpadumpoathu	ஏற்படும்போது	ஏற்பாடும்போது
yerpadumpoathu	ஏற்படும்போது	ஏற்படும்போது
aerpaduvathu	ஏற்படுவது	ஏற்படுவது
yaerpaduvathu	ஏற்படுவது	ஏற்படுவது
yerpaduvathu	ஏற்படுவது	ஏற்படுவது
aerpaduvathai	ஏற்படுவதை	ஏற்படுதைவை
earpaduvathai	ஏற்படுவதை	ஏற்படுவதை
yerpaduvathai	ஏற்படுவதை	ஏற்படுதையை
aetrtrukkonda	ஏற்றுக்கொண்ட	ஏற்றுக்கோண்ட
eattrukkonda	ஏற்றுக்கொண்ட	ஏற்றுக்கோட்டன
aetrtrukkondaar	ஏற்றுக்கொண்டார்	ஏற்றுக்கொண்டார்
eattrukkondaar	ஏற்றுக்கொண்டார்	ஏற்றுக்கொண்டார்
aela	ஏல	ஏலா
eala	ஏல	ஆலா
yaela	ஏல	ஏலா
aelaththil	ஏலத்தில்	ஏழத்தில்
ealaththil	ஏலத்தில்	ஏலத்தில்
yaelaththil	ஏலத்தில்	ஏலத்தில்
aelam	ஏலம்	ஏலம்
ealam	ஏலம்	ஆலம்
yaelam	ஏலம்	ஏயல்
aelanam	ஏளனம்	ஏழனம்
ealanam	ஏளனம்	இலாமம்
eelanam	ஏளனம்	எலனம்
yelanam	ஏளனம்	எலனம்
ainaavin	ஐநாவின்	ஆண்வாின்
aynaavin	ஐநாவின்	அயன்வின்
inaavin	ஐநாவின்	இணாவின்
aippachi	ஐப்பசி	இப்பாசி
aippasi	ஐப்பசி	அப்பாசி
ippachi	ஐப்பசி	இப்பாசி
aivarum	ஐவரும்	இவர்மு
ivarum	ஐவரும்	இவரும்
odunggi	ஒடுங்கி	ஒடுங்கி
odungi	ஒடுங்கி	ஒடுங்கி
odungki	ஒடுங்கி	ஒடுங்கி
odungiya	ஒடுங்கிய	ஒடுங்கிய
odungkiya	ஒடுங்கிய	ஒடுங்கிய
oppandhangalil	ஒப்பந்தங்களில்	பப்பந்தங்களில்
oppanthangalil	ஒப்பந்தங்களில்	பப்பந்தங்களில்
oppanthangkalil	ஒப்பந்தங்களில்	போப்பங்களில்
oppandhangalai	ஒப்பந்தங்களை	போப்பண்்களை
oppanthangalai	ஒப்பந்தங்களை	போப்பண்்களை
oppanthangkalai	ஒப்பந்தங்களை	போப்பங்களைக்
oppandhangal	ஒப்பந்தங்கள்	போப்பண்்கள்
oppandhangall	ஒப்பந்தங்கள்	போப்பங்கள்கள்
oppanthangall	ஒப்பந்தங்கள்	போப்பங்கள்ள்
oppanthangkal	ஒப்பந்தங்கள்	போப்பங்கள்
oppandhathin	ஒப்பந்தத்தின்	ஒப்பத்தின்
oppandhaththin	ஒப்பந்தத்தின்	ஒப்பத்தின்தின்
oppanthaththin	ஒப்பந்தத்தின்	ஒப்பத்ததின்
oppandhaththai	ஒப்பந்தத்தை	ஒப்பத்தைத்
oppanthathai	ஒப்பந்தத்தை	ஒப்பத்தை
oppanthaththai	ஒப்பந்தத்தை	ஒப்பத்தைத்
oppukkolgiraar	ஒப்புக்கொள்கிறார்	ஒப்புக்கிலிர்க்
oppukkolgirar	ஒப்புக்கொள்கிறார்	ஒப்புக்கிருக்கள்
oppukkolkiraar	ஒப்புக்கொள்கிறார்	ஒப்புக்கிலிர்க்கர்
oppukkolkirar	ஒப்புக்கொள்கிறார்	ஒப்புக்கிருக்கள்
omeega	ஒமேகா	அமேகா
omeegaa	ஒமேகா	அமேகா
omeeka	ஒமேகா	அமேகா
omega	ஒமேகா	அமேக
omegaa	ஒமேகா	அமேகா
ommeega	ஒமேகா	அம்மேக
ommeegaa	ஒமேகா	மம்சாக
ommega	ஒமேகா	அம்மாக
ommegaa	ஒமேகா	மம்காயா
orisa	ஒரிசா	ஒரிஷா
orisaa	ஒரிசா	ஒரிசா
orissa	ஒரிசா	ஒரிஸ்
orissaa	ஒரிசா	ஒரிஸ்சா
orrisa	ஒரிசா	ஒரிஸ்
orichaavil	ஒரிசாவில்	ஒரிசாவில்
orisavil	ஒரிசாவில்	ஒரிசவில்
orissavil	ஒரிசாவில்	ஒரிஸ்வில்
orunginaipai	ஒருங்கிணைப்பை	ஒருங்கிணைப்
orunginaippai	ஒருங்கிணைப்பை	ஒருங்கைப்பைப்
orunkinaippai	ஒருங்கிணைப்பை	ஒருங்கைப்பைப்
orupadi	ஒருபடி	ஒருபாடி
orupati	ஒருபடி	ஒருபாடி
oruphadi	ஒருபடி	ஒருபதி
otrarkal	ஒற்றர்கள்	ஒற்றகள்
ottrargal	ஒற்றர்கள்	ஒற்றகள்
ottrarkal	ஒற்றர்கள்	ஒற்றக்கள்
ovvoar	ஒவ்வோர்	ஓவ்வோர்
ovvoor	ஒவ்வோர்	ஓவ்வோர்
ovvor	ஒவ்வோர்	வவ்வோர்
oangi	ஓங்கி	ஆங்கி
ongi	ஓங்கி	ஒங்கி
oongi	ஓங்கி	ஒங்கி
ozone	ஓசோன்	ஜோனி
oaiyaa	ஓயா	ஓய்யா
oayaa	ஓயா	ஓயா
ooyaa	ஓயா	ஓயா
oyaa	ஓயா	ஓய்யா
hora	ஓர	ஹோரா
oora	ஓர	ஒரா
ora	ஓர	ஒரா
vora	ஓர	வரர
horangalil	ஓரங்களில்	ஒராங்களில்
oorangalil	ஓரங்களில்	ஒரங்களில்
orangalil	ஓரங்களில்	ஒரங்களில்
vorangalil	ஓரங்களில்	வருங்களில்
horathilum	ஓரத்திலும்	ஒருதிலும்
oorathilum	ஓரத்திலும்	ஒருதிலும்
orathilum	ஓரத்திலும்	ஒருதிலும்
oraththilum	ஓரத்திலும்	ஒரத்திலும்
vorathilum	ஓரத்திலும்	வருதிலும்
horathil	ஓரத்தில்	ஒரதிதில்
oorathil	ஓரத்தில்	ஒரதில்
orathil	ஓரத்தில்	ஒரதிதில்
oraththil	ஓரத்தில்	ஒரத்தில்
vorathil	ஓரத்தில்	வருதில்
horamaaga	ஓரமாக	ஒராமாக
ooramaaga	ஓரமாக	ஒராமாக
oramaaga	ஓரமாக	ஒராமாக
voramaaga	ஓரமாக	ஊராமாக
horam	ஓரம்	ஒராம்
ooram	ஓரம்	ஒராம்
oram	ஓரம்	ஒராம்
voram	ஓரம்	ஊர்ம்
aolaichchuvadikal	ஓலைச்சுவடிகள்	அலைச்சுவியக்கள்
oalaichchuvadikal	ஓலைச்சுவடிகள்	ஒலைச்சுவிகளை
oalaichuvadigal	ஓலைச்சுவடிகள்	ஒலைவாட்சுகள்
olaichchuvadigal	ஓலைச்சுவடிகள்	ஒலைச்சுவிகளை
oolaichuvadigal	ஓலைச்சுவடிகள்	ஒலைவுச்களைக்
oaldu	ஓல்டு	ஒல்டு
oldu	ஓல்டு	ஒல்டு
ooldu	ஓல்டு	ஒல்டு
kakkan	கக்கன்	கக்கன்
kakken	கக்கன்	கக்கின்
kaki	கக்கி	காகி
kakki	கக்கி	காக்கி
kakky	கக்கி	காக்கி
kachan	கசன்	கசன்
kajan	கசன்	காஜன்
kasan	கசன்	காசன்
kazan	கசன்	கான்
qazan	கசன்	கானன்
kadaththal	கடத்தல்	கடத்தல்
kadaththalgalil	கடத்தல்களில்	கடத்தல்களில்
kadaththalkalil	கடத்தல்களில்	கதத்தல்களில்
kadandhaar	கடந்தார்	கடந்தார்
kadanthaar	கடந்தார்	கடந்தார்
katandhaar	கடந்தார்	கடன்தார்
katanthaar	கடந்தார்	கடன்தார்
kadanin	கடனின்	கடனின்
kadanil	கடனில்	கடனில்
kadanudhavi	கடனுதவி	கடனுதவி
kadanuthavi	கடனுதவி	கடனுத்தை
katanuthavi	கடனுதவி	கடனதுதிவே
kadarkaraigalil	கடற்கரைகளில்	கடர்கரைகளில்
kadarkaraikalil	கடற்கரைகளில்	கடர்கரைகளில்
kadarkaraigal	கடற்கரைகள்	கடர்கரைகள்
kadarkaraikal	கடற்கரைகள்	கடர்ககரைகள்
kadarkaraich	கடற்கரைச்	கதர்கரைச்
katarkaraichh	கடற்கரைச்	கதற்கரைச்
kadarkaraip	கடற்கரைப்	கதரர்கைப்
kadarkaraiyum	கடற்கரையும்	கதற்கையும்
kadarkollaiyargal	கடற்கொள்ளையர்கள்	கடர்கள்ளையர்கள்
kadarkollaiyarkal	கடற்கொள்ளையர்கள்	கடர்கள்ளையர்கள்
kadalin	கடலின்	கடலின்
katalin	கடலின்	கடலின்
kadavul	கடவுள்	கடவுல்
kadvul	கடவுள்	கட்வுள்
kadavulgalil	கடவுள்களில்	கடவுள்ளில்
kadavulkalil	கடவுள்களில்	கடவுள்ளில்
kadavulgalai	கடவுள்களை	கடவுள்ளை
kadavulkalai	கடவுள்களை	கடவுள்ளை
kadavulgal	கடவுள்கள்	கடவுள்ள்
kadavulkal	கடவுள்கள்	கடவுள்ள்
kadidha	கடித	கடித்த
kadith	கடித	கடித்
kaditha	கடித	கடித்த
kadidhangalil	கடிதங்களில்	கடித்தங்களில்
kadithangalil	கடிதங்களில்	கடித்தங்களில்
kadithangkalil	கடிதங்களில்	கடித்தங்களில்
kadidhangal	கடிதங்கள்	கடித்தங்கள்
kadithangal	கடிதங்கள்	கடித்தங்கள்
kadithangkal	கடிதங்கள்	கடித்தங்கள்
kadidhu	கடிது	கடித்து
kadithu	கடிது	கடித்து
katithu	கடிது	கதித்து
kadugu	கடுகு	கடுகு
kadumaiyaana	கடுமையான	கடுமையான
kadaisith	கடைசித்	கடைசித்
kadaisip	கடைசிப்	கடைசிப்
kadaisiyil	கடைசியில்	கடைசியில்
kadaippidiththu	கடைப்பிடித்து	கடைப்பிட்த்து
kadaippidithu	கடைப்பிடித்து	கடைப்பிடித்து
kadaippiditthu	கடைப்பிடித்து	கடைப்பிட்டுத்து
avut	கட்	அவுட்
cut	கட்	குட்
kat	கட்	கா்
out	கட்	ஓட்
kattamaikkum	கட்டமைக்கும்	கட்டமைக்கும்
kattaayamaaga	கட்டாயமாக	கட்டாயாக
kattumaanak	கட்டுமானக்	கட்டுமாக
kattumaanath	கட்டுமானத்	கட்டுமானத்
kattumaanathin	கட்டுமானத்தின்	கட்டுமானதின்
kattumaanaththin	கட்டுமானத்தின்	கட்டுமாத்தின்
kattumaanathirku	கட்டுமானத்திற்கு	கட்டுமான்றதுக்
kattumaanaththirku	கட்டுமானத்திற்கு	கட்டுமா்திறதுக்
katumaanaththirku	கட்டுமானத்திற்கு	கடுமானத்திற்கு
kattumaanathil	கட்டுமானத்தில்	கட்டுமாதிலின்
kattumaanaththil	கட்டுமானத்தில்	கட்டுமாத்தில்
katturaigal	கட்டுரைகள்	கட்றுறைகள்
kanangalin	கணங்களின்	கணங்களின்
kanangkalin	கணங்களின்	கணங்களின்
kanaththin	கணத்தின்	காநத்தின்
kanini	கணிணி	கணினி
kanippori	கணிப்பொறி	கானிப்பிரி
kanipporiyil	கணிப்பொறியில்	கணிப்பூரிலில்
ganes	கணேஸ்	கானஸ்
ganesh	கணேஸ்	காஷ்
kandarindhavar	கண்டறிந்தவர்	கண்டிரவந்தார்
kandarindhdhavar	கண்டறிந்தவர்	கண்டிரத்தனர்
kandarinthavar	கண்டறிந்தவர்	கண்டிரவந்தார்
kandarinththavar	கண்டறிந்தவர்	கண்டிர்ந்தவர்
kandarindhaar	கண்டறிந்தார்	கண்டிரர்ந்தார்
kandarindhdhaar	கண்டறிந்தார்	கண்டிரத்தார்
kandarinthaar	கண்டறிந்தார்	கண்டிரர்ந்தார்
kandarinththaar	கண்டறிந்தார்	கண்டிரத்தார்
kandarindhdhu	கண்டறிந்து	கண்டரிந்து
kandarindhu	கண்டறிந்து	கண்டரிந்து
kandarinthu	கண்டறிந்து	கண்டரிந்து
kandrinththu	கண்டறிந்து	கண்றிந்து
kandarindhulladhu	கண்டறிந்துள்ளது	கண்டிருந்தலுள்து
kandarindhullathu	கண்டறிந்துள்ளது	கண்டிருள்ளதுது
kandarinthulladhu	கண்டறிந்துள்ளது	கண்டிர்ள்துள்து
kandarinthullathu	கண்டறிந்துள்ளது	கண்டிர்ள்துள்து
athinaveena	கண்டுபிடிக்க	அதிவேனா
kandupidikka	கண்டுபிடிக்க	கண்டுபிட்கிக்க
kandupitikka	கண்டுபிடிக்க	கண்டுபிட்கிக்க
kanupidikka	கண்டுபிடிக்க	கணுபிடிக்க
kandupidikkak	கண்டுபிடிக்கக்	கண்டுபிட்க்க்க்
kandupitikkak	கண்டுபிடிக்கக்	கண்டுபிட்க்க்க்
kandupidikkavum	கண்டுபிடிக்கவும்	கண்டுப்பிடுக்கிக்
kandupidikkum	கண்டுபிடிக்கும்	கண்டுப்பிடுக்கி
kannaottaththudan	கண்ணோட்டத்துடன்	கண்ணாட்டத்துட்டன
kannoottaththudan	கண்ணோட்டத்துடன்	கான்டத்துடன்ட்
kannottaththudan	கண்ணோட்டத்துடன்	கண்ணத்துட்டன்
kanoottatthudan	கண்ணோட்டத்துடன்	கோன்டத்துடன்
kannoottathai	கண்ணோட்டத்தை	கண்ந்தோடை
kannoottaththai	கண்ணோட்டத்தை	கண்ந்த்தோடை
kannottaththai	கண்ணோட்டத்தை	கண்ந்தத்தை
kannoattam	கண்ணோட்டம்	கான்டாட்டம்
kannoottam	கண்ணோட்டம்	கான்டோட்டம்
kannottam	கண்ணோட்டம்	கான்டோட்டம்
kanpaarvai	கண்பார்வை	கண்பார்வை
gana	கன	கான
kana	கன	கான
ganam	கனம்	காணம்
kanam	கனம்	காணம்
ganaraga	கனரக	கரணக
kanaraga	கனரக	கணரக
kanavai	கனவை	கணவை
canno	கனோ	கன்
cannoo	கனோ	கன்னோ
cano	கனோ	சனோ
kanno	கனோ	கன்
kannoo	கனோ	கன்னோ
kano	கனோ	கானோ
kanoo	கனோ	கோனோ
kanu	கனோ	கானு
qanno	கனோ	கான்
qano	கனோ	கானோ
qanoo	கனோ	கோனோ
comiti	கமிட்டி	காமிடி
comitie	கமிட்டி	காமிட்டி
comittee	கமிட்டி	காடிமீட்ட்
comity	கமிட்டி	காமிட்
commitee	கமிட்டி	காம்பீடி
committee	கமிட்டி	காம்மீட்டி
committii	கமிட்டி	காம்பிட்டி
kamiddi	கமிட்டி	காமிட்டி
kamiti	கமிட்டி	காமிதி
kamitte	கமிட்டி	காமித்தி
kamitti	கமிட்டி	காமித்தி
qamiti	கமிட்டி	காமிதி
kamees	கமீஸ்	கேமிஸ்
kameez	கமீஸ்	கேமே
kamis	கமீஸ்	காமிஸ்
cumbaththil	கம்பத்தில்	கம்பத்தில்
kambaththil	கம்பத்தில்	கம்பத்தில்
kambattil	கம்பத்தில்	காம்பத்தில்
kampattil	கம்பத்தில்	காம்பட்டில்
kambam	கம்பம்	கம்பம்
kampam	கம்பம்	கம்பம்
kambaramayanam	கம்பராமாயணம்	கம்பரமாமமன்
kamparamayanam	கம்பராமாயணம்	கம்பரமாயமம்
company	கம்பெனி	காம்பின்
kambeni	கம்பெனி	கம்பினி
kampeni	கம்பெனி	கம்பாிி
companykku	கம்பெனிக்கு	கோம்பாங்கு
kambenikku	கம்பெனிக்கு	கம்பீனிக்கு
kampenikku	கம்பெனிக்கு	கம்பென்கிக்
companyil	கம்பெனியில்	காம்பாிில்
kambeniyil	கம்பெனியில்	கம்பாிியில்
kampeniyil	கம்பெனியில்	கம்பானியில்
gayaanaa	கயானா	காயான
gayana	கயானா	கயன
guana	கயானா	குனா
guiaana	கயானா	குயானா
guiana	கயானா	குயான
guianaa	கயானா	குயானா
guiiana	கயானா	கியான
guiyana	கயானா	குயயன
guuana	கயானா	குனா
guuiana	கயானா	குயான
guuiyana	கயானா	குயயன
guuvana	கயானா	குவான
guuwana	கயானா	குவான
guuyaana	கயானா	குயான
guuyana	கயானா	குயான
guuyanaa	கயானா	குயான
guvana	கயானா	குவான
guwana	கயானா	குவான
guyaana	கயானா	குயான
guyana	கயானா	குயான
guyanaa	கயானா	குயான
kayana	கயானா	கயன
karagaatam	கரகாட்டம்	கராகதாம்
karagaattam	கரகாட்டம்	கராகத்தம்
karakaatam	கரகாட்டம்	கராகத்மம்
karakaattam	கரகாட்டம்	கராகத்தம்
karachiyil	கராச்சியில்	கராசியில்
karung	கருங்	கருங்
karuththaa	கருத்தா	கருத்தா
karuththaakkangal	கருத்தாக்கங்கள்	கருத்தக்காகள்
karuththaakkanggal	கருத்தாக்கங்கள்	கருத்தக்காக்கள்
karuththaakkangkal	கருத்தாக்கங்கள்	கருத்தக்கங்கள்
karuththaakkaththai	கருத்தாக்கத்தை	கருத்தகத்தைக்
karuththaal	கருத்தால்	கருத்தால்
karutthaal	கருத்தால்	கருத்தால்
karuththukalaal	கருத்துக்களால்	கருத்துகள்ல்
karuththukkalaal	கருத்துக்களால்	கருத்துக்களால்
karuthukkalaal	கருத்துக்களால்	கருத்துகள்கள்
karuththukalil	கருத்துக்களில்	கருத்துகளில்
karuththukkalil	கருத்துக்களில்	கருத்துக்களில்
karuththukalukku	கருத்துக்களுக்கு	கருத்துகளுக்கு
karuththukkalukku	கருத்துக்களுக்கு	கருத்துக்குகளுக்
karuththukalum	கருத்துக்களும்	கருத்துகளும்
karuththukkalum	கருத்துக்களும்	கருத்துக்கும்
karuththulla	கருத்துள்ள	கருத்துள்ள
karuththae	கருத்தே	கருத்தே
karuththe	கருத்தே	கருத்தே
karuththey	கருத்தே	கருத்தே
karunira	கருநிற	கருநிர
karum	கரும்	கரும்
karumpalagai	கரும்பலகை	கரும்பாலை
karumpalakai	கரும்பலகை	கரும்பாலை
karmpuli	கரும்புலி	கர்ம்புளி
karumpuli	கரும்புலி	கரும்புளி
karumpuligal	கரும்புலிகள்	கரும்புள்ளிகள்
karumpulikal	கரும்புலிகள்	கரும்புள்ளிகள்
karumpulith	கரும்புலித்	கரும்புளித்
karumpulli	கரும்புள்ளி	கரும்புள்ளி
karna	கர்ண	கர்னா
karnanai	கர்ணனை	கரண்ணை
karnnanai	கர்ணனை	கர்ணண்ணை
karma	கர்ம	கர்மா
karpadhu	கற்பது	கர்பது
karpathu	கற்பது	கர்பத்து
karpatthu	கற்பது	கர்பத்து
karpam	கற்பம்	கர்பம்
padugira	கற்பிக்கப்	படுகிறா
padugiradhu	கற்பிக்கப்	படுகிறது
padukira	கற்பிக்கப்	படுகிறா
padukirathu	கற்பிக்கப்	படுகிறது
patukiratu	கற்பிக்கப்	படுகிறது
karpikkappatta	கற்பிக்கப்பட்ட	கரிப்பிக்கப்பட்
karpikkum	கற்பிக்கும்	கர்பிக்கும்
karpithanggal	கற்பிதங்கள்	கர்பித்தங்கள்
karpithangkal	கற்பிதங்கள்	கர்பித்தங்கள்
karpin	கற்பின்	கர்பின்
kalasam	கலசம்	கலாசம்
kalandhaaivu	கலந்தாய்வு	காலந்தாவு
kalandhaayvu	கலந்தாய்வு	காலந்தவு
kalanthaaivu	கலந்தாய்வு	கலந்தாவு
kalandhuk	கலந்துக்	கலந்துக்
kalanthuk	கலந்துக்	கலந்துக்
kalandhum	கலந்தும்	கலந்தும்
kalanthum	கலந்தும்	கலந்தும்
kalavi	கலவி	காலவி
kalaviyil	கலவியில்	காளவியில்
kalaanidhi	கலாநிதி	காலந்தி
kalaanithi	கலாநிதி	காலந்தி
kalanidhi	கலாநிதி	கலநிதி
kalaanidhip	கலாநிதிப்	காலநிதிப்
kalaanithip	கலாநிதிப்	காலநிதிப்
kalanidhip	கலாநிதிப்	கலநிதிப்
kalinga	கலிங்க	கலிங்க
kalingam	கலிங்கம்	காழிங்கம்
kalinkam	கலிங்கம்	கலிங்கம்
ccalinga	கலிங்கா	காசிங்
kaliina	கலிங்கா	கலினா
kaliinga	கலிங்கா	கலிய்க்
kalina	கலிங்கா	கலினா
kalinaa	கலிங்கா	கலினா
kalinga	கலிங்கா	கலிங்க
kalingaa	கலிங்கா	கலிங்கா
kalinka	கலிங்கா	கலிங்க
kallinaa	கலிங்கா	கல்லினா
kallingaa	கலிங்கா	கல்லின்க
qaliinga	கலிங்கா	காலின்
qalinga	கலிங்கா	காலிக்
qalingaa	கலிங்கா	காலிக்கா
qallingaa	கலிங்கா	கால்லின்க
kaliyan	கலியன்	கலியன்
kalaik	கலைக்	கலைக்
koavan	கலைக்	கோவன்
koovan	கலைக்	கோவான்
kovan	கலைக்	கோவன்
choargal	கலைச்	சோர்கள்
chortkal	கலைச்	சொற்கள்
corkal	கலைச்	கோர்கள்
sorkkal	கலைச்	சொற்களக்
sortkal	கலைச்	சோர்டகள்
kalaichchorkalai	கலைச்சொற்களை	கலைச்சொள்களை
kalicchorkalai	கலைச்சொற்களை	கலிச்சொர்களை
kalladi	கல்லடி	கல்லிடி
kalluppatti	கல்லுப்பட்டி	கல்லப்ப்பட்டி
kalloorigalin	கல்லூரிகளின்	கல்லூரிகளின்
kallorikalin	கல்லூரிகளின்	கல்லிருகளின்
kallurigalin	கல்லூரிகளின்	கல்லுரிகளின்
kallurigazhin	கல்லூரிகளின்	கல்லுர்கினின்
kallurikalin	கல்லூரிகளின்	கல்லுரிகளின்
kallurikazhin	கல்லூரிகளின்	கல்லுர்கிலின்
kalloorigalil	கல்லூரிகளில்	கல்லூரிகளில்
kalloorikalil	கல்லூரிகளில்	கல்லூரிலிகளில்
kallurigalil	கல்லூரிகளில்	கல்றுள்கிலில்
kallurigazhil	கல்லூரிகளில்	கல்லுர்கிலில்
kallurikalil	கல்லூரிகளில்	கல்றுள்கிலில்
kallurikazhil	கல்லூரிகளில்	கல்லுர்கிலில்
kalloorigalukkaana	கல்லூரிகளுக்கான	கல்லிருக்களையு
kalloorikalukkaana	கல்லூரிகளுக்கான	கல்லிருக்களையு
kallurigalukkana	கல்லூரிகளுக்கான	கல்லுற்குகளைக்
kallurigazhukkana	கல்லூரிகளுக்கான	கல்லுற்குகளைக்
kallurikalukkana	கல்லூரிகளுக்கான	கல்லிருக்களைக்க
kallurikazhukkana	கல்லூரிகளுக்கான	கல்லுற்குகளைக்க
kalloorigal	கல்லூரிகள்	கல்லோரிகள்
kalloorikal	கல்லூரிகள்	கல்லோரிகள்
kallurigal	கல்லூரிகள்	கல்லுரிகள்
kallurikal	கல்லூரிகள்	கல்றுள்களி
kalloorigalukku	கல்லூரிக்கு	கல்லிருளைக்கு
kalloorikku	கல்லூரிக்கு	கல்லிருக்கு
kallurikku	கல்லூரிக்கு	கல்லுறிக்கு
kalloorip	கல்லூரிப்	கல்லோரிப்
kallurip	கல்லூரிப்	கல்லூரிப்
kallooriyin	கல்லூரியின்	கல்லோரியின்
kalluriyin	கல்லூரியின்	கல்லிருயின்
kallooriyilirindhu	கல்லூரியிலிருந்து	கலிலோரியிலுந்து
kallooriyilirundhu	கல்லூரியிலிருந்து	கல்லிரியுளிருந்து
kalluriyilirundhu	கல்லூரியிலிருந்து	கல்லிருயிலிருந்து
kalluriyilirunthu	கல்லூரியிலிருந்து	கல்லிருளியிருந்து
kallooriyil	கல்லூரியில்	கல்லோரியில்
kalluriyil	கல்லூரியில்	கல்லுரியில்
kallooriyum	கல்லூரியும்	கல்லோரியும்
kalluriyum	கல்லூரியும்	கல்லுறியும்
kallooriei	கல்லூரியை	கல்லோரியி
kallooriyai	கல்லூரியை	கல்லோரியை
kalluriyai	கல்லூரியை	கல்லுறையி
kalvikku	கல்விக்கு	கால்விக்கு
kalvikkum	கல்விக்கும்	கால்விக்கும்
kalvich	கல்விச்	கல்விச்
kalviththittam	கல்வித்திட்டம்	காள்த்திட்ட்டம்
kalvip	கல்விப்	கால்பி
kalviyaaga	கல்வியாக	கல்வியாக
kalviyin	கல்வியின்	கால்யின்
kalviyil	கல்வியில்	கால்யிலில்
kalvieiyum	கல்வியையும்	கால்வியும்
kalviyaiyum	கல்வியையும்	கல்வையியும்
kaliman	களிமண்	கலிமன்
kalimun	களிமண்	கலிமுன்
kazhiman	களிமண்	கழிமன்
kalaiyum	களையும்	கலையும்
kazhaiyum	களையும்	கழையும்
kazhayum	களையும்	கழையும்
kalutaikal	கழுதைகள்	கலைத்துகள்
kaluthaikal	கழுதைகள்	கழுதைகள்
kazhudhaigal	கழுதைகள்	கழுதைகள்
gavanippu	கவனிப்பு	கவனிப்பு
kavanippu	கவனிப்பு	கவனிப்பு
kavalaigalai	கவலைகளை	கவளைகளை
kavalaikalai	கவலைகளை	கவளைகளை
kavaligalai	கவலைகளை	கவளைகளி
kavalaigal	கவலைகள்	கவைளைகள்
kavalaikal	கவலைகள்	கவைளைகள்
kavaligal	கவலைகள்	கவளிகள்
kaviyarachu	கவியரசு	கவியராகு
kaviyaracu	கவியரசு	கவியாரு
kaviyarasu	கவியரசு	கவியாரு
counti	கவுண்டி	காண்டி
countii	கவுண்டி	கோன்டி
county	கவுண்டி	காண்டி
couunti	கவுண்டி	காண்டி
couunty	கவுண்டி	காண்டி
kaunti	கவுண்டி	காண்டி
kaunty	கவுண்டி	காண்டி
kauunty	கவுண்டி	காண்டி
kavunti	கவுண்டி	கவுண்டி
kavuntii	கவுண்டி	கவுண்டி
kavuunti	கவுண்டி	கவுண்டி
kawunti	கவுண்டி	காண்டி
kounti	கவுண்டி	காண்டி
kountii	கவுண்டி	கோண்டி
kounty	கவுண்டி	கோண்டி
kouunti	கவுண்டி	கோண்டி
kouunty	கவுண்டி	கோண்டி
qaunty	கவுண்டி	காண்டி
qavunti	கவுண்டி	காவுண்டி
qounti	கவுண்டி	காண்டி
qounty	கவுண்டி	காண்டி
conggo	காங்கோ	கங்கோ
congo	காங்கோ	கோங்கோ
congoo	காங்கோ	கோங்கோ
congu	காங்கோ	காங்கு
conngo	காங்கோ	காங்கோ
coonggoo	காங்கோ	கங்கோ
coongoo	காங்கோ	கோங்கோ
coonngoo	காங்கோ	கோங்கோ
kaango	காங்கோ	காங்கோ
kaanko	காங்கோ	காங்கோ
kankoo	காங்கோ	கங்கோ
kongo	காங்கோ	கோங்கோ
koongoo	காங்கோ	கோங்கோ
qongo	காங்கோ	கோங்கோ
kaattuvadhaagavum	காட்டுவதாகவும்	காட்டுவதாகவும்
kaattuvathaagavum	காட்டுவதாகவும்	காட்டுவதாகவும்
kaattuvadhai	காட்டுவதை	காட்டுவதை
kaattuvathai	காட்டுவதை	காட்டுவதை
kaangindranar	காண்கின்றனர்	காங்கின்றார்
kaangintranar	காண்கின்றனர்	காங்கின்றார்
kaankinranar	காண்கின்றனர்	கான்கின்றனர்
kaanbithththu	காண்பித்து	காண்பித்து
kaanbiththu	காண்பித்து	காண்பித்து
kaanpiththu	காண்பித்து	காண்பித்து
kaathi	காதி	காதி
kathi	காதி	கதி
kaadhirundhanar	காத்திருந்தனர்	காதிருந்தனர்
kaathirundhanar	காத்திருந்தனர்	காதிருந்தனர்
kaaththirunthanar	காத்திருந்தனர்	காத்திருந்தனர்
kaatthirunthanar	காத்திருந்தனர்	காத்திருந்தார்
kaathirunthu	காத்திருந்து	காதிருந்து
kaaththirundhu	காத்திருந்து	காத்திருந்து
kaaththirunththu	காத்திருந்து	காத்திருந்து
kaaththirunthu	காத்திருந்து	காத்திருந்து
kaatthirunthu	காத்திருந்து	காத்திருந்து
kaanagaththin	கானகத்தின்	காகத்தின்
kanakaththin	கானகத்தின்	ககநதத்தின்
kaanagam	கானகம்	காணகம்
kanagam	கானகம்	கணகம்
kaabul	காபூல்	காபுல்
kabul	காபூல்	கபுல்
kabuul	காபூல்	கபுல்
kapuul	காபூல்	கபுல்
qabul	காபூல்	காபுல்
kaapaatri	காப்பாற்றி	காபார்
kaapaattri	காப்பாற்றி	காபார்டிர்
kaappaatri	காப்பாற்றி	காப்பாரி
kaappaatrti	காப்பாற்றி	காப்பாற்றி
kaappatrtri	காப்பாற்றி	காப்பற்றிற்
kaapaatrinaar	காப்பாற்றினார்	காபாப்றிரான்
kaappaatrinaar	காப்பாற்றினார்	காப்பாற்றினார்
kaappaatrtrinaar	காப்பாற்றினார்	காப்பாற்றிருந்தார்
kaappu	காப்பு	காப்பு
kappu	காப்பு	கப்பு
kaappuch	காப்புச்	காப்புச்
kappuch	காப்புச்	கப்புச்
kaaranangalukkaagavum	காரணங்களுக்காகவும்	காரணங்களுகககும்
kaaranangalukkaakavum	காரணங்களுக்காகவும்	காரணங்களுகககும்
karananggalukkaakavum	காரணங்களுக்காகவும்	கரணங்களுக்ககமம்
kaaranaththai	காரணத்தை	காரநத்தை
kaaranattai	காரணத்தை	காரணட்டை
kaaranatthai	காரணத்தை	காரணத்தை
karanaththai	காரணத்தை	கரரந்தை
kaaranaththaip	காரணத்தைப்	காரநத்தைப்
kaaranattaip	காரணத்தைப்	காரணட்டைப்
kaaranatthaip	காரணத்தைப்	காரணத்தைப்
karanaththaip	காரணத்தைப்	கரரணத்தைப்
kaaranamaaga	காரணமாக	காரணமாக
kaaranamaaka	காரணமாக	காரணமாக
karanamaaka	காரணமாக	கரணமாக
kaaranamaakak	காரணமாகக்	காரணாகமக்
karanamaakach	காரணமாகக்	கராணமாகச்
kaaranamaagath	காரணமாகத்	காராணமாத
kaaranamaakat	காரணமாகத்	காரணாமாக
kaaranamaakath	காரணமாகத்	காராணமாத
karanamaakath	காரணமாகத்	கராணமாகத்
kaaranamaakavo	காரணமாகவோ	காரணமாகவே
karanamaakavo	காரணமாகவோ	கரணமாகவே
kaaram	காரம்	காரம்
carin	காரின்	கரின்
kaarin	காரின்	காரின்
caril	காரில்	கரில்
kaaril	காரில்	காரில்
carai	காரை	கரை
kaarai	காரை	காரை
caar	கார்	சார்
car	கார்	கார்
kar	கார்	கார்
cargalai	கார்களை	கர்களை
kaargalai	கார்களை	கார்களை
kaarkalai	கார்களை	கார்களை
carbon	கார்பன்	கர்போன்
kaarban	கார்பன்	கார்பான்
kaarpan	கார்பன்	கார்பான்
karban	கார்பன்	கர்பான்
karbon	கார்பன்	கர்போன்
karbonn	கார்பன்	கர்போன்
karpan	கார்பன்	கர்பான்
qarban	கார்பன்	கர்பான்
qarbon	கார்பன்	கர்போன்
qarbonn	கார்பன்	கர்போன்
caarl	கார்ல்	சார்
carl	கார்ல்	கார்
carll	கார்ல்	சார்ல்
karl	கார்ல்	கார்
karll	கார்ல்	கார்ல்
qarl	கார்ல்	கார்
qarll	கார்ல்	கார்ல்
kaatraal	காற்றால்	காற்றால்
katraal	காற்றால்	காற்றால்
kaatrinaal	காற்றினால்	காற்றினால்
katrinaal	காற்றினால்	கறிற்னால்
kaatrilirundhu	காற்றிலிருந்து	காற்றிலிருந்து
kaatrilirunthu	காற்றிலிருந்து	காற்றிலிருந்து
katrilirunthu	காற்றிலிருந்து	கறிற்றிலுள்து
kaalakatta	காலகட்ட	காலகத்த
kalakatta	காலகட்ட	கலகத்தா
kaalakattaththin	காலகட்டத்தின்	காலத்தத்தின்
kalakattaththin	காலகட்டத்தின்	கலகத்தத்தின்
kaalakattam	காலகட்டம்	காலத்தாம்
kalakattam	காலகட்டம்	கலகத்தம்
kattangal	காலக்	கட்டங்கள்
kattangkal	காலக்	கட்டங்கள்
kattankal	காலக்	கட்டங்கள்
kattaththai	காலக்	கட்டத்தை
kattattai	காலக்	கட்டட்டை
keduvukkul	காலக்	கேடுவுக்கு
ketuvukkul	காலக்	கேடுவுக்கு
colony	காலணி	காலின்
kaalani	காலணி	காலினி
kaalaththaik	காலத்தைக்	காலத்தைக்
kaalattaik	காலத்தைக்	காலத்தைக்
kaalatthaik	காலத்தைக்	காலத்தைக்
kaalaththaip	காலத்தைப்	காலத்தைப்
kaalattaip	காலத்தைப்	காலத்தைப்
kaalatthaip	காலத்தைப்	காலத்தைப்
kaavalthurai	காவல்துறை	காவல்துறை
kaavalturai	காவல்துறை	காவல்று
kaavthurai	காவல்துறை	காத்துரை
kaavalthuraiyin	காவல்துறையின்	காவல்துயிலை
kaavalturaiyin	காவல்துறையின்	காவல்ுதியின்
kaavalthuraiyil	காவல்துறையில்	காவல்துயிலை
kaavalturaiyil	காவல்துறையில்	காவல்றுயையில்
kaavalthuraiyum	காவல்துறையும்	காவல்துறையும்
kaavalturaiyum	காவல்துறையும்	காவல்றுயையும்
kaavalthuraiyai	காவல்துறையை	காவல்துயையை
kaavalturaiyai	காவல்துறையை	காவல்றுயையை
kidangkugal	கிடங்குகள்	கிடங்குகள்
kidangugal	கிடங்குகள்	கிடங்களுக்
kidangukal	கிடங்குகள்	கிடங்குகள்
kidankukal	கிடங்குகள்	கிடங்குகள்
kitankukal	கிடங்குகள்	கிட்டங்குகள்
kidandhadhu	கிடந்தது	கிடந்தது
kidandhathu	கிடந்தது	கிடந்தது
kidanthathu	கிடந்தது	கிடந்தது
kitantatu	கிடந்தது	கிட்டாட்டு
kitanthathu	கிடந்தது	கிட்நததது
kidandhana	கிடந்தன	கிடந்தன
kidantana	கிடந்தன	கிடன்டன
kidanthana	கிடந்தன	கிடந்தன
kitantana	கிடந்தன	கிட்டனான
kidandhan	கிடந்தான்	கிடந்தன்
kidanthaan	கிடந்தான்	கிட்நதான்
kidanthan	கிடந்தான்	கிட்நத்தன்
kitantaan	கிடந்தான்	கிட்டான்ட்
kidandhar	கிடந்தார்	கிட்நத்தர்
kidanthaar	கிடந்தார்	கிட்நத்தார்
kidanthar	கிடந்தார்	கிட்ந்தர்
kitantaar	கிடந்தார்	கிட்டாட்டர்
kidandhu	கிடந்து	கிட்ந்து
kidanthu	கிடந்து	கிட்ந்து
kidantu	கிடந்து	கிட்டன்
kitanthu	கிடந்து	கிட்ந்து
kitantu	கிடந்து	கிட்டன்
kidai	கிடை	கிடை
kidaikkach	கிடைக்கச்	கிடைக்கா்
kidaikkap	கிடைக்கப்	கிடைக்கப்
kidaikkaadha	கிடைக்காத	கிடைக்காத
kidaikkaatha	கிடைக்காத	கிடைக்காத
kidaikkaamal	கிடைக்காமல்	கிடைக்காலம்
kitaikkaamal	கிடைக்காமல்	கிடைக்காலம்
kidaikkum	கிடைக்கும்	கிடைக்கும்
kitaikkum	கிடைக்கும்	கிடைக்கும்
kidaikkumbodhu	கிடைக்கும்போது	கிடைக்கொழும்பு
kidaikkumboodhu	கிடைக்கும்போது	கிடைக்கொழும்போத
kidaikkumbothu	கிடைக்கும்போது	கிடைக்கொழும்து
kidaikkumpodhu	கிடைக்கும்போது	கிடைக்கொழுப்பது
kidaikkumpoodhu	கிடைக்கும்போது	கிடைக்கொழும்போத
kidaikkumpootu	கிடைக்கும்போது	கிடைக்கொண்போடு
kidaikkumpothu	கிடைக்கும்போது	கிடைக்கொழும்பு
kitaikkumpootu	கிடைக்கும்போது	கிடைக்கொடும்போட
ginnas	கின்னஸ்	கின்னாஸ்
ginnes	கின்னஸ்	கின்ஸ்
guines	கின்னஸ்	குனிஸ்
guinness	கின்னஸ்	குயன்ஸ்ஸ்
guuinness	கின்னஸ்	குயன்ஸ்ஸ்
kinnas	கின்னஸ்	கின்னாஸ்
kinnes	கின்னஸ்	கின்னிஸ்
kinns	கின்னஸ்	கின்ஸ்
cubavin	கியூபாவின்	குபாிின்
kiyoobaavin	கியூபாவின்	கியோபாடிவின்
kiyoopaavin	கியூபாவின்	கியோக்போவில்
grantha	கிரந்த	கிரந்த
kirantha	கிரந்த	கிரந்த
krantha	கிரந்த	கிரந்த
graham	கிரஹாம்	கிராம்
kirubakaran	கிருபாகரன்	கிருபாகரன்
kirubhaagaran	கிருபாகரன்	கிருதாரர்
kirubhaakaran	கிருபாகரன்	கிருதாரர்்
kirupakaran	கிருபாகரன்	கிறுப்பான்
kiristhavar	கிறித்தவர்	கிரிஸ்தவர்
kiriththavar	கிறித்தவர்	கிறித்தவர்
kiritthavar	கிறித்தவர்	கிறித்தவர்
kiriththuvam	கிறித்துவம்	கிரித்துவம்
keelo	கிலோ	கீலோ
keeloo	கிலோ	கீலோ
kiilo	கிலோ	கிலோ
kilo	கிலோ	கிலோ
kiloo	கிலோ	கிலோ
kylo	கிலோ	கிலோ
kyloo	கிலோ	கிலோ
qeelo	கிலோ	கீலோ
qilo	கிலோ	கிலோ
qylo	கிலோ	கிலோ
keevi	கிவி	கீவி
keewi	கிவி	கீவி
keewii	கிவி	கீவி
kiivi	கிவி	கிவி
kiiwi	கிவி	கிவி
kiiwii	கிவி	கிவிய்
kivi	கிவி	கிவி
kivii	கிவி	கிவி
kiwi	கிவி	கிவி
kiwii	கிவி	கிவி
qeewi	கிவி	கீவி
qiiwi	கிவி	கிவி
qiwi	கிவி	கிவி
qiwii	கிவி	கிவி
geethaiyin	கீதையின்	கீதையின்
geethayin	கீதையின்	கீதியைன்
green	கீரன்	கிரின்
keeran	கீரன்	கேரன்
kunggumappoo	குங்குமப்பூ	குங்கும்போப்
kungkumappoo	குங்குமப்பூ	குங்கும்போப்
kungumapoo	குங்குமப்பூ	குங்குமோபோ
kungumappoo	குங்குமப்பூ	குங்கும்போப்
kuchaylar	குசேலர்	குச்சல்
kuchelar	குசேலர்	குச்லர்
kusaylar	குசேலர்	குசயல்
kuselar	குசேலர்	குசேல்
kuch	குச்	குச்
kuchh	குச்	குச்
kuuch	குச்	குச்
kuuchh	குச்	குச்
quch	குச்	குச்
quchh	குச்	குச்
quuch	குச்	குச்
gunamaagum	குணமாகும்	குணமாகும்
gunamagum	குணமாகும்	குணமாகும்
kunamaakum	குணமாகும்	குணமாகும்
gunavardhana	குணவர்தன	குவநரத்த
gunavarththana	குணவர்தன	குவந்ததற்
gunaathisayanggalai	குணாதிசயங்களை	குணாத்சியகளைக்
gunadhisayangalai	குணாதிசயங்களை	குநிதசியகளை
gunathisayankalai	குணாதிசயங்களை	குநதிசைகளையா
gunaathisanggal	குணாதிசயங்கள்	குணாச்திகக்கள்
gunaathisayanggal	குணாதிசயங்கள்	குணாசியாக்கக்
gunadhisayangal	குணாதிசயங்கள்	குணதியாககள்
kuththappattu	குத்தப்பட்டு	குத்தப்பட்டு
kuthdhudhal	குத்துதல்	குத்துதல்
kuththudhal	குத்துதல்	குத்துதல்
kuththuthal	குத்துதல்	குத்துதல்
kutthuthal	குத்துதல்	குத்துதல்
guptha	குப்த	குபத்
kuptha	குப்த	குப்த
kumili	குமிழி	குமிலி
kumizhi	குமிழி	குமிழி
kumilikal	குமிழிகள்	குமிலிகள்
kumizhgal	குமிழிகள்	குழிம்கள்
kumizhigal	குமிழிகள்	குமிழிகள்
kumizhikal	குமிழிகள்	குமிழிகள்
gummi	கும்மி	கும்
kummi	கும்மி	கும்மி
kurudi	குருதி	குறுடி
kuruthi	குருதி	குருத்தி
kurudich	குருதிச்	குறுச்கி
kuruthich	குருதிச்	குறுத்தி
kurudhip	குருதிப்	குறுதிப்
kuruthip	குருதிப்	குறுத்தி
kurudiyin	குருதியின்	குறுதியின்
kuruthiyin	குருதியின்	குறுதியின்
kurudiyil	குருதியில்	குறுடியில்
kuruthiyil	குருதியில்	குறுத்தில்
kurudhiyai	குருதியை	குறுதியை
kuruthiyai	குருதியை	குறுத்தையை
guruvikal	குருவிகள்	குறுவிகள்
kuruvigal	குருவிகள்	குறுவிகள்
guraikkum	குரைக்கும்	குறைக்கும்
kuraikkum	குரைக்கும்	குறைக்கும்
kuraikum	குரைக்கும்	குறைக்கும்
kuravanjchi	குறவஞ்சி	குராவசிிக்
kuravanji	குறவஞ்சி	குராவங்கி
kuripil	குறிப்பில்	குறிப்பில்
kurippil	குறிப்பில்	குறிப்பில்
kurippaedu	குறிப்பேடு	குறிப்போடு
kurippedu	குறிப்பேடு	குறிப்பெடு
kurugalaana	குறுகலான	குறுகளான
kurukku	குறுக்கு	குறுக்கு
kurukkuk	குறுக்குக்	குறுக்குக்
kuraindha	குறைந்த	குறைந்த
kuraindhdha	குறைந்த	குறைந்த
kuraintha	குறைந்த	குறைந்த
kuraindhadhaaga	குறைந்ததாக	குறைந்ததாக
kuraindhdhadhaaga	குறைந்ததாக	குறைந்ததாக
kurainthathaaka	குறைந்ததாக	குறைந்ததாக
kuraindadhaal	குறைந்ததால்	குறைந்தால்
kuraindhdhadhaal	குறைந்ததால்	குறைந்ததல்
kurainthathaal	குறைந்ததால்	குறைந்தால்
kuraindhadhu	குறைந்தது	குறைந்தது
kuraindhdhadhu	குறைந்தது	குறைந்தது
kurainthathu	குறைந்தது	குறைந்தது
kuraindhana	குறைந்தன	குறைந்தன
kuraindhdhana	குறைந்தன	குறைந்தன
kurainthana	குறைந்தன	குறைந்தன
kuraindhaalum	குறைந்தாலும்	குறைந்தாலும்
kuraindhdhaalum	குறைந்தாலும்	குறைந்தலும்
kurainthaalum	குறைந்தாலும்	குறைந்தாலும்
kuraindhdhullathu	குறைந்துள்ளது	குறைந்துள்ளது
kuraindhulladhu	குறைந்துள்ளது	குறைந்துள்ளது
kurainthulladhu	குறைந்துள்ளது	குறைந்துள்ளது
kulanggalil	குளங்களில்	குழங்களில்
kulangkalil	குளங்களில்	குழங்களில்
kulanggalukku	குளங்களுக்கு	குழங்களுக்கு
kulangkalukku	குளங்களுக்கு	குழங்களுக்கு
kulirchchiyaana	குளிர்ச்சியான	குளிர்ச்சியான
kulai	குழை	குழை
kuzai	குழை	குழை
kuzhai	குழை	குழை
gooam	குவாம்	கோம்
guam	குவாம்	காம்
guama	குவாம்	காமா
guuam	குவாம்	காம்
guuama	குவாம்	கோமா
kuvam	குவாம்	குவாம்
kuvindha	குவிந்த	குவிந்த
kuvinta	குவிந்த	குவிந்த
kuvintha	குவிந்த	குவிந்த
kuvindhulladhu	குவிந்துள்ளது	குவிந்துள்ளது
kuvindhullathu	குவிந்துள்ளது	குவிந்துள்ளது
kuvinthullathu	குவிந்துள்ளது	குவிந்துள்ளது
kuvintullathu	குவிந்துள்ளது	குவிந்துள்ளது
kuvintullatu	குவிந்துள்ளது	குவிந்துள்ளது
koodam	கூடம்	கோடம்
koodi	கூடி	கோடி
koodith	கூடித்	கோடித்து
koodinar	கூடினர்	கோடின்ற
koodip	கூடிப்	கோடிப்
koodu	கூடு	கோடு
kuudu	கூடு	குடு
kuutu	கூடு	கூடு
koodugalai	கூடுகளை	கூடுகளை
koodukalai	கூடுகளை	கூடுகளை
kuudukalai	கூடுகளை	குடுகளை
kuutukalai	கூடுகளை	குடுகளை
koodugal	கூடுகள்	கூடுகள்
koodukal	கூடுகள்	கூடுகள்
kuudugal	கூடுகள்	குடுகள்
kuudukal	கூடுகள்	குடுகள்
kuutukal	கூடுகள்	கூடுகள்
kootta	கூட்ட	கோட்ட
kuuta	கூட்ட	கூட்
kuutta	கூட்ட	கூட்ட
koottangalil	கூட்டங்களில்	கோட்டங்களில்
kuuttangalil	கூட்டங்களில்	கூட்டங்களில்
kuuttankalil	கூட்டங்களில்	கூட்டங்களில்
koottangalum	கூட்டங்களும்	கோட்டங்களும்
kuuttangalum	கூட்டங்களும்	கூட்டங்களும்
kuuttankalum	கூட்டங்களும்	கூட்டங்களும்
koottaththirku	கூட்டத்திற்கு	கூட்டித்திற்
kuuttatthirku	கூட்டத்திற்கு	கூட்டித்துக்
kuuttattirku	கூட்டத்திற்கு	கூட்டிர்ற்கு
koottaththil	கூட்டத்தில்	கூட்டத்தில்
koottatthil	கூட்டத்தில்	கூட்டத்தில்
kuuttatil	கூட்டத்தில்	கூட்டதில்
kuuttatthil	கூட்டத்தில்	கூட்டத்தில்
kuuttattil	கூட்டத்தில்	கூட்டத்தில்
koottaththudan	கூட்டத்துடன்	கூட்டத்துடன்
koottatthudan	கூட்டத்துடன்	கூட்டத்துடன்
kuutattudan	கூட்டத்துடன்	கூட்டடுடன்
kuutattutan	கூட்டத்துடன்	கூட்டத்தன்
koottaththaik	கூட்டத்தைக்	கூட்டத்தைக்
koottatthaik	கூட்டத்தைக்	கூட்டத்தைக்
kuuttattaik	கூட்டத்தைக்	கூட்டத்தைக்
kuuttatthaik	கூட்டத்தைக்	கூட்டத்தைக்
koottaththaip	கூட்டத்தைப்	கூட்டத்தைப்
koottatthaip	கூட்டத்தைப்	கூட்டைத்தை
kuuttataip	கூட்டத்தைப்	கூட்டைப்
kuuttattaip	கூட்டத்தைப்	கூட்டைத்தை
koottal	கூட்டல்	கோட்டல்
koottavo	கூட்டவோ	கோட்டோ
kuutavoo	கூட்டவோ	கூடோவோ
kuuttavoo	கூட்டவோ	கூட்டோவோ
koottagach	கூட்டாகச்	கோட்டசக்
koottakach	கூட்டாகச்	கோட்டசக்
kuuttaakac	கூட்டாகச்	கூட்டாக்
kuuttaakach	கூட்டாகச்	கூட்டாகச்
kootinaal	கூட்டினால்	கோட்டியால்
koottinaal	கூட்டினால்	கோட்டியால்
koottinal	கூட்டினால்	கோட்டின்
koottuvadharkku	கூட்டுவதற்கு	கூட்டுவதற்கு
koottuvadharku	கூட்டுவதற்கு	கூட்டுவதற்கு
koottuvatharku	கூட்டுவதற்கு	கூட்டுவதற்கு
koottai	கூட்டை	கோட்டை
koorai	கூரை	கோரை
kooraigal	கூரைகள்	கோறைகள்
kooraikal	கூரைகள்	கோறைகள்
kooreigal	கூரைகள்	கோரியகள்
kooraiyin	கூரையின்	கோரையின்
kooraiyilirundhu	கூரையிலிருந்து	கோறியிலிருந்து
kooraiyilirunthu	கூரையிலிருந்து	கோறியிலிருந்து
koorayilirindhu	கூரையிலிருந்து	கோரியிலிருந்து
mudiyuma	கூற	முடியும
mudiyumaa	கூற	முடியுமா
mutiyuma	கூற	முடியும்
mutiyumaa	கூற	முட்யியா
koorappattadhu	கூறப்பட்டது	கோபர்பட்டது
koorappattathu	கூறப்பட்டது	கோபர்பட்டது
kuurapattatu	கூறப்பட்டது	குறப்பட்டது
kuurappattatu	கூறப்பட்டது	குறப்பட்டது
koorappattana	கூறப்பட்டன	கோபர்பட்டன
kuurapattana	கூறப்பட்டன	குரப்பட்டன
kuurappattana	கூறப்பட்டன	குறப்பட்டன
koorappattaalum	கூறப்பட்டாலும்	கோபர்பட்டாலும்
kuurappataalum	கூறப்பட்டாலும்	கூறப்பாடும்
kuurappattaalum	கூறப்பட்டாலும்	குறப்பட்டாலும்
koorappattaal	கூறப்பட்டால்	கோபர்பட்டால்
kuurapattaal	கூறப்பட்டால்	கூறப்பட்டால்
kuurappattaal	கூறப்பட்டால்	குறப்பட்டால்
koorappattulla	கூறப்பட்டுள்ள	கோறப்பட்டுள்ள
kuurapattulla	கூறப்பட்டுள்ள	கூறப்பட்டுள்ள
kuurappattulla	கூறப்பட்டுள்ள	குறப்பட்டுள்ள
kooravillai	கூறவில்லை	கோருவிலைல்
kuuravillai	கூறவில்லை	குறவில்லை
kooravae	கூறவே	கோரவே
koorave	கூறவே	கோரவே
kuravee	கூறவே	குரவே
koorinaal	கூறினால்	கோரினால்
kuurinaal	கூறினால்	குரிநால்
koorudhal	கூறுதல்	கூறுதல்
kooruthal	கூறுதல்	கூறுதல்
koorumpoadhu	கூறும்போது	கூறும்போது
koorumpodhu	கூறும்போது	கூறும்புது
koorumpothu	கூறும்போது	கூரும்புது
kedu	கெடு	கேடு
kaeplar	கெப்லர்	கேப்பல்
keeplar	கெப்லர்	கீப்லர்
keplar	கெப்லர்	கெப்பர்
kepler	கெப்லர்	கெப்லிர்
kiiplar	கெப்லர்	கிப்பர்
qeeplar	கெப்லர்	கீப்லர்
qeplar	கெப்லர்	கெப்பர்
qepler	கெப்லர்	கெப்லிர்
kaellar	கெல்லர்	கேல்லர்
keler	கெல்லர்	கேலிர்
kellar	கெல்லர்	கெல்லர்
keller	கெல்லர்	கெல்லிர்
qeller	கெல்லர்	கெல்லிர்
ccelli	கெல்லி	கெல்லி
ccelly	கெல்லி	கெல்லி
ccely	கெல்லி	கிலி
celli	கெல்லி	செல்லி
celly	கெல்லி	செல்லி
cely	கெல்லி	கெலி
kaelli	கெல்லி	காலில்
keley	கெல்லி	கேலி
keli	கெல்லி	கேலி
kellei	கெல்லி	கெல்லி
kelley	கெல்லி	கெல்லி
kelli	கெல்லி	கெல்லி
kelly	கெல்லி	கெல்லி
kely	கெல்லி	கெலி
qelley	கெல்லி	கெல்லி
qelli	கெல்லி	கெல்லி
qelly	கெல்லி	கெல்லி
gautham	கெளதம்	காத்தம்
goutham	கெளதம்	கோதம்
kaudham	கெளதம்	காத்தம்
kovtham	கெளதம்	கோத்தம்
catalina	கேடலினா	கடலினா
cetalina	கேடலினா	கேட்லானி
keedalina	கேடலினா	கீடிலான
kaetta	கேட்ட	கேட்ட
ketta	கேட்ட	கேட்டா
kaettadhai	கேட்டதை	கேட்தைதை
kaettathai	கேட்டதை	கேட்தைதை
ketadhai	கேட்டதை	கேட்தை
ketathai	கேட்டதை	கேட்தை
kaettal	கேட்டல்	கேட்டல்
kettal	கேட்டல்	கேட்டல்
kaettavar	கேட்டவர்	கேட்டவர்
kettavar	கேட்டவர்	கேட்டவர்
kaettaan	கேட்டான்	கேட்டான்
kettan	கேட்டான்	கேட்டன்
catie	கேட்டி	கேடி
catiee	கேட்டி	கீடி
cetie	கேட்டி	கீட்
kaetti	கேட்டி	கேட்டி
kati	கேட்டி	காடி
katie	கேட்டி	கேடி
katiee	கேட்டி	கதி
katii	கேட்டி	கதி
katiie	கேட்டி	கதிடி
katiiee	கேட்டி	கதிதே
kattie	கேட்டி	காட்டி
kattiee	கேட்டி	கட்டீ
katy	கேட்டி	காடி
katyi	கேட்டி	காடி
ketie	கேட்டி	கீட்டி
ketiee	கேட்டி	கீட்டி
ketiie	கேட்டி	கீட்டி
ketti	கேட்டி	காட்டி
kettie	கேட்டி	காட்டி
kety	கேட்டி	கேட்
ketyi	கேட்டி	கெட்டி
qatie	கேட்டி	காடி
qatiee	கேட்டி	கதிதே
qatiie	கேட்டி	கதிடி
qattie	கேட்டி	காட்டி
qaty	கேட்டி	காட்
qatyi	கேட்டி	காடி
kaettum	கேட்டும்	கேட்டும்
kettum	கேட்டும்	கேட்டும்
kaendhira	கேந்திர	கேந்திர
kaenthira	கேந்திர	கேந்திர
kendhira	கேந்திர	கென்திர
kendra	கேந்திர	கென்ற
kaikoarkka	கைகோர்க்க	கைக்கோற்க
kaikoorkka	கைகோர்க்க	கைக்கோர்க்
kaikorkka	கைகோர்க்க	கைக்க்றோக்
kaik	கைக்	கைக்
kaidhi	கைதி	கைதி
kaithi	கைதி	கைத்தி
kaydhi	கைதி	கைத்தி
kaythi	கைதி	காத்தி
kaidhigaludan	கைதிகளுடன்	கைதிகளுடன்
kaidhigalutan	கைதிகளுடன்	கைதிகளுடன்
kaidhikaludan	கைதிகளுடன்	கைதிகளுடன்
kaithigaludan	கைதிகளுடன்	கைத்திகளுடன்
kaithigalutan	கைதிகளுடன்	கைத்திகளுடன்
kaidhigalaiyum	கைதிகளையும்	கைதிகளையும்
kaidhikalaiyum	கைதிகளையும்	கைதிகளையும்
kaithigalaiyum	கைதிகளையும்	கைதிகளையும்
kaiyin	கையின்	கையின்
kaiyoppamitta	கையொப்பமிட்ட	கையாப்போட்ட்ட
kaiyoppamittaar	கையொப்பமிட்டார்	கையாப்போட்ட்ர்
kaiyoppamittar	கையொப்பமிட்டார்	கையாப்போட்ட்ட்
kaivittanar	கைவிட்டனர்	கைவிட்டனர்
kaiviral	கைவிரல்	கைவிர்ள்
kodukkiradhu	கொடுக்கிறது	கொடுக்கிறது
kodukkirathu	கொடுக்கிறது	கொடுக்கிறது
kodukkiraan	கொடுக்கிறான்	கொடுக்கிறான்
kodukkiraar	கொடுக்கிறார்	கொடுக்கிறார்
kottagai	கொட்டகை	கொட்டைக்
kottagaikku	கொட்டகைக்கு	கொட்டைக்குக்
vidugirathu	கொட்டி	விடுகிறது
vidukirathu	கொட்டி	விடுகிறது
vitukiratu	கொட்டி	விடுகிறது
kottik	கொட்டிக்	கோட்டிக்
konara	கொணர	கோனா
kondaa	கொண்டா	கொண்டா
kondirukkaamal	கொண்டிருக்காமல்	கொண்டிருக்காலம்
kondirukkamal	கொண்டிருக்காமல்	கொண்டிருக்கால்
kontirukkamal	கொண்டிருக்காமல்	கொண்டிருக்கமால்
kodhi	கொதி	கோதி
kothi	கொதி	கோதி
kodhikka	கொதிக்க	கொதிக்க
kothikka	கொதிக்க	கொதிக்க
gorilla	கொரில்லாப்	கோரில்ல்
gorillaap	கொரில்லாப்	கொரில்லப்ப்
gorillap	கொரில்லாப்	கொரில்லப்
korillaap	கொரில்லாப்	கொரில்லப்ப்
kolusu	கொலுசு	கொளுசு
kolgiraar	கொள்கிறார்	கொல்கிறார்
kolkiraar	கொள்கிறார்	கொல்கிறார்
kolgiraen	கொள்கிறேன்	கொல்கிரின்
kolkirayn	கொள்கிறேன்	கொள்கிறின்
kollvadhan	கொள்வதன்	கொள்ளவத்தன்
kolvadhan	கொள்வதன்	கொள்வதன்
kolvathan	கொள்வதன்	கொள்வதன்
kolvadharkaaga	கொள்வதற்காக	கொள்வதற்காக
kolvatharkaaka	கொள்வதற்காக	கொள்தவதற்காக
kollvadharkaagavum	கொள்வதற்காகவும்	கொள்ளவத்தவாகம்க
kolvadharkaagavum	கொள்வதற்காகவும்	கொள்வதற்கவும்க
kolvatharkkakavum	கொள்வதற்காகவும்	கொள்வத்துகவக்கம்
kollvadhaaga	கொள்வதாக	கொள்ளத்தாக
kolvadhaaga	கொள்வதாக	கொள்வதாக
kolvathaaka	கொள்வதாக	கொள்வதாக
kollvathaagum	கொள்வதாகும்	கொள்ளத்தாகும்
kolvadhaagum	கொள்வதாகும்	கொள்வதாகும்
kolvathaakum	கொள்வதாகும்	கொள்தவதாகும்
kolu	கொழு	கொளு
kozhu	கொழு	கொழு
koadaari	கோடாரி	கோடாரி
koodaari	கோடாரி	கோடாரி
kootaari	கோடாரி	கோடாரி
kaalangalil	கோடைக்	காலங்களில்
kaalangazhil	கோடைக்	காலங்களில்
kaalangkalil	கோடைக்	காலங்களில்
kalankalil	கோடைக்	கலங்களில்
koatpaatukalil	கோட்பாடுகளில்	கோட்பாட்டுகளில்
kootpaadugalil	கோட்பாடுகளில்	கோட்பாடுகளில்
kootpaadukalil	கோட்பாடுகளில்	கோட்பாடுகளில்
kootpaatukalil	கோட்பாடுகளில்	கோட்பாட்டுகளில்
koatpaatugalukku	கோட்பாடுகளுக்கு	கோட்பாடுக்குக்கு
kootpaadugalukku	கோட்பாடுகளுக்கு	கோட்பாடுகளுக்கு
kootpaadukalukku	கோட்பாடுகளுக்கு	கோட்பாடுக்குக்கு
kootpaatugalukku	கோட்பாடுகளுக்கு	கோட்பாடுக்குக்கு
kootpaatukalukku	கோட்பாடுகளுக்கு	கோட்பாடுக்குக்கு
koatpaatukalaip	கோட்பாடுகளைப்	கோட்பாடுகளைப்
kootpaadugalaip	கோட்பாடுகளைப்	கோட்பாடுகளைப்
kootpaadukalaip	கோட்பாடுகளைப்	கோட்பாடுகளைப்
kootpaatugalaip	கோட்பாடுகளைப்	கோட்பாடுகளைப்
kootpaatukalaip	கோட்பாடுகளைப்	கோட்பாடுக்களை
koatpaatukalaiyum	கோட்பாடுகளையும்	கோட்பாடுகளையும்
kootpaadukalaiyum	கோட்பாடுகளையும்	கோட்பாடுகளையும்
koatpaatukal	கோட்பாடுகள்	கோட்பாட்டுகள்
kootpaadugal	கோட்பாடுகள்	கோட்பாடுகள்
kootpaadukal	கோட்பாடுகள்	கோட்பாடுகள்
kootpaatukal	கோட்பாடுகள்	கோட்பாடுகள்
godhra	கோத்ரா	கோத்ரா
koathraa	கோத்ரா	கோத்தா
koothraa	கோத்ரா	கோத்தா
kootraa	கோத்ரா	கோற்றா
conan	கோனன்	கோனன்
conann	கோனன்	கோனன்
connan	கோனன்	கோனன்
coonan	கோனன்	கோனன்
coonann	கோனன்	கோனன்
coonnan	கோனன்	கோனன்
coounan	கோனன்	கோனன்
coownan	கோனன்	கோனன்
counan	கோனன்	கோனன்
couunan	கோனன்	கோனன்
covnan	கோனன்	சோனன்
cownan	கோனன்	கோனன்
koonn	கோனன்	கோன்
koapiththukkondu	கோபித்துக்கொண்டு	கோபித்துக்கொட்டு
kobiththukkondu	கோபித்துக்கொண்டு	கோபித்துக்க்க்டு
kobithukondu	கோபித்துக்கொண்டு	கோபித்துக்குடு
koopitthukkontu	கோபித்துக்கொண்டு	கோபிட்டுக்கிட்
koopittukkondu	கோபித்துக்கொண்டு	கோபிட்டுக்கிட்டு
koopittukkontu	கோபித்துக்கொண்டு	கோபிட்டுக்கிட்டு
kopiththukkondu	கோபித்துக்கொண்டு	கோபித்துக்கொட்டு
kopithukondu	கோபித்துக்கொண்டு	கோபிட்துக்குடு
koamagan	கோமகன்	கோமான்
komagan	கோமகன்	கோமான்
koomagan	கோமகன்	கோமான்
koomakan	கோமகன்	கோமான்
caul	கோல்	கால்
cauul	கோல்	கால்
col	கோல்	கால்
coll	கோல்	கால்ல்
cool	கோல்	கோல்
cooll	கோல்	கால்ல்
goal	கோல்	கோல்
goall	கோல்	கோல்ல்
gol	கோல்	கோல்
gooal	கோல்	கோல்
gooall	கோல்	கோல்ல்
gool	கோல்	கோல்
gooul	கோல்	கோல்
goul	கோல்	கோல்
gouul	கோல்	கோல்
kaul	கோல்	கால்
kauul	கோல்	கால்
kol	கோல்	கோல்
kole	கோல்	கோலி
kool	கோல்	கோல்
qaul	கோல்	கால்
qol	கோல்	கால்
goalgal	கோல்கள்	கோல்கள்
goalkal	கோல்கள்	கோல்கள்
kolgal	கோல்கள்	கொள்கள்
koolkal	கோல்கள்	கோல்கள்
golconda	கோல்கொண்டா	கொல்கோட்டா
golkonda	கோல்கொண்டா	கொல்கோட்டா
koolkondaa	கோல்கொண்டா	கொல்கோட்டா
koolkontaa	கோல்கொண்டா	கொல்கோட்டா
kolil	கோளில்	கொளில்
koolil	கோளில்	கோலில்
koovalar	கோவலர்	கோவலர்
kovalar	கோவலர்	கோவலர்
gouravaththai	கௌரவத்தை	கோரவத்தை
gowravathai	கௌரவத்தை	கோரவத்தை
gowrawaththay	கௌரவத்தை	கோரவத்தை
kouravaththay	கௌரவத்தை	கூறவதத்தை
gouravamana	கௌரவமான	கோரவமான
gowravamaana	கௌரவமான	கோரவிமான
gowrawamaana	கௌரவமான	கோரவவான
kouravamaana	கௌரவமான	கோரவமான
gauravam	கௌரவம்	கருவம்
gowravam	கௌரவம்	கோவர்ம்
kauravam	கௌரவம்	கருவம்
kouravam	கௌரவம்	கோரவம்
gouravippu	கௌரவிப்பு	கூருவிப்பு
gowravippu	கௌரவிப்பு	கோவரிப்பு
gowrawippu	கௌரவிப்பு	கோவரிப்பு
kouravippu	கௌரவிப்பு	கூருவிப்பு
saga	சக	சகா
saka	சக	சாக
cagaaya	சகாய	காசயா
cakaaya	சகாய	காசாய
chagaaya	சகாய	சகாயா
chakaaya	சகாய	சகாயா
sagaaya	சகாய	சகாயா
sagaya	சகாய	சகாயா
cagaayam	சகாயம்	காசயம்
cakaayam	சகாயம்	காசயம்
chagaayam	சகாயம்	சகாயம்
chakaayam	சகாயம்	சகாயம்
sagaayam	சகாயம்	சகாயம்
sagayam	சகாயம்	சகையம்
cakkara	சக்கர	காக்கர
chakkara	சக்கர	சக்கர
sakkara	சக்கர	சக்கார
cakkarangal	சக்கரங்கள்	காக்கரங்கள்
cakkarankal	சக்கரங்கள்	காக்கரங்கள்
chakkarangal	சக்கரங்கள்	சக்கங்கள்
chakkarankal	சக்கரங்கள்	சக்கங்கள்
sakkarangal	சக்கரங்கள்	சக்கங்கள்
sakkaranggal	சக்கரங்கள்	சக்கங்கள்
chakkaraththil	சக்கரத்தில்	சக்கரத்தில்
sakkaraththil	சக்கரத்தில்	சக்கரத்தில்
cakkaram	சக்கரம்	காக்கரம்
chakkaram	சக்கரம்	சக்கரம்
sakkaram	சக்கரம்	சக்கரம்
cakkarai	சக்கரை	கா்கரை
chakkarai	சக்கரை	சக்கரை
sakkarai	சக்கரை	சக்கரை
changka	சங்க	சங்க
sanga	சங்க	சங்க
sangga	சங்க	சங்க
sangh	சங்க	சங்க
sangha	சங்க	சங்க
sangka	சங்க	சங்க
sangangalin	சங்கங்களின்	சங்கங்களின்
sanggangkalin	சங்கங்களின்	சங்கங்களின்
sangkangkalin	சங்கங்களின்	சங்கங்களின்
sangangalil	சங்கங்களில்	சங்கங்களில்
sanggangkalil	சங்கங்களில்	சங்கங்களில்
sangkangkalil	சங்கங்களில்	சங்கங்களில்
cankangalum	சங்கங்களும்	சங்கங்களும்
cankankalum	சங்கங்களும்	சங்கங்களும்
chankangalum	சங்கங்களும்	சங்கங்களும்
chankankalum	சங்கங்களும்	சங்கங்களும்
sangankalum	சங்கங்களும்	சங்கங்களும்
sanggangkalum	சங்கங்களும்	சங்கங்களும்
changkaththaal	சங்கத்தால்	சங்கத்தால்
sangaththal	சங்கத்தால்	சங்கத்தல்
sanggaththaal	சங்கத்தால்	சங்கத்தால்
sangkaththaal	சங்கத்தால்	சங்கத்தால்
cankatthin	சங்கத்தின்	கங்கத்தின்
cankattin	சங்கத்தின்	காங்கட்டின்
chankattin	சங்கத்தின்	சங்கட்டின்
sangaththin	சங்கத்தின்	சங்கத்தின்
sanggaththin	சங்கத்தின்	சங்கத்தின்
sangaththilirundhdhu	சங்கத்திலிருந்து	சங்கத்திலிருந்து
sangaththilirundhu	சங்கத்திலிருந்து	சங்கத்திலிருந்து
sangaththilirunthu	சங்கத்திலிருந்து	சங்கத்திருந்து
sanggaththilirunthu	சங்கத்திலிருந்து	சங்கித்திருந்து
sangaththilum	சங்கத்திலும்	சங்கத்திலும்
sanggaththilum	சங்கத்திலும்	சங்கத்திலும்
sangap	சங்கப்	சங்கப்
sanggap	சங்கப்	சங்கப்
sankap	சங்கப்	சங்கப்
sangama	சங்கம	சங்கமா
sanggama	சங்கம	சங்கமா
sankama	சங்கம	சங்கமா
sankarin	சங்கரின்	சங்கரின்
shankarin	சங்கரின்	சங்காரின்
sanggin	சங்கின்	சங்கின்
sangin	சங்கின்	சங்கின்
sanggiliyin	சங்கிலியின்	சங்கிலியின்
sangiliyin	சங்கிலியின்	சங்கிலியின்
sangilyyin	சங்கிலியின்	சங்கியிலின்
sanggiliyil	சங்கிலியில்	சங்கிலிலில்
sangiliyil	சங்கிலியில்	சங்கிலிலில்
sangilyyil	சங்கிலியில்	சங்கிலியில்
sattaikku	சட்டைக்கு	சட்டைக்கு
sadhaveedha	சதவீத	சதேவத
sathaveetha	சதவீத	சதேவதே
sadhaveedhaththai	சதவீதத்தை	சதவதிதத்தை
sathaveedhaththai	சதவீதத்தை	சதவதிதத்தை
sathaveethaththai	சதவீதத்தை	சதவதிதத்தை
santharppa	சந்தர்ப்ப	சந்தரப்பா
santharppaththai	சந்தர்ப்பத்தை	சந்தரப்பத்தை
sandhaa	சந்தா	சந்தா
santha	சந்தா	சந்த
santhaa	சந்தா	சந்தா
sandhaippaduththudhal	சந்தைப்படுத்துதல்	சந்தையப்பட்துளது
sandhaippaduththuthal	சந்தைப்படுத்துதல்	சந்தையப்பட்துதுள்
santhaippaduththuthal	சந்தைப்படுத்துதல்	சந்தைப்பத்துடுள்ள
sandhaippaduththum	சந்தைப்படுத்தும்	சந்தைப்பத்தும்
santhaippaduththum	சந்தைப்படுத்தும்	சந்தைப்படுத்தும்
chaand	சந்த்	சா்்
chand	சந்த்	சா்
chanda	சந்த்	சந்தா
jaen	சன	ஜேன்
jain	சன	ஜென்
jan	சன	ஜான்
jann	சன	ஜென்
jayn	சன	ஜெய்
zaen	சன	ஜென்
zan	சன	ஜென்
zann	சன	ஜென்
zayn	சன	ஜெய்
san	சன்	சன்
sann	சன்	சன்
son	சன்	சோன்
sun	சன்	சுன்
sunn	சன்	சன்
suun	சன்	சுன்
suunn	சன்	சுன்
tivi	சன்	டிவி
sabadham	சபதம்	சபதம்
sabatham	சபதம்	சபதம்
sabaiyinar	சபையினர்	சபையினர்
sab	சப்	சப்
sabb	சப்	சப்ப
sub	சப்	சுப்
subb	சப்	சுப்ப்
suub	சப்	சுப்
suubb	சப்	சப்ப்
samagaalaththil	சமகாலத்தில்	சமகாளத்தில்
samakaalaththil	சமகாலத்தில்	சமகாளத்தில்
samacheeraana	சமச்சீரான	சமசரேயான
samachieerana	சமச்சீரான	சமசியேரன
samachierana	சமச்சீரான	சமசிரான
samamaagavae	சமமாகவே	சமமாகவே
samamagave	சமமாகவே	சமமாகவே
samamakave	சமமாகவே	சமமகவே
samamaagum	சமமாகும்	சமமாகும்
samamagum	சமமாகும்	சமமகம்
samamakum	சமமாகும்	சமமகம்
samayaththavar	சமயத்தவர்	சமையத்தவர்
samarppiththa	சமர்ப்பித்த	சமர்ப்பித்த
samavaaippu	சமவாய்ப்பு	சமாமைப்பு
samavaayppu	சமவாய்ப்பு	சமாபாப்பு
samavaippu	சமவாய்ப்பு	சமைப்பு
sameera	சமீரா	சமேரா
samsaara	சம்சார	சம்சார
sumsaara	சம்சார	சுமாரா
sambirathaayathil	சம்பிரதாயத்தில்	சம்பாரிததியதில்
sambradhaayathil	சம்பிரதாயத்தில்	சம்பாரததியில்
sambrathaayathil	சம்பிரதாயத்தில்	சம்பாரததியில்
sampirathaayatthil	சம்பிரதாயத்தில்	சம்பாறிதத்தில்
sampirathayathil	சம்பிரதாயத்தில்	சம்பித்தியதில்
sampirathayaththil	சம்பிரதாயத்தில்	சம்பித்ததியதில்
sambiradhayathai	சம்பிரதாயத்தை	சம்பிததரையதை
sambradhayathai	சம்பிரதாயத்தை	சம்பரததையை
sambrathayaththai	சம்பிரதாயத்தை	சம்பரதததையத்
sampiradhayathai	சம்பிரதாயத்தை	சம்பித்தாயை
sampirathaayatthai	சம்பிரதாயத்தை	சம்பிறத்தையாத
sampirathayaththai	சம்பிரதாயத்தை	சம்பித்ததையத்
sambandhappatta	சம்மந்தப்பட்ட	சம்பப்பத்தாட்ட
sammanthappatta	சம்மந்தப்பட்ட	சமம்பந்தப்பட்ட
sammandhdhamaana	சம்மந்தமான	சமம்நமததன
sammanthamaana	சம்மந்தமான	சமம்நாதன
cargo	சரக்கு	கர்கோ
kargo	சரக்கு	கர்கோ
kargoo	சரக்கு	கர்கோ
kargou	சரக்கு	கர்கோ
kargouu	சரக்கு	கர்கு
kargu	சரக்கு	கர்கு
karrgo	சரக்கு	கர்கோ
qargoo	சரக்கு	கர்கோ
qargou	சரக்கு	கர்கு
qarrgo	சரக்கு	கர்க்
sarakku	சரக்கு	சரக்கு
sarakkukalai	சரக்குகளை	சரக்குகளை
sarasu	சரசு	சராசு
saranadainthanar	சரணடைந்தனர்	சரணணடிதன்ற
saranadaiyach	சரணடையச்	சராணயையை
soorai	சர்ரே	சூரை
sooray	சர்ரே	சூரை
soorey	சர்ரே	சூரி
soorreey	சர்ரே	சூர்ரியே
soorrei	சர்ரே	சூர்ரை
soorrey	சர்ரே	சூர்ரி
suray	சர்ரே	சுரா
surey	சர்ரே	சுரே
surrai	சர்ரே	சுற்றை
surray	சர்ரே	சுர்ரை
surreey	சர்ரே	சுர்ரேயி
surrei	சர்ரே	சுர்ரே
surrey	சர்ரே	சுர்ரி
suurray	சர்ரே	சூர்ரை
suurrey	சர்ரே	சுர்ரி
sarvaadhigaara	சர்வாதிகார	சர்வாத்தாகி
sarvaathikaara	சர்வாதிகார	சர்வாத்தாகி
sarvaadhigaaraththai	சர்வாதிகாரத்தை	சர்வாத்தாகிித்
sarvaathikaaraththai	சர்வாதிகாரத்தை	சர்வாத்தாகிதி
sarvaathikaaratthai	சர்வாதிகாரத்தை	சர்வாத்திகாறதி
sarvaadhigaaram	சர்வாதிகாரம்	சர்வாத்தாகம்
sarvaathikaaram	சர்வாதிகாரம்	சர்வாத்தாகம்
sarvaadigaari	சர்வாதிகாரி	சர்வாாகிறியர்
sarvaathikaari	சர்வாதிகாரி	சர்வாத்திகியா
satru	சற்று	சற்று
sattru	சற்று	சற்று
saakkadai	சாக்கடை	சாக்கை
sakkadai	சாக்கடை	சக்காடை
saakkadaigal	சாக்கடைகள்	சாக்கைகள்
sakkadaikal	சாக்கடைகள்	சக்ககைகள்
saakkiya	சாக்கிய	சாக்கிய
sakkiya	சாக்கிய	சக்கிய
saasanam	சாசனம்	சாசனம்
sasanam	சாசனம்	சசனம்
saattai	சாட்டை	சாட்டை
saattay	சாட்டை	சாட்டை
sattai	சாட்டை	சட்டை
saadhagamaaga	சாதகமாக	சாதகாக
saathakamaaka	சாதகமாக	சாதகாக
sathakamaka	சாதகமாக	சதககமா
saathanangal	சாதனங்கள்	சாதங்கள்
saathanangkal	சாதனங்கள்	சாதங்கள்
saadhaarana	சாதாரண	சாதாரா
saathaarana	சாதாரண	சாதாரா
saadhaaranamaaga	சாதாரணமாக	சாதாராாக
saathaaranamaaga	சாதாரணமாக	சாதாராாக
saathaaranamaaka	சாதாரணமாக	சாதாராாக
saadhaaranamaanathu	சாதாரணமானது	சாதாரானது
saathaaranamaanathu	சாதாரணமானது	சாதாரானது
saaththiyamaaga	சாத்தியமாக	சாத்தியாக
saaththiyamaaka	சாத்தியமாக	சாத்தியாக
saaththiyamaagum	சாத்தியமாகும்	சாத்தியாமும்
saaththiyamaakum	சாத்தியமாகும்	சாத்தியாமும்
saayam	சாயம்	சாயம்
saaradhi	சாரதி	சாரதி
saarathi	சாரதி	சாரதி
saarathy	சாரதி	சாரத்தி
sarathi	சாரதி	சரதி
caarnthoo	சார்ந்தோ	கார்ந்தோ
chaarntho	சார்ந்தோ	சார்ந்தோ
saarndhoa	சார்ந்தோ	சார்ந்தோ
saarnthoo	சார்ந்தோ	சார்ந்தோ
caarpatta	சார்பற்ற	கார்ப்ட்ட
chaarpatta	சார்பற்ற	சார்ப்பட்ட
saarpatta	சார்பற்ற	சார்ப்டட்
saarpattra	சார்பற்ற	சார்ப்பட்ட
saarpattrra	சார்பற்ற	சார்ப்ற்ற
chaalukkiya	சாளுக்கிய	சாலுக்கிய
chalukya	சாளுக்கிய	சலக்கியா
saalukkiya	சாளுக்கிய	சாலுக்கிய
salukkiya	சாளுக்கிய	சலுக்கிய
java	சாவா	ஜாவா
saava	சாவா	சாவா
saavaa	சாவா	சாவா
saavilirundhu	சாவிலிருந்து	சாவிலிருந்து
saavilirunthu	சாவிலிருந்து	சாவிலிருந்து
saashthaa	சாஸ்தா	சாஷ்தா
saasthaa	சாஸ்தா	சாஸ்தா
sastha	சாஸ்தா	சாத்
saashthiriyin	சாஸ்திரியின்	சாத்திரியின்
saasthiriyin	சாஸ்திரியின்	சாத்திரியின்
sastriyin	சாஸ்திரியின்	சார்டியின்
shastriyin	சாஸ்திரியின்	சார்சியின்
chikkanam	சிக்கனம்	சிக்கம்
sikanam	சிக்கனம்	சிகானம்
sikkanam	சிக்கனம்	சிக்கம்
caitric	சிட்ரிக்	செட்ரிக்
cetric	சிட்ரிக்	கெற்றிக்
citric	சிட்ரிக்	சிற்றிக்
citrick	சிட்ரிக்	சிற்றிக்க்
citricq	சிட்ரிக்	சிற்றிக்க்
citrik	சிட்ரிக்	சிற்றிக்
citriq	சிட்ரிக்	சிற்றிக்
shidhi	சிதி	சிதி
sidhi	சிதி	சிதி
sidi	சிதி	சிடி
siidhii	சிதி	சிதிதி
siidii	சிதி	சிடி
sydhi	சிதி	சிதி
sydhii	சிதி	சித்தி
chithiraith	சித்திரைத்	சிதிரத்தை
sithiraith	சித்திரைத்	சிதிரத்தை
siththiraith	சித்திரைத்	சித்திரத்தை
sitthiraith	சித்திரைத்	சித்திரைத்
chithiraiyil	சித்திரையில்	சித்திரையில்
sithiraiyil	சித்திரையில்	சித்திரையில்
siththiraiyil	சித்திரையில்	சித்திரையில்
sitthiraiyil	சித்திரையில்	சித்திரையில்
chintha	சிந்தா	சிந்த
chinthaa	சிந்தா	சிந்தா
sindhaa	சிந்தா	சிந்தா
sintha	சிந்தா	சிந்த
sinthaa	சிந்தா	சிந்தா
chinthitthu	சிந்தித்து	சிந்தித்து
sinthiththu	சிந்தித்து	சிந்தித்து
sinthithu	சிந்தித்து	சிந்திது
sinthitthu	சிந்தித்து	சிந்தித்து
sindhu	சிந்து	சிந்து
sinthu	சிந்து	சிந்து
sindhum	சிந்தும்	சிந்தும்
sindhuvin	சிந்துவின்	சிந்துவின்
cbse	சிபிஎஸ்இ	பிஸ்
seempson	சிம்ப்சன்	சீம்போன்
siimpson	சிம்ப்சன்	சிம்போன்
simpsan	சிம்ப்சன்	சிம்பான்
simpson	சிம்ப்சன்	சிம்போன்
simpsonn	சிம்ப்சன்	சிம்பன்்
sympson	சிம்ப்சன்	சம்பின்
shimma	சிம்ம	சிம்மா
simma	சிம்ம	சிம்மா
chiyol	சியோல்	சியோல்
chiyool	சியோல்	சியோல்
seooul	சியோல்	சூல்
seoul	சியோல்	சூல்
seouul	சியோல்	சூல்
siyoal	சியோல்	சியால்
siyool	சியோல்	சியோல்
sirikka	சிரிக்க	சிரிக்க
siria	சிரிய	சிரியா
siriya	சிரிய	சிரியா
syria	சிரிய	சிரியா
siridhalavum	சிறிதளவும்	சிறிதாளவும்
sirithalavum	சிறிதளவும்	சிறித்தலும்
koodam	சிறைக்	கோடம்
kutam	சிறைக்	குடம்
siraik	சிறைக்	சிறைக்
siraikh	சிறைக்	சிரைக்
sivanadhu	சிவனது	சிவனது
sivanathu	சிவனது	சிவனது
sivanaal	சிவனால்	சிவானல்
sivanal	சிவனால்	சிவானல்
sivapragasham	சிவப்பிரகாசம்	சிவாரப்சம்
sivaprakasam	சிவப்பிரகாசம்	சிவாரப்கமம்
sivasivappiragasam	சிவப்பிரகாசம்	சிவசியர்பிகமாம
sivappirakaashar	சிவப்பிரகாசர்	சிவப்பரிக்கார்
sivappirakasar	சிவப்பிரகாசர்	சிவப்பிர்கரர்
sivaprakasar	சிவப்பிரகாசர்	சிவார்பரர்க்
sivaprakashar	சிவப்பிரகாசர்	சிவார்கரர்
cevil	சிவில்	சீவில்
cewil	சிவில்	செய்லி
civiil	சிவில்	சிவில்
civil	சிவில்	சிவில்
ciwiil	சிவில்	சிவில்
ciwil	சிவில்	சிவில்
sivil	சிவில்	சிவில்
siwil	சிவில்	சிவில்
season	சீசன்	சேசன்
sesan	சீசன்	சேசன்
seson	சீசன்	செசன்
siijan	சீசன்	சிசன்
siizan	சீசன்	சிசன்
sijan	சீசன்	சிசன்
sizan	சீசன்	சினா்
caesarin	சீசரின்	சேசரின்
cesarin	சீசரின்	சேரிின்
seesarin	சீசரின்	சீரிஷன்
caesar	சீசர்	சேசர்
cesar	சீசர்	சேசர்
ciisar	சீசர்	சிசார்
cisar	சீசர்	சிசர்
seesar	சீசர்	சீசர்
siijor	சீசர்	சிச்ரோ
sijor	சீசர்	சிஸ்
sizor	சீசர்	சிரோ்
seenivasan	சீனிவாசன்	செனிவான்
srinivasan	சீனிவாசன்	ஸ்ரிசனிவான்
seeriya	சீரிய	சீரிய
sarial	சீரியல்	சரியல்
serial	சீரியல்	செரியல்
seriial	சீரியல்	செரியல்
chiirutaikalai	சீருடைகளை	சிறுறைகளை
chirutaikalai	சீருடைகளை	சிறுதைகளை
seerudaigalai	சீருடைகளை	செறுகைகளை
seerudaikalai	சீருடைகளை	செறுகைகளை
serutaikalai	சீருடைகளை	செறுடைகளை
siirutaikalai	சீருடைகளை	சிறுறைகளை
seeri	சீறி	சீரி
sugandhan	சுகந்தன்	சுகந்தன்
suganthan	சுகந்தன்	சுகந்தன்
sukanthan	சுகந்தன்	சுகந்தன்
chukumaaran	சுகுமாரன்	சுகுமானர்
sugumaaran	சுகுமாரன்	சுகாமான்
sugumaran	சுகுமாரன்	சுகுமான்
sukumaaran	சுகுமாரன்	சுகுமார்
sukumaran	சுகுமாரன்	சுகுமான்
chuththa	சுத்த	சுத்த
chuttha	சுத்த	சுத்த
suththa	சுத்த	சுத்த
suttha	சுத்த	சுத்த
chuththap	சுத்தப்	சுத்தப்
chutthap	சுத்தப்	சுத்தப்
suththap	சுத்தப்	சுத்தப்
sutthap	சுத்தப்	சுத்தப்
chuttham	சுத்தம்	சுத்தம்
sutham	சுத்தம்	சுதம்
suththam	சுத்தம்	சுத்தம்
suttham	சுத்தம்	சுத்தம்
sudhthikarikkappatta	சுத்திகரிக்கப்பட்ட	சுத்திரக்கப்பட்ட
suththikarikkappatta	சுத்திகரிக்கப்பட்ட	சுத்திரக்கப்பட்ட
suththikarippu	சுத்திகரிப்பு	சுத்திரிக்கப்பு
chunithaa	சுனிதா	சுனிதா
sunita	சுனிதா	சுனித்
sunitha	சுனிதா	சுனித
sunithaa	சுனிதா	சுனிதா
suunita	சுனிதா	சுனிய
chuyeecchai	சுயேச்சை	சுயைச்சை
suyaechchai	சுயேச்சை	சுயச்சை
suyechai	சுயேச்சை	சுயைசை
suyechchai	சுயேச்சை	சுய்சைச்
suyeecchai	சுயேச்சை	சுசைசை
shruthi	சுருதி	சுரத்தி
surudhi	சுருதி	சுருதி
suruthi	சுருதி	சுருத்தி
surusuruppaaga	சுறுசுறுப்பாக	சுறுறுபாபாக
surrullaath	சுற்றுலாத்	சுற்றுளா்த்
sutrullaath	சுற்றுலாத்	சுற்றுள்ளத்
suttrulaath	சுற்றுலாத்	சுற்றாது
surrulaavin	சுற்றுலாவின்	சுற்றாலிவின்
sutrulaavin	சுற்றுலாவின்	சுற்றாலுவின்
suttrulaavin	சுற்றுலாவின்	சுற்றுளாவின்
surrulaavai	சுற்றுலாவை	சுற்றுளா
sutrulaavai	சுற்றுலாவை	சுற்றுளை
suttrulaavai	சுற்றுலாவை	சுற்றுளை
sulalil	சுழலில்	சுலலில்
suzhalil	சுழலில்	சுழலில்
suvaasikkath	சுவாசிக்கத்	சுவாசிக்கத்
suvachikkath	சுவாசிக்கத்	சுவாசிக்கத்
suvasikkath	சுவாசிக்கத்	சுவாசிக்கத்
chootti	சூட்டி	கோட்டி
chutti	சூட்டி	சுட்டி
shootti	சூட்டி	சோட்டி
sootti	சூட்டி	சூட்டி
choottinaar	சூட்டினார்	சோட்டினார்
chuttinaar	சூட்டினார்	சுட்டினார்
shoottinaar	சூட்டினார்	சூட்டினார்
soottinaar	சூட்டினார்	சூட்டினார்
choottinai	சூட்டினை	சோட்டினை
chuttinai	சூட்டினை	சுட்டினை
shootinai	சூட்டினை	சோதினை
soottinai	சூட்டினை	சூட்டினை
suittinai	சூட்டினை	சுட்டினை
choottil	சூட்டில்	சூட்டில்
soottil	சூட்டில்	சூட்டில்
suittil	சூட்டில்	சுட்டில்
choothaatta	சூதாட்ட	சூதாத்ட
soodhaatta	சூதாட்ட	சூடாத்த
soothaatta	சூதாட்ட	சூடாத்த
choothaattathil	சூதாட்டத்தில்	சூடாத்திதில்
soodhattaththil	சூதாட்டத்தில்	சூடத்ததித்
soothaattaththil	சூதாட்டத்தில்	சூடாத்தித்தில்
sooyas	சூயஸ்	சோசா
suez	சூயஸ்	சுஜ்
suyas	சூயஸ்	சுயா்
sooraavali	சூறாவளி	சூராவில்
sooravazhi	சூறாவளி	சூரவிி
sooraavaliyaaga	சூறாவளியாக	சூராவாயாக
sooraavaliyaaka	சூறாவளியாக	சூராவாயாக
sooravazhiyaga	சூறாவளியாக	சூரவியாக
soolappatta	சூழப்பட்ட	சொலப்பட்ட
soozhappatta	சூழப்பட்ட	சூழப்பட்ட
soolappattu	சூழப்பட்டு	சூலப்பட்டு
soozhappattu	சூழப்பட்டு	சூழப்பட்டு
chengkam	செங்கம்	செங்கம்
sengam	செங்கம்	செங்கம்
sengkam	செங்கம்	செங்கம்
senkam	செங்கம்	செங்கம்
seyarpaadugalinaal	செயற்பாடுகளினால்	செயர்பாடுகளிலால்
seyarpaadugal	செயற்பாடுகள்	செயற்பாடுகள்
seyarpadugal	செயற்பாடுகள்	செயற்படுகள்
seyarpaadum	செயற்பாடும்	செயர்பாடும்
seyarpadum	செயற்பாடும்	செயர்படும்
seyalaatri	செயலாற்றி	செயலாற்றி
seyalaattri	செயலாற்றி	செயலாற்றி
seyalattri	செயலாற்றி	செயல்றதி
seyalaatrum	செயலாற்றும்	செயலாறும்
seyalaattrum	செயலாற்றும்	செயலாற்றும்
seyalattrum	செயலாற்றும்	செயலற்றும்
seyalaatruvathu	செயலாற்றுவது	செயலாறுவது
seyalaattruvathu	செயலாற்றுவது	செயலாறுவது
seyalattruvadhu	செயலாற்றுவது	செயல்றுவது
seyalattruvathu	செயலாற்றுவது	செயல்றுவது
seyalilakka	செயலிழக்க	செயல்லைக்க
seyalizhakka	செயலிழக்க	செயல்லைக்க
seyalukku	செயலுக்கு	செயலுக்கு
seyalum	செயலும்	செயலும்
seyalpada	செயல்பட	செயல்பட
seyalpadakkoodiya	செயல்படக்கூடிய	செயல்படுக்கோயிய
seyalpadakkudiya	செயல்படக்கூடிய	செயல்படுக்கைய
seyalpadath	செயல்படத்	செயல்பட்டத்
seyalpadavillai	செயல்படவில்லை	செயல்பட்டைவில்
seyalpadavum	செயல்படவும்	செயல்படும்
seyalpaduvum	செயல்படவும்	செயல்படுவும்
seyalpadaamal	செயல்படாமல்	செயல்பாடலாம்
seyalpadamal	செயல்படாமல்	செயல்படலாம்
cheyalpaduvatharku	செயல்படுவதற்கு	செயல்படுவதற்கு
cheyalpatuvatharku	செயல்படுவதற்கு	செயல்படுவதற்கு
seyalpaduvadharku	செயல்படுவதற்கு	செயல்படுவதற்கு
seyalpaduvatharku	செயல்படுவதற்கு	செயல்படுவதற்கு
seyalpatuvatharku	செயல்படுவதற்கு	செயல்படுவதற்கு
cheyalmurai	செயல்முறை	செயல்முறை
seyalmurai	செயல்முறை	செயல்முறை
seidhadhan	செய்ததன்	செயத்தன்
seithathan	செய்ததன்	செய்தததன்
cheythavan	செய்தவன்	செய்தவன்
seidhavan	செய்தவன்	செய்தவன்
seithavan	செய்தவன்	செய்தவன்
seythavan	செய்தவன்	செய்தவன்
seidhulladhu	செய்துள்ளது	செய்துள்ளது
seithullathu	செய்துள்ளது	செய்துள்ளது
seidhullaar	செய்துள்ளார்	செய்துள்ளார்
seithullaar	செய்துள்ளார்	செய்துள்ளார்
seibavargalin	செய்பவர்களின்	செய்பவர்களின்
seibavarkalin	செய்பவர்களின்	செய்பவர்களின்
seibavargalukku	செய்பவர்களுக்கு	செய்பவர்களுக்கு
seibavarkalukku	செய்பவர்களுக்கு	செய்வபர்களுக்கு
seibavargalai	செய்பவர்களை	செய்பவர்களை
seibavarkalai	செய்பவர்களை	செய்பவர்களை
seiyappattathaal	செய்யப்பட்டதால்	செய்யப்பட்டால்
seiyyappattadhaal	செய்யப்பட்டதால்	செய்யப்பட்டதல்
seiyyappattathaal	செய்யப்பட்டதால்	செய்யப்பட்டதல்
seiyappattathai	செய்யப்பட்டதை	செய்யப்பட்டதை
seiyyappattadhai	செய்யப்பட்டதை	செய்யப்பட்டதை
seiyyappattathai	செய்யப்பட்டதை	செய்யப்பட்டதை
seiyappattana	செய்யப்பட்டன	செய்யப்பட்டன
seiyyappattana	செய்யப்பட்டன	செய்யப்பட்டன
seiyappattavar	செய்யப்பட்டவர்	செய்யப்பட்டர்
seiyyappattavar	செய்யப்பட்டவர்	செய்யப்பட்டவர்
seiyappattaal	செய்யப்பட்டால்	செய்யப்பட்டால்
seiyappattal	செய்யப்பட்டால்	செய்யப்பட்டல்
seyyappattal	செய்யப்பட்டால்	செய்யப்பட்டல்
seiyappattirukkum	செய்யப்பட்டிருக்கும்	செய்யப்பட்டிருக்கும்
seyyappattirukkum	செய்யப்பட்டிருக்கும்	செய்யப்பட்டிருக்கும்
seiyappattum	செய்யப்பட்டும்	செய்யப்பட்டும்
seyyappattum	செய்யப்பட்டும்	செய்யப்பட்டும்
seiyappattulla	செய்யப்பட்டுள்ள	செய்யப்பட்டுள்ள
seyyappattulla	செய்யப்பட்டுள்ள	செய்யப்பட்டுள்ள
seiyappattulladhu	செய்யப்பட்டுள்ளது	செய்யப்பட்டுள்ளது
seiyappattullathu	செய்யப்பட்டுள்ளது	செய்யப்பட்டுள்ளது
seyyappattullathu	செய்யப்பட்டுள்ளது	செய்யப்பட்டுள்ளது
seiyulil	செய்யுளில்	செய்யில்ல்
seyyulil	செய்யுளில்	செய்யில்
cherbiya	செர்பிய	செர்பியா
serbia	செர்பிய	செர்பியா
serbiya	செர்பிய	செர்பியா
chelavita	செலவிட	செலவிட
selavida	செலவிட	செலவிட
selavita	செலவிட	செலவிட
chelavitapadum	செலவிடப்படும்	செலவிடப்படும்
chelavitappadum	செலவிடப்படும்	செலைவிப்படும்
selavidappadum	செலவிடப்படும்	செலவிப்படும்
selavitappatum	செலவிடப்படும்	செலைப்படுகிம்
cheluthi	செலுத்தி	செலுத்தி
chelutthi	செலுத்தி	செலுத்தி
seluthi	செலுத்தி	செலுத்தி
seluththi	செலுத்தி	செலுத்தி
selutthi	செலுத்தி	செலுத்தி
cheluthik	செலுத்திக்	செலுத்திக்
chelutthik	செலுத்திக்	செலுத்திக்
seluthik	செலுத்திக்	செலுத்திக்
seluththik	செலுத்திக்	செலுத்திக்
selutthik	செலுத்திக்	செலுத்திக்
cheluthina	செலுத்தின	செலுத்தின
chelutthina	செலுத்தின	செலுத்தின
seluthina	செலுத்தின	செலுத்தி
seluththina	செலுத்தின	செலுத்தின
selutthina	செலுத்தின	செலுத்தின
cheluthinar	செலுத்தினார்	செலுத்திர
chelutthinaar	செலுத்தினார்	செலுத்தினார்
seluthinaar	செலுத்தினார்	செலுத்திரா
seluththinaar	செலுத்தினார்	செலுத்திரான்
selutthinaar	செலுத்தினார்	செலுத்தினார்
segarippil	சேகரிப்பில்	சேரிப்பில்
sekarippil	சேகரிப்பில்	சேரிப்பில்
chaethamadainththu	சேதமடைந்து	சேதமையத்து
saethamadainththu	சேதமடைந்து	சேதமையத்து
sedhamadaindhu	சேதமடைந்து	சேமதியதுு
sethamadaindhu	சேதமடைந்து	சேதமத்துு
saeiyon	சேயோன்	செய்யோன்
saeyaon	சேயோன்	சேயான்
saeyon	சேயோன்	சேயன்
seiyon	சேயோன்	செய்யோ
seyon	சேயோன்	செய்
cheri	சேரி	செரி
saeri	சேரி	சேரி
saerkkaikkaana	சேர்க்கைக்கான	சேர்க்கைக்கான
serkkaikkaana	சேர்க்கைக்கான	செர்க்கைக்கான
saerkkaikku	சேர்க்கைக்கு	சேர்க்கைக்கு
serkkaikku	சேர்க்கைக்கு	சேர்க்கைக்கு
saerkkaiyil	சேர்க்கையில்	சேர்க்கையில்
serkkaiil	சேர்க்கையில்	சேர்க்கையில்
serkkaiyil	சேர்க்கையில்	சேர்க்கையில்
saerkkaiyum	சேர்க்கையும்	சேர்க்கையும்
serkkaium	சேர்க்கையும்	செர்க்கையும்
serkkaiyum	சேர்க்கையும்	செர்க்கையும்
saerththu	சேர்த்து	சேர்த்து
serththu	சேர்த்து	செர்த்து
saerththuk	சேர்த்துக்	சேர்த்துக்
serththuk	சேர்த்துக்	செர்த்துக்
saerththukkondaar	சேர்த்துக்கொண்டார்	சேர்த்துக்கொண்டார்
serththukkondaar	சேர்த்துக்கொண்டார்	செற்த்துக்கொண்டார்
saerththukkolvathan	சேர்த்துக்கொள்வதன்	சேற்த்துக்கொவ்தல்
serththukkolvathan	சேர்த்துக்கொள்வதன்	செற்த்துக்குவத்்
saerththuth	சேர்த்துத்	சேர்த்து
serththuth	சேர்த்துத்	செர்த்து
saerththup	சேர்த்துப்	சேர்த்துப்
serththup	சேர்த்துப்	செர்த்துப்
chervai	சேர்வை	செர்வை
saervai	சேர்வை	சேர்வை
servai	சேர்வை	செர்வை
saigaigalai	சைகைகளை	சைகைகளை
saigaikalai	சைகைகளை	சைகைகளை
saikaigalai	சைகைகளை	சைக்கையல்
saikaikalai	சைகைகளை	சைக்கையல்
cibar	சைபர்	சிபர்
cibarr	சைபர்	சிபர்
ciber	சைபர்	கிபர்
ciberr	சைபர்	சிபர்ர்
cipher	சைபர்	சிபர்
cybar	சைபர்	சிபர்
cyber	சைபர்	கிபர்
cyfer	சைபர்	கிபார்
cyphar	சைபர்	சிபர்
cypher	சைபர்	சிப்பர்
saibar	சைபர்	சப்பர்
sibar	சைபர்	சிபர்
siber	சைபர்	சிபர்
syber	சைபர்	சிப்
saivaththin	சைவத்தின்	சைவத்தின்
saivar	சைவர்	சைவர்
sombu	சொம்பு	சோம்பு
sompu	சொம்பு	சோம்பு
chori	சொறி	சோரி
sori	சொறி	சோரி
chorpolivu	சொற்பொழிவு	சொற்போளிவு
sorpolivu	சொற்பொழிவு	சொற்போளிவு
sorpozhivu	சொற்பொழிவு	சொற்போலியு
chorpolivukalai	சொற்பொழிவுகளை	சொற்போளிவைகளை
sorpolivugalai	சொற்பொழிவுகளை	சொற்போளிவைகளை
sorpolivukalai	சொற்பொழிவுகளை	சொற்போளிவைகளை
sorpolzhivugalai	சொற்பொழிவுகளை	சொற்பொள்ளைகளை
chorpolivukal	சொற்பொழிவுகள்	சொற்போளிவுகள்
sorpolivugal	சொற்பொழிவுகள்	சொற்போலியுகள்
sorpolivukal	சொற்பொழிவுகள்	சொற்போளிவுகள்
sorpozhivugal	சொற்பொழிவுகள்	சொற்போலிகளு
cholana	சொல்லான	சொலனா
chollaana	சொல்லான	சொல்லான
sollaana	சொல்லான	சொல்லான
chollu	சொல்லு	சொல்லு
sollu	சொல்லு	சொல்லு
chollukkup	சொல்லுக்குப்	சொல்லுக்குப்
cholukup	சொல்லுக்குப்	சொழுக்கு
sollukkup	சொல்லுக்குப்	சொல்லுக்குப்
solluvar	சொல்லுவர்	சொல்லவர்
cholvar	சொல்வர்	சொல்வர்
solvar	சொல்வர்	சொல்வர்
cholvaar	சொல்வார்	சொல்வார்
cholvar	சொல்வார்	சொல்வர்
solvaar	சொல்வார்	சொல்வார்
solvar	சொல்வார்	சொல்வர்
soasalisap	சோசலிசப்	சோசசிலா
socialisap	சோசலிசப்	சோசியாளி
sosalisap	சோசலிசப்	சோசிலாப்
shocialishm	சோசலிசம்	சோசிலியம்
soasalisam	சோசலிசம்	சோசாலியம்
socialeesm	சோசலிசம்	சோசிலியம்
socialiism	சோசலிசம்	சோசியாலிம்
socialism	சோசலிசம்	சோசியாலிம்
soocialeesm	சோசலிசம்	சூசாயிலம்
soocialism	சோசலிசம்	சூசாயிலிம்
sosalisam	சோசலிசம்	சோசலியம்
soadi	சோடி	சோடி
sodi	சோடி	சோடி
choathikka	சோதிக்க	சோதிக்க
soathikka	சோதிக்க	சோதிக்க
sothikka	சோதிக்க	சோதிக்க
chooppup	சோப்புப்	சோப்புப்
soappup	சோப்புப்	சோப்புப்
sooppup	சோப்புப்	சூப்புப்
soppup	சோப்புப்	சோப்புப்
sopup	சோப்புப்	சோப்பு
choayaa	சோயா	சோயா
soayaa	சோயா	சோயா
soi	சோயா	சோ
soia	சோயா	சோயா
sooy	சோயா	சோய்
sooya	சோயா	சோயா
soy	சோயா	சோ
soya	சோயா	சோயா
soyaa	சோயா	சோயா
choazharkalaal	சோழர்களால்	சோழர்களால்
cholargalal	சோழர்களால்	சொல்களைகள்
chozharkalaal	சோழர்களால்	சொழர்களால்
soazhargalaal	சோழர்களால்	சோழர்களால்
soazharkalaal	சோழர்களால்	சோழர்களால்
solargalal	சோழர்களால்	சொல்களைகள்
sozharkalaal	சோழர்களால்	சொழர்களால்
choazharkalai	சோழர்களை	சோழர்களை
cholargalai	சோழர்களை	சொல்றைகளை
chozhargalai	சோழர்களை	சொழர்களை
soazhargalai	சோழர்களை	சோழர்களை
soazharkalai	சோழர்களை	சோழர்களை
sozharkalai	சோழர்களை	சொழர்களை
jajeera	ஜசீரா	ஜேஜரி
jazeara	ஜசீரா	ஜெரா
jazeera	ஜசீரா	ஜேரரி
jaziira	ஜசீரா	ஜெரியா
zazeera	ஜசீரா	ஜேரா
janadha	ஜனதா	ஜனதா
janadhaa	ஜனதா	ஜனாத
janata	ஜனதா	ஜனாட
janataa	ஜனதா	ஜனாட
janatha	ஜனதா	ஜனதா
janeta	ஜனதா	ஜெனாட்
janetaa	ஜனதா	ஜெனாட
janta	ஜனதா	ஜா்ட
zanata	ஜனதா	ஜானத
zanataa	ஜனதா	ஜானாட
japaniya	ஜப்பானிய	ஜானபிய
jappaaniya	ஜப்பானிய	ஜாப்பானியா
japaniyak	ஜப்பானியக்	ஜாபனியக்
jappaaniyak	ஜப்பானியக்	ஜாப்பாணியக்
japaniyarkal	ஜப்பானியர்கள்	ஜானபியர்கள்
jappaaniyargal	ஜப்பானியர்கள்	ஜாப்பாயர்களிக்
jappaaniyarkal	ஜப்பானியர்கள்	ஜாப்பாயர்களிக்
japanukku	ஜப்பானுக்கு	ஜானபுக்கு
jappaanukku	ஜப்பானுக்கு	பாப்பானுக்கு
jameen	ஜமீன்	ஜேமன்
jamuna	ஜமுனா	ஜமுன
jamunaa	ஜமுனா	ஜமுனா
jamp	ஜம்ப்	ஜாம்ப்
jump	ஜம்ப்	ஜூ்ப்
juump	ஜம்ப்	ஜூம்ப்
zump	ஜம்ப்	ஜூ்ப்
jaansan	ஜான்சன்	ஜான்சன்
jaanson	ஜான்சன்	ஜான்சன்
jhonsan	ஜான்சன்	ஜோனன்
jhonson	ஜான்சன்	ஜோனன்
johnson	ஜான்சன்	ஜோன்சன்
jecas	ஜீசஸ்	ஜேகாச்
jesus	ஜீசஸ்	ஜெஸ்
jesuus	ஜீசஸ்	ஜெஸ்
jiicas	ஜீசஸ்	ஜிசா்
zesus	ஜீசஸ்	ஜெஸ்
jeeroa	ஜீரோ	ஜோரா
zeero	ஜீரோ	ஜெரோ
zero	ஜீரோ	ஜோர்
jeevan	ஜீவன்	ஜேவன்
joori	ஜூரி	ஜூரி
joory	ஜூரி	ஜூரி
juri	ஜூரி	ஜூரி
jurii	ஜூரி	ஜூரி
jury	ஜூரி	ஜூரி
juuri	ஜூரி	ஜூரி
juury	ஜூரி	ஜூரி
zoory	ஜூரி	ஜூரி
zuri	ஜூரி	ஜூரி
zury	ஜூரி	ஜூரி
jaenna	ஜென்னா	ஜென்
jeina	ஜென்னா	ஜெனா
jena	ஜென்னா	ஜெனா
jenaa	ஜென்னா	ஜெனா
jenna	ஜென்னா	ஜென்
jennaa	ஜென்னா	ஜென்னா
jeyna	ஜென்னா	ஜென்
zena	ஜென்னா	ஜெனா
zenna	ஜென்னா	ஜென்
zennaa	ஜென்னா	ஜென்னா
zeyna	ஜென்னா	ஜெய்
jaenni	ஜென்னி	ஜென்
jannine	ஜென்னி	ஜென்னி
jeanie	ஜென்னி	ஜெனி
jeannie	ஜென்னி	ஜென்யி
jenni	ஜென்னி	ஜென்
jennie	ஜென்னி	ஜென்
jennii	ஜென்னி	ஜென்னி
jenny	ஜென்னி	ஜென்
jianine	ஜென்னி	ஜினினே
jiannine	ஜென்னி	ஜெனினின்
jyanine	ஜென்னி	ஜெயனி
jyannine	ஜென்னி	ஜெயனின்
zeannie	ஜென்னி	ஜென்யி
zenni	ஜென்னி	ஜென்
zenny	ஜென்னி	ஜென்
ziannine	ஜென்னி	ஜெனினி
zyannine	ஜென்னி	ஜெயனின்
jaens	ஜென்ஸ்	ஜென்ஸ்
jains	ஜென்ஸ்	ஜென்ஸ்
jens	ஜென்ஸ்	ஜென்ஸ்
zains	ஜென்ஸ்	ஜென்ஸ்
zens	ஜென்ஸ்	ஜென்ஸ்
jebam	ஜெபம்	ஜேபம்
jepam	ஜெபம்	ஜேபம்
jefersaun	ஜெபர்சன்	ஜெப்ரான்
jeferson	ஜெபர்சன்	ஜெபர்ஸ்
jeffarsaun	ஜெபர்சன்	ஜெப்பார்சன்
jeffarson	ஜெபர்சன்	ஜெப்பர்ஸ்
jeffersaun	ஜெபர்சன்	ஜெப்பர்சன்
jeffersauun	ஜெபர்சன்	ஜெப்பார்சன்
jefferson	ஜெபர்சன்	ஜெப்பென்ஸ்
jefpharson	ஜெபர்சன்	ஜெப்பர்ஷ்
jefpherson	ஜெபர்சன்	ஜெப்பர்ஸ்
jephpharson	ஜெபர்சன்	ஜெப்பர்சன்
jephphersaun	ஜெபர்சன்	ஜெப்பர்சன்
jephpherson	ஜெபர்சன்	ஜெப்பர்ஷ்
zeffersaun	ஜெபர்சன்	ஜெப்பர்சன்
zefferson	ஜெபர்சன்	ஜெப்பென்ஸ்
zefpherson	ஜெபர்சன்	ஜெப்பிர்ஸ்
zephpharson	ஜெபர்சன்	ஜெப்பர்சன்
germaaniya	ஜெர்மானிய	கேர்மாயியா
germania	ஜெர்மானிய	கேர்மானி
germaaniyap	ஜெர்மானியப்	கெர்மாயியா்
germaniyap	ஜெர்மானியப்	கேர்மியான்
germaaniyarkal	ஜெர்மானியர்கள்	கேர்மாயியர்கள்
germaniyargal	ஜெர்மானியர்கள்	கேர்மியாகள்க்
jami	ஜேமி	ஜாமி
jamie	ஜேமி	ஜேமி
jamiee	ஜேமி	ஜேமி
jamii	ஜேமி	ஜாமி
jamiie	ஜேமி	ஜமீமி
jamy	ஜேமி	ஜாம்
jeemi	ஜேமி	ஜீமி
jeemiee	ஜேமி	ஜீமி
jemie	ஜேமி	ஜீமி
jemiie	ஜேமி	ஜீமி
zami	ஜேமி	ஜாமி
zamie	ஜேமி	ஜாமி
zamii	ஜேமி	ஜாமி
zamy	ஜேமி	ஜாம்
zemie	ஜேமி	ஜெமி
jioti	ஜோதி	ஜோடி
jooti	ஜோதி	ஜோடி
jothi	ஜோதி	ஜோதி
jyooti	ஜோதி	ஜூயோடி
jyoti	ஜோதி	ஜெய்டி
jyotii	ஜோதி	ஜூய்டி
zyoti	ஜோதி	ஜெய்டி
gnanashnaanam	ஞானஸ்நானம்	காணசனாமன்
gnanasnaanam	ஞானஸ்நானம்	காண்ணாாமண்
gnanasnanam	ஞானஸ்நானம்	கணண்ணாமண்
taakshi	டாக்ஸி	தாக்சி
taxi	டாக்ஸி	டாகி
daan	டான்	டான்
dain	டான்	டென்
dan	டான்	டான்
dann	டான்	டன்
dayn	டான்	டென்
den	டான்	டென்
don	டான்	டோன்
donn	டான்	டோன்
taan	டான்	டான்
design	டிசைன்	டீசி்
disain	டிசைன்	டிசன்
dear	டியர்	டேர்
der	டியர்	டேர்
diyar	டியர்	டியர்
diram	டிராம்	திரம்
tiraam	டிராம்	திராம்
tirom	டிராம்	திரோம்
traam	டிராம்	திராம்
tram	டிராம்	திராம்
trama	டிராம்	திராம
tirailar	டிரெய்லர்	திரையர்
trailer	டிரெய்லர்	திராலிர்
daepiyan	டெபியன்	தேபியன்
deban	டெபியன்	டீபன்
debann	டெபியன்	பீடன்
debeean	டெபியன்	டீபான்
debeen	டெபியன்	டீபன்
debian	டெபியன்	டீபான்
debiann	டெபியன்	டீபானின்
debiian	டெபியன்	டீபியன்
debiyan	டெபியன்	டீபியன்
delivery	டெலிவரி	தெலிவிரி
telivari	டெலிவரி	தெலிவரி
devil	டெவில்	டெவில்
daeni	டேனி	டெனி
danni	டேனி	டன்னி
danny	டேனி	டன்னி
dany	டேனி	டனி
deeni	டேனி	டெனி
dison	டைசன்	டிஸ்
tisan	டைசன்	டிசன்
tison	டைசன்	டிஸ்
tyson	டைசன்	டிஸ்
daiveng	டைவிங்	டெவ்க்
daivengg	டைவிங்	டெவ்க்க்
daiving	டைவிங்	டெவிக்
daiwengg	டைவிங்	டெவ்க்க்
daiwing	டைவிங்	டெவிக்
devengg	டைவிங்	டெவங்க்
deving	டைவிங்	டெவிங்
diving	டைவிங்	டிவிங்
divingg	டைவிங்	டிவிங்க்
diwing	டைவிங்	டிவிங்
diwingg	டைவிங்	டிவிங்க்
druuman	ட்ரூமன்	திருமான்
trooman	ட்ரூமன்	திரோமன்
trueman	ட்ரூமன்	திருமான்
truman	ட்ரூமன்	திருமன்
trumann	ட்ரூமன்	திருமனன்
truueman	ட்ரூமன்	துருமான்
truuman	ட்ரூமன்	துருமன்
truumann	ட்ரூமன்	துருமனன்
driver	ட்ரைவர்	டிரிவர்
tarran	த	தரர்ன்
teran	த	தேரன்
terran	த	தேர்ரன்
thagadugal	தகடுகள்	தககுகள்
thagadukal	தகடுகள்	தககுகள்
thakadukal	தகடுகள்	தககுகள்
thakatukal	தகடுகள்	தகக்குள்
thanggi	தங்கி	தங்கி
thangi	தங்கி	தங்கி
thangki	தங்கி	தங்கி
thanki	தங்கி	தங்கி
thanginar	தங்கினர்	தங்கினர்
thangkinar	தங்கினர்	தங்கின்ற
thankinar	தங்கினர்	தங்கின்ற
thanginaar	தங்கினார்	தங்கினார்
thangkinaar	தங்கினார்	தங்கினார்
thankinaar	தங்கினார்	தங்கினார்
thangirukka	தங்கியிருக்க	தங்கிறுக்க
thangiyirukka	தங்கியிருக்க	தங்கியிருக்க
thangkiirukka	தங்கியிருக்க	தங்கிற்க்கு
thangkiyirrukka	தங்கியிருக்க	தங்கிறிக்கிறா
thankiyirkka	தங்கியிருக்க	தங்கியிர்க்க
thangiirukkum	தங்கியிருக்கும்	தங்கிறிகுக்கும்
thangiyirukkum	தங்கியிருக்கும்	தங்கியிருக்கும்
thankiyirukkum	தங்கியிருக்கும்	தங்கியிருக்கும்
thangiulla	தங்கியுள்ள	தங்கிலுள்
thangiyulla	தங்கியுள்ள	தங்கியுள்ள
thankiyulla	தங்கியுள்ள	தங்கியுள்ள
dasaapdhangalaaga	தசாப்தங்களாக	தாசப்பாங்களா
dasaapthangalaaga	தசாப்தங்களாக	தாசப்்காாக
dasapthanggalaahga	தசாப்தங்களாக	தசப்்களங்கா
thasaapthangalaaga	தசாப்தங்களாக	தாசப்பாங்களா
dasaapdhangalil	தசாப்தங்களில்	தாசப்பாங்களில்
dasaapthangalil	தசாப்தங்களில்	தாசப்பாங்களில்
dasapthanggalil	தசாப்தங்களில்	தடச்சங்களில்
thasaapdhangalil	தசாப்தங்களில்	தாசப்பாங்களில்
dasapthanggalukku	தசாப்தங்களுக்கு	தடச்சங்களுக்கு
thasaapdhangalukku	தசாப்தங்களுக்கு	தாசப்பாங்களுக்
thasaapthankkalukku	தசாப்தங்களுக்கு	தாசப்்களுக்கு
thadangalai	தடங்களை	தடங்களை
thadanggalai	தடங்களை	தடங்களை
thadangkalai	தடங்களை	தடங்களை
thadangal	தடங்கள்	தடங்கள்
thadanggal	தடங்கள்	தடங்கள்
thadangkal	தடங்கள்	தடங்கள்
thaduththadhu	தடுத்தது	தடுத்தது
thaduththathu	தடுத்தது	தடுத்தது
thaduththanar	தடுத்தனர்	தடுத்தனர்
thaduththal	தடுத்தல்	தடுத்தல்
thadaigalaiyum	தடைகளையும்	தடைகளையும்
thadaikalaiyum	தடைகளையும்	தடைகளையும்
thadaikkalaiyum	தடைகளையும்	தடைக்களையும்
thadaykalayyum	தடைகளையும்	தடைகளுயும்
thadaigal	தடைகள்	தடைகள்
thadaikal	தடைகள்	தடைகள்
thadaikkal	தடைகள்	தடைக்கள்
thadaygal	தடைகள்	தடைகள்
thadaykal	தடைகள்	தடைகள்
thadaich	தடைச்	தடைச்
thadaippattu	தடைப்பட்டு	தடைப்பட்டு
thadaiyatrtra	தடையற்ற	தடையற்ற
thadaiyattra	தடையற்ற	தடையற்ற
thadaiyaaga	தடையாக	தடையாக
thadaiyaaka	தடையாக	தடையாக
thadaiyaanadhu	தடையானது	தடையானது
thadaiyaanathu	தடையானது	தடையானது
thadaiyin	தடையின்	தடையின்
thadaiyaiyum	தடையையும்	தடையையும்
dhandanaigalaiyum	தண்டனைகளையும்	தன்டணையகளும்
thandanaigalaium	தண்டனைகளையும்	தன்டணைகளும்
thandanaigalaiyum	தண்டனைகளையும்	தன்டணையகளும்
thandanaikalaiyum	தண்டனைகளையும்	தன்டணையகளும்
thandanaik	தண்டனைக்	தன்டணைக்
dhandanaikku	தண்டனைக்கு	தன்டைக்கு
thandanaikku	தண்டனைக்கு	தன்டைக்கு
dhandanaich	தண்டனைச்	தன்டாசைச்
thandanaich	தண்டனைச்	தன்டாசைச்
dhandanaiyaaga	தண்டனையாக	தன்டனையாக
thandanaiyaaga	தண்டனையாக	தன்டையாக
thandanaiyaaka	தண்டனையாக	தன்டையாக
dhandanaiyum	தண்டனையும்	தன்னையும்
thandanaiyum	தண்டனையும்	தன்னையும்
dhandanaiyai	தண்டனையை	தன்டனையை
thandanaiyai	தண்டனையை	தன்டணையை
dhandi	தண்டி	தாண்டி
thandi	தண்டி	தன்டி
thandil	தண்டில்	தன்டில்
thandhiramaaga	தந்திரமாக	தந்திரமாக
thanthiramaaga	தந்திரமாக	தந்திரமாக
thanthiramaaka	தந்திரமாக	தந்திரமாக
thandhiram	தந்திரம்	தந்திரம்
thanthiram	தந்திரம்	தந்திரம்
thanakkulla	தனக்குள்ள	தஙக்குள்ள
thanakkae	தனக்கே	தனக்கே
thankkae	தனக்கே	தங்கேக
thanithanip	தனித்தனிப்	தனிதானிப்
thaniththani	தனித்தனிப்	தனித்தின்
thaniththanip	தனித்தனிப்	தனித்திப்ப்
thanithaniye	தனித்தனியே	தனிநாதியே
thaniththaniyae	தனித்தனியே	தனிந்தியே
thaniththaniye	தனித்தனியே	தனிந்ததியே
thanithanmai	தனித்தன்மை	தனிந்தமை
thaniththanmai	தனித்தன்மை	தனிந்தமை
thanithanmaiyai	தனித்தன்மையை	தனிந்தமையை
thaniththanmaiyai	தனித்தன்மையை	தனிந்ததமையை
thanima	தனிம	தனிமா
thanimangal	தனிமங்கள்	தனிமங்கள்
thanimankal	தனிமங்கள்	தனினம்கள்
thanimam	தனிமம்	தனிமம்
thanatchi	தன்னாட்சி	தான்சி
thannaatchi	தன்னாட்சி	தன்னாச்சி
thanmaana	தன்மான	தன்மான
tamilaga	தமிழக	தமிழாக
thamilaga	தமிழக	தமிழாக
thamilaka	தமிழக	தமிழாக
thamizhaka	தமிழக	தமிழாக
tamilagach	தமிழகச்	தமிழாகச்
thamizhakach	தமிழகச்	தமிழக்ச்
tamilagath	தமிழகத்	தமிழாகத்
thamizhakath	தமிழகத்	தமிழக்த்
tamilagaththin	தமிழகத்தின்	தமிழகத்தின்
thamizhakaththin	தமிழகத்தின்	தமிழகத்தின்
tamilagaththirku	தமிழகத்திற்கு	தமிழக்கத்திற்
thamizhakaththirkku	தமிழகத்திற்கு	தமிழக்கத்திற்க
thamizhakaththirku	தமிழகத்திற்கு	தமிழக்கத்திற்
tamilagaththil	தமிழகத்தில்	தமிழகத்தில்
tamilagatthil	தமிழகத்தில்	தமிழக்கதில்
tamilakatthil	தமிழகத்தில்	தமிழக்கத்தில்
tamizhagatthil	தமிழகத்தில்	தமிழக்த்தில்
tamizhakatthil	தமிழகத்தில்	தமிழக்த்தில்
thamilagatthil	தமிழகத்தில்	தமிழக்கத்தில்
thamilakatthil	தமிழகத்தில்	தமிழக்கத்தில்
thamizhagatthil	தமிழகத்தில்	தமிழக்த்தில்
thamizhakaththil	தமிழகத்தில்	தமிழகத்தில்
thamizhakatthil	தமிழகத்தில்	தமிழக்த்தில்
tamilagaththudan	தமிழகத்துடன்	தமிழக்கத்தது
tamilagatthudan	தமிழகத்துடன்	தமிழக்கட்டது
tamilakatthudan	தமிழகத்துடன்	தமிழக்கட்டது
tamizhagatthudan	தமிழகத்துடன்	தமிழக்த்தடுடு
tamizhakatthudan	தமிழகத்துடன்	தமிழக்கட்டது
thamilagatthudan	தமிழகத்துடன்	தமிழக்கட்டது
thamilakatthudan	தமிழகத்துடன்	தமிழக்கட்டது
thamizhagatthudan	தமிழகத்துடன்	தமிழக்த்தடுடு
thamizhakaththudan	தமிழகத்துடன்	தமிழக்தத்துடன்
thamizhakaththutan	தமிழகத்துடன்	தமிழக்த்தத்து
thamizhakatthudan	தமிழகத்துடன்	தமிழக்த்தடுடன்
tamilarinargal	தமிழறிஞர்கள்	தமிரிலாரர்கள்
tamilaringargal	தமிழறிஞர்கள்	தமிழர்கிகளர்கள
thamizharingargal	தமிழறிஞர்கள்	தமிழர்கிர்கள்
thamizharingyargal	தமிழறிஞர்கள்	தமிழர்கிரர்கள்
thamizharingyarkal	தமிழறிஞர்கள்	தமிழர்கிரர்கள்
tamilai	தமிழை	தமிழை
tamizhai	தமிழை	தமிழ்
thamilai	தமிழை	தமிழை
thamizhai	தமிழை	தமிழை
tamilaip	தமிழைப்	தமிழைப்
tamizhaip	தமிழைப்	தமிழைப்
thamilaip	தமிழைப்	தமிழைப்
thamizhaip	தமிழைப்	தமிழைப்
tamilnadu	தமிழ்நாடு	தமிழ்நாட்டு
tamilnatu	தமிழ்நாடு	தமிழ்நாட்டு
thamilnaatu	தமிழ்நாடு	தமிழ்நாட்டு
thamilnatu	தமிழ்நாடு	தமிழ்நாட்டு
thamizhnaadu	தமிழ்நாடு	தமிழாந்து
tamilnadum	தமிழ்நாடும்	தமிழ்நாடும்
thamilnaadum	தமிழ்நாடும்	தமிழ்நாட்டும்
thamilnadum	தமிழ்நாடும்	தமிழ்நாடும்
thamizhnaadum	தமிழ்நாடும்	தமிழ்நாடும்
thambadhigalin	தம்பதிகளின்	தம்பதிகளின்
thambathigalin	தம்பதிகளின்	தம்பதிகளின்
thambathikalin	தம்பதிகளின்	தம்பதிகளின்
thampathikalin	தம்பதிகளின்	தம்பதிகளின்
thambadhiyinarin	தம்பதியினரின்	தம்பதியினரன்
thambathiyinarin	தம்பதியினரின்	தம்பதியினர்ன்
thambadhiyin	தம்பதியின்	தம்பதியின்
thambathiyin	தம்பதியின்	தம்பதியின்
tayaaraana	தயாரான	தயாரான
thayaaraana	தயாரான	தயாரான
thayarana	தயாரான	தயரான
thayaarippaana	தயாரிப்பான	தயாரிபாபான
thayaarippaalarum	தயாரிப்பாளரும்	தயாரிபாரும்ம்
thayaarippaazharum	தயாரிப்பாளரும்	தயாரிப்பாரும்
dhayaazh	தயாள்	தயாள்
thayaal	தயாள்	தயால்
thayal	தயாள்	தயல்
mudiyumaa	தர	முடியுமா
mutiyuma	தர	முடியும்
tarathai	தரத்தை	தரதை
tharathai	தரத்தை	தரதை
tharaththai	தரத்தை	தரத்தை
tharatthai	தரத்தை	தரத்தை
taratthaiyum	தரத்தையும்	தரத்தையும்
tharathaiyum	தரத்தையும்	தரதையும்
tharaththaiyum	தரத்தையும்	தரத்தையும்
tharatthaiyum	தரத்தையும்	தரத்தையும்
tarappil	தரப்பில்	தரப்பில்
tharapil	தரப்பில்	தரபில்
tharappil	தரப்பில்	தரப்பில்
tharavarisai	தரவரிசை	தரரைசி
tharavalladhu	தரவல்லது	தரளவளது
tharavallathu	தரவல்லது	தரளவள்ளது
tharavugalaich	தரவுகளைச்	தரவுகளைச்
tharavukalaich	தரவுகளைச்	தரவுகளைச்
tharavugalaip	தரவுகளைப்	தரவுகளைப்
tarunatthil	தருணத்தில்	தருநத்தில்
tharunathil	தருணத்தில்	தருநத்தில்
tharunaththil	தருணத்தில்	தருநத்தில்
tharunatthil	தருணத்தில்	தருநத்தில்
dharun	தருண்	தருன்
tarun	தருண்	டருன்
tharun	தருண்	தருன்
dharumi	தருமி	தருமி
tharumi	தருமி	தருமி
tharum	தரும்	தரும்
dharmapuriyil	தர்மபுரியில்	தர்முரப்பிலில்
thalaimaiyaetru	தலைமையேற்று	தலையமறையு
thalaimaiyetru	தலைமையேற்று	தலைமையறறு
thalaimaiyettru	தலைமையேற்று	தலைமையற்று
talaivanin	தலைவனின்	தலைவனின்
thalaivanin	தலைவனின்	தலைவனின்
talaivaraavaar	தலைவராவார்	தலைவாராவர்
thalaivaraavaar	தலைவராவார்	தலைவராார்
thalaivaravaar	தலைவராவார்	தலைவராவர்
talaivarukku	தலைவருக்கு	தலைவருக்கு
thalaivarukku	தலைவருக்கு	தலைவருக்கு
thalaivali	தலைவலி	தலைவளி
thalaththirku	தளத்திற்கு	தலத்திர்க்
thalatthirku	தளத்திற்கு	தலத்திர்க்
thalaththilirunthu	தளத்திலிருந்து	தலத்திலிருந்து
thalatthilirunthu	தளத்திலிருந்து	தலத்திலிருந்து
thalaththilum	தளத்திலும்	தலத்திலும்
thalatthilum	தளத்திலும்	தலத்திலும்
thalap	தளப்	தலப்
thalamaana	தளமான	தலமான
thalavaadangalai	தளவாடங்களை	தாலவடங்களை
thalavaadangalay	தளவாடங்களை	தாலவாக்களை
thalavaadangkalai	தளவாடங்களை	தாலவங்களை
thalavaadankalai	தளவாடங்களை	தாலவடங்களை
thalavaatankalay	தளவாடங்களை	தலாவடங்களை
thaviththa	தவித்த	தவித்த
thavittha	தவித்த	தவித்த
thaakku	தாக்கு	தாக்கு
thaadhukkal	தாதுக்கள்	தாதுக்கள்
thaathukkal	தாதுக்கள்	தாதுக்கள்
thaadhuvai	தாதுவை	தாதுவை
thaathuvai	தாதுவை	தாதுவை
thaano	தானோ	தானோ
thaamira	தாமிர	தாமிரா
thamira	தாமிர	தமிரா
thaamae	தாமே	தாமே
thaame	தாமே	தாம்
thaamey	தாமே	தாம்
dam	தாம்	டாம்
dhaam	தாம்	தாம்
thaam	தாம்	தாம்
tambaram	தாம்பரம்	தம்பரம்
thaambaram	தாம்பரம்	தாம்பரம்
thaayaga	தாயக	தயாக
thayaga	தாயக	தயகக
thaayagathil	தாயகத்தில்	தாயகதில்
thaayagaththil	தாயகத்தில்	தாயகத்தில்
thaayagap	தாயகப்	தயகக்ப
thaayagam	தாயகம்	தாயகம்
thaayumaanavar	தாயுமானவர்	தாயுமானர்
thayumanavar	தாயுமானவர்	தயுமானர்
taali	தாலி	தாலி
taalii	தாலி	தாலி
tali	தாலி	டாலி
talii	தாலி	தலி
thaali	தாலி	தாலி
thaaliyai	தாலியை	தாளியை
thaal	தாழ்	தால்
thaazh	தாழ்	தாழ்
thikaar	திகார்	திகார்
tihar	திகார்	திரா்
thittamidaludan	திட்டமிடலுடன்	திட்டம்பட்டின்
thittamiduthal	திட்டமிடுதல்	திட்டமிட்டல்
thinnanaar	திண்ணனார்	தின்னான்
deen	தின்	டீன்
dhin	தின்	தின்
diin	தின்	டின்
din	தின்	டின்
dyn	தின்	டின்
thin	தின்	தின்
tin	தின்	டின்
thinnum	தின்னும்	தின்மும்
dmkvil	திமுகவில்	டிம்க்ல்
thimukavil	திமுகவில்	திமுக்கவில்
temoorr	திமோர்	தோமர்ர்
temor	திமோர்	தேம்ர்
temorr	திமோர்	தேமர்ர்
timoor	திமோர்	திமோர்
timoorr	திமோர்	திமூர்
timor	திமோர்	திம்்
timorr	திமோர்	திம்ர்ர்
tymoor	திமோர்	திமோர்
tymor	திமோர்	திம்்
thiyaagaraajarin	தியாகராஜரின்	தியாரரரிசின்
thiyaakaraajarin	தியாகராஜரின்	தியாரரரிகின்
thiyagarajarin	தியாகராஜரின்	தியாரரரின்
thyaagarajarin	தியாகராஜரின்	தாயரர்கின்
thiyaagaraajaa	தியாகராஜா	தியாராாா
thiyaakaraaja	தியாகராஜா	தியாராா
thiyaakaraajaa	தியாகராஜா	தியாராாா
thiyakaraja	தியாகராஜா	தியகரா
tiyaakaraaja	தியாகராஜா	தியாராா
thirumulukkup	திருமுழுக்குப்	திருமுழுக்குப்
thirumulukup	திருமுழுக்குப்	திருமுழுப்பு
tirumulukkup	திருமுழுக்குப்	திருமுழுக்குப்
thirumoorthi	திருமூர்த்தி	திருமூரித்
thirumoorththi	திருமூர்த்தி	திருமர்த்தி
thirumuurtthi	திருமூர்த்தி	திருமுர்த்தி
tiruumrthi	திருமூர்த்தி	திருமர்த்
thiruvadi	திருவடி	திருவாடி
thiruvati	திருவடி	திருவாடி
thiruvadikalai	திருவடிகளை	திருவைகளை
thiruvatikalai	திருவடிகளை	திருவைகளை
tiruvatikalai	திருவடிகளை	திருவைகளை
thiruvarangkaththil	திருவரங்கத்தில்	திருவர்க்கத்தில்
thiruvarankkaththil	திருவரங்கத்தில்	திருவருக்கத்தில்
thiruvarangan	திருவரங்கன்	திருவரங்கன்
thiruvarangkan	திருவரங்கன்	திருவரங்கன்
thiruvarankan	திருவரங்கன்	திருவரங்கன்
tiruvarankan	திருவரங்கன்	திருவரங்கன்
maraivil	திரை	மரைவில்
thiraikalil	திரைகளில்	திரைகளில்
tiraikalil	திரைகளில்	திரைகளில்
thiraikal	திரைகள்	திரைகள்
tiraikal	திரைகள்	திரைகள்
thiraiyil	திரையில்	திரையில்
tiraiyil	திரையில்	திரையில்
thiraiyum	திரையும்	திரையும்
tiraiyum	திரையும்	திரையும்
thiraiyai	திரையை	திரையை
tiraiyai	திரையை	திரையை
thiranaal	திறனால்	திராணல்
thiranukku	திறனுக்கு	திருணக்கு
thiranudan	திறனுடன்	திருணாடன்
thirangalai	திறன்களை	திரங்களை
thirankalai	திறன்களை	திரங்களை
divakar	திவாகர்	திவகர்
diwakar	திவாகர்	திவாகர்
thivaakar	திவாகர்	திவாகர்
deevan	திவான்	டேவன்
deewan	திவான்	டீவா்
diiwan	திவான்	டிவா்
divaan	திவான்	டிவான்
divan	திவான்	டிவான்
divann	திவான்	டிவான்
diwaan	திவான்	திவான்
diwan	திவான்	டிவா்
diwann	திவான்	டிவான்
thivaan	திவான்	திவான்
tivan	திவான்	டிவான்
theetchithar	தீட்சிதர்	தீட்சித்ர்
thidshithar	தீட்சிதர்	தித்திர்்
theendaamaikku	தீண்டாமைக்கு	தென்டமைக்கு
theeba	தீப	தீபா
theepa	தீப	தீபா
deepath	தீபத்	தேபத்
dheepath	தீபத்	தேபத்
theepath	தீபத்	தீபத்
deepa	தீபா	டீபா
deepaa	தீபா	தேபா
dheepa	தீபா	தீபா
dheepaa	தீபா	தீபா
diipa	தீபா	டிபா
diipaa	தீபா	திபா
dipa	தீபா	டிபா
dipaa	தீபா	திபா
theepaa	தீபா	தீபா
tiipa	தீபா	திபா
theepparri	தீப்பற்றி	தீப்பரரிர்
theeppatri	தீப்பற்றி	தெப்பரித்
theeppattri	தீப்பற்றி	தெப்பிர்ட்டி
theeparrik	தீப்பற்றிக்	தேரபரிக்க்
theepattrik	தீப்பற்றிக்	தெடரிப்தி
theeppatrik	தீப்பற்றிக்	தெப்பிர்ட்க்
dheergadarisigal	தீர்க்கதரிசிகள்	தீர்காடிகளில்
theerkkatharisikal	தீர்க்கதரிசிகள்	தெர்க்கத்திகளில்
theerppadhil	தீர்ப்பதில்	தெர்ப்பதில்
theerppathil	தீர்ப்பதில்	தெர்ப்பதில்
theerppadhu	தீர்ப்பது	தெர்ப்பது
theerppathu	தீர்ப்பது	தெர்ப்பது
theerppil	தீர்ப்பில்	தெர்பில்
theerppai	தீர்ப்பை	தெர்பிப்
theermaaniththadhu	தீர்மானித்தது	தெர்மாயந்தது
theermaaniththathu	தீர்மானித்தது	தெர்மாயந்த்து
theermaaniththaar	தீர்மானித்தார்	தெர்மாந்திரா்
theermaaniththu	தீர்மானித்து	தெர்மானித்து
theervaaga	தீர்வாக	தெர்வாக
theervaaka	தீர்வாக	தெர்வாக
theevana	தீவன	தேவான
theevanaththil	தீவனத்தில்	தேவநத்தில்
theevaththil	தீவனத்தில்	தேவத்தில்
theevanam	தீவனம்	தேவாமம்
theeviravaadhi	தீவிரவாதி	தீவரிவதி
theeviravaathi	தீவிரவாதி	தெவிராவிதி
theeviravaadhigalaal	தீவிரவாதிகளால்	தெவிரவிதாலால்
theeviravaathigalaal	தீவிரவாதிகளால்	தெவிரவிதாலால்
theeviravaathigazhaal	தீவிரவாதிகளால்	தெவிரவிதாாலகள்
theeviravaathikalaal	தீவிரவாதிகளால்	தெவிரவிதாலால்
theeviravaadhigalin	தீவிரவாதிகளின்	தீவிராவிிின்
theeviravaathigalin	தீவிரவாதிகளின்	தீவிராவிிில்
theeviravaathigazhin	தீவிரவாதிகளின்	தீவிராத்திிின்
theeviravaathikalin	தீவிரவாதிகளின்	தீவிராவிிில்
theeviravaathigalay	தீவிரவாதிகளை	தெவிரவியாால்
theeviravaathigazhai	தீவிரவாதிகளை	தெவிராவிதைகளை
theeviravaathikalai	தீவிரவாதிகளை	தெவிரவிதாளை
theeviravaathikalay	தீவிரவாதிகளை	தெவிரவியாதால்
theeviravaathigal	தீவிரவாதிகள்	தெவிரவிதாள்
theeviravaathikal	தீவிரவாதிகள்	தெவிரவிதாள்
theeviravaadhiyaaga	தீவிரவாதியாக	தெவிராயதாவாக
theeviravaathiyaaga	தீவிரவாதியாக	தெவிராயதாவாக
theeviravaathiyaaka	தீவிரவாதியாக	தெவிராயதாதாக
thundaaga	துண்டாக	துண்டாக
thundaaka	துண்டாக	துண்டாக
thundai	துண்டை	துண்டை
thunburuthalil	துன்புறுத்தலில்	துன்புருதிலல்
thunburuththalil	துன்புறுத்தலில்	துன்புரத்திலில்
thunpuruththalil	துன்புறுத்தலில்	துன்புரத்திலில்
thunburuththum	துன்புறுத்தும்	துன்புரத்தும்
thunburuthum	துன்புறுத்தும்	துன்புருத்தும்
thunpuruththum	துன்புறுத்தும்	துன்புருத்தும்
tumi	துமி	டுமி
tumii	துமி	துமி
tuumi	துமி	டுமி
thuruva	துருவ	துருவ
thuruvangalil	துருவங்களில்	துருவங்களில்
thuruvangal	துருவங்கள்	துருவங்கள்
thuruvaththil	துருவத்தில்	துருவத்தில்
thuruvap	துருவப்	துருவப்
dhroanarin	துரோணரின்	திரோனனின்
dronarin	துரோணரின்	டிரோனனின்
thuronarin	துரோணரின்	துரோனின்
thuravigalum	துறவிகளும்	துறவிகளும்
thuravikalum	துறவிகளும்	துறவிகளும்
thuravikku	துறவிக்கு	துறவிக்கு
thuraviyaaga	துறவியாக	துரவியாக
thuraviyaaka	துறவியாக	துரவியாக
thuraviyaana	துறவியான	துரவியான
thuraikku	துறைக்கு	துறைக்கு
thulaigalil	துளைகளில்	துளைகளில்
thulaikalil	துளைகளில்	துளைகளில்
thuvakka	துவக்க	துவக்க
thuvakkap	துவக்கப்	துவக்கப்
thuvakkappatta	துவக்கப்பட்ட	துவக்கப்பட்ட
thuvakkiya	துவக்கிய	துவக்கிய
thuvanga	துவங்க	துவங்க
thuvangga	துவங்க	துவங்க
thuvangka	துவங்க	துவங்க
thuvangapatu	துவங்கப்பட்டு	துவங்கப்பட்டு
thuvangappattu	துவங்கப்பட்டு	துவங்கப்பட்டு
thuvanggappattu	துவங்கப்பட்டு	துவங்கப்பட்டு
thuvangkappattu	துவங்கப்பட்டு	துவங்கப்பட்டு
thuvanggum	துவங்கும்	துவங்கும்
thuvangkum	துவங்கும்	துவங்கும்
thuvangum	துவங்கும்	துவங்கும்
thuvangguvatharku	துவங்குவதற்கு	துவங்கவுக்றது
thuvangkuvatharku	துவங்குவதற்கு	துவங்கவுக்கது
thuvanguvatharku	துவங்குவதற்கு	துவங்கவுக்றது
dvaitham	துவைதம்	திவத்தம்
thuvaitham	துவைதம்	துவதைத்
thwaytham	துவைதம்	துவதிம்
thoodhuvar	தூதுவர்	தொதுவர்
thoothuvar	தூதுவர்	தோதுவர்
thoothuvargal	தூதுவர்கள்	தோத்துவர்கள்
thoothuvarkal	தூதுவர்கள்	தோதுவர்கள்
thoorvaari	தூர்வாரி	தூர்வாரி
thenasia	தென்னாசிய	தெனாசியா
thennaasiya	தென்னாசிய	தென்னாயாசி
therkil	தெற்கில்	தெர்கில்
therkkil	தெற்கில்	தெர்க்கில்
therkae	தெற்கே	தேர்க்க
therke	தெற்கே	தெர்கி
therkke	தெற்கே	தெர்க்கி
thelivatra	தெளிவற்ற	தெளிவர்ற
dhegathil	தேகத்தில்	தேகதில்
thaegaththil	தேகத்தில்	தேகத்தில்
thaekaththil	தேகத்தில்	தேகத்தில்
thaekkam	தேக்கம்	தேக்கம்
thekkam	தேக்கம்	தேக்கம்
thaekku	தேக்கு	தேக்கு
thekku	தேக்கு	தெக்கு
thaekkum	தேக்கும்	தேக்கும்
thekkum	தேக்கும்	தீக்கும்
thaengaai	தேங்காய்	தேங்கா
thaenkaai	தேங்காய்	தேங்கா
thaenum	தேனும்	தேனும்
thenum	தேனும்	தெனும்
thaergal	தேர்கள்	தேர்கள்
thaerkal	தேர்கள்	தேர்கள்
therkal	தேர்கள்	தெர்கள்
teerth	தேர்த்	தேர்த்
thaerth	தேர்த்	தேர்த்
theerth	தேர்த்	தீர்த்
therth	தேர்த்	தேர்த்
thaernthaedukka	தேர்ந்தெடுக்க	தேர்ந்தெடுக்க
thaernthedukka	தேர்ந்தெடுக்க	தேர்ந்தெடுக்க
thernthedukka	தேர்ந்தெடுக்க	தெர்ந்தெடுக்க
thaernthedukkappada	தேர்ந்தெடுக்கப்பட	தேர்ந்தெடுக்கப்பட்ட
thernthedukkappada	தேர்ந்தெடுக்கப்பட	தெர்ந்தெடுக்கப்பட்ட
thaernthaedukkappadum	தேர்ந்தெடுக்கப்படும்	தேர்ந்தெடுக்கப்பட்டும
thaernthedukkappadum	தேர்ந்தெடுக்கப்படும்	தேர்ந்தெடுக்கப்பட்டும
thernthedukkappadum	தேர்ந்தெடுக்கப்படும்	தெர்ந்தெடுக்கப்பட்டும
devaalayanggalil	தேவாலயங்களில்	தேவாளரிகளில்
devalayangalil	தேவாலயங்களில்	தேவலாளிகளில்
thevaalayangalil	தேவாலயங்களில்	தேவாளரிகளில்
thevaalayangkalil	தேவாலயங்களில்	தேவாளர்களில்
devaalayangal	தேவாலயங்கள்	தேவாளாகள்
devalayangal	தேவாலயங்கள்	தேவலாகள்
thevaalayangal	தேவாலயங்கள்	தேவாளாகள்
thevaalayangkal	தேவாலயங்கள்	தேவாளைகள்க்
devaalayaththin	தேவாலயத்தின்	தேவாளதிதின்
devalayaththin	தேவாலயத்தின்	தேவலதிதின்
thevaalayaththin	தேவாலயத்தின்	தேவாளதிதின்
devaalayaththil	தேவாலயத்தில்	தேவாளதிதில்
devalayaththil	தேவாலயத்தில்	தேவலதில்தில்
thevaalayaththil	தேவாலயத்தில்	தேவாளதிதில்
devaalayaththai	தேவாலயத்தை	தேவாளைத்தை
devalayaththai	தேவாலயத்தை	தேவலையத்தை
thevaalayaththai	தேவாலயத்தை	தேவாளைத்தை
thoguththal	தொகுத்தல்	தொகுத்தல்
thoguththavar	தொகுத்தவர்	தொகுத்தவர்
thoguththullaar	தொகுத்துள்ளார்	தொகுத்துள்ளார்
thoguppinai	தொகுப்பினை	தொகுப்பினை
thokupinai	தொகுப்பினை	தொகுப்பினை
thokuppinai	தொகுப்பினை	தொகுப்பிகின்
thoguppai	தொகுப்பை	தொகுப்பை
thokupaip	தொகுப்பை	தொகுப்பை
thokuppai	தொகுப்பை	தொகுப்பை
thoguppaip	தொகுப்பைப்	தொகுப்பைப்
thokupaip	தொகுப்பைப்	தொகுப்பை
thokuppaip	தொகுப்பைப்	தொகுப்பைப்
thogai	தொகை	தோகை
thokai	தொகை	தோக்கை
tokai	தொகை	டோக்கை
thogaik	தொகைக்	தோகைக்
thokaik	தொகைக்	தோகைக்
tokaik	தொகைக்	டோக்கை
thogaip	தொகைப்	தோகைப்
thokaip	தொகைப்	தோகைப்
tokaip	தொகைப்	டோக்கைப்
thogaiyaaga	தொகையாக	தோகையாக
thokaiyaaka	தொகையாக	தொகையாக
thokaiyaka	தொகையாக	தொகையாக
thogaiyana	தொகையான	தோகையான
thokaiyaana	தொகையான	தோகையான
thokaiyana	தொகையான	தோகையான
thogaiyil	தொகையில்	தோகையில்
thokaiyil	தொகையில்	தோகையில்
tokaiyil	தொகையில்	டோக்கியில்
thogaiyudan	தொகையுடன்	தோகையுடன்
thokaiyudan	தொகையுடன்	தோகையுட்டு
thokaiyutan	தொகையுடன்	தோக்கையுட்
tokaiyutan	தொகையுடன்	தோக்கையுட்
thogaiyum	தொகையும்	தோகையும்
thokaiyum	தொகையும்	தொகையும்
tokaiyum	தொகையும்	தொகையும்
thokaiyaich	தொகையைச்	தொகையைச்
tokaiyaich	தொகையைச்	டொகையைச்
thokaiyaiyum	தொகையையும்	தொகையையும்
tokaiyaiyum	தொகையையும்	தொகையையும்
thodandhu	தொடந்து	தொடன்து
thodanththu	தொடந்து	தொட்ந்து
thotanthu	தொடந்து	தொட்ந்து
totanthu	தொடந்து	தொட்டுத்து
thodarbaana	தொடர்பான	தொடர்பான
thodarpaana	தொடர்பான	தொடர்பான
thotarpaana	தொடர்பான	தோடர்பான
thotarpana	தொடர்பான	தோடர்பான
thodarbaanathu	தொடர்பானது	தொடர்பாதது
thodarpaanathu	தொடர்பானது	தொடர்பானது
thotarpaanathu	தொடர்பானது	தோடர்பானது
thotarpanathu	தொடர்பானது	தோற்றப்பது
thodarbaanavai	தொடர்பானவை	தொடர்பாாவை
thodarpaanavai	தொடர்பானவை	தொடர்பாானை
thotarpaanavai	தொடர்பானவை	தொடர்பாாவை
thotarpanavai	தொடர்பானவை	தொடர்பாணவை
thodarbu	தொடர்பு	தொடர்பு
thodarpu	தொடர்பு	தொடர்பு
thotarpu	தொடர்பு	தோற்றப்பு
totarpu	தொடர்பு	தோடர்பு
thodarbukalai	தொடர்புகளை	தொடர்புகளை
thodarpukalai	தொடர்புகளை	தொடர்புகளை
thotarpukalai	தொடர்புகளை	தோற்றப்புகளை
totarpukalai	தொடர்புகளை	தொட்றுப்களை
thodarbukalaip	தொடர்புகளைப்	தொடர்புகளைப்
thodarpukalaip	தொடர்புகளைப்	தொடர்புகளைப்
thotarpukalaip	தொடர்புகளைப்	தொடர்புப்களை
totarpukalaip	தொடர்புகளைப்	தொடர்புகளைப்
thodarbup	தொடர்புப்	தொடர்ப்பு
thodarpup	தொடர்புப்	தொடர்ப்பு
thodarbum	தொடர்பும்	தொடர்பும்
thodarpum	தொடர்பும்	தொடர்பும்
thoduthal	தொடுதல்	தொடுதல்
totuthal	தொடுதல்	தொட்டுல்
thottuk	தொட்டுக்	தோட்டுக்
thotuk	தொட்டுக்	தோட்கு
thottum	தொட்டும்	தொட்டும்
thotum	தொட்டும்	தோட்டும்
tholaipaesigal	தொலைபேசிகள்	தொலைபாளிக்கள்
tholaipesigal	தொலைபேசிகள்	தொலைப்பிசாக்
tholaipaesikku	தொலைபேசிக்கு	தொலைப்பிசுக்க
tholaipesikku	தொலைபேசிக்கு	தொலைப்பிசுக்க
tholaipaesiyil	தொலைபேசியில்	தொலைப்பிலியில
tholaipesiyil	தொலைபேசியில்	தொலைப்பிலியில
tholiyal	தொல்லியல்	தொழியல்
tholliyal	தொல்லியல்	தொல்லியல்
tholilathibarai	தொழிலதிபரை	தொலிலிதைபாரை
thozhilathibarai	தொழிலதிபரை	தொழிலைப்றை
thozhilathiparai	தொழிலதிபரை	தொழிலைப்பாளை
tholilum	தொழிலும்	தொழிலும்
thozhilum	தொழிலும்	தொழிலும்
tolilum	தொழிலும்	தொலிலும்
tholilae	தொழிலே	தொழிலை
tholile	தொழிலே	தொலிலி
tholilee	தொழிலே	தொலிலில்
thozhile	தொழிலே	தொழில்
thoandappatta	தோண்டப்பட்ட	தோன்பட்டப்
thondappatta	தோண்டப்பட்ட	தொன்டப்பட்ட
thontapata	தோண்டப்பட்ட	தொன்டப்பட்டா
thoontappatta	தோண்டப்பட்ட	தோன்டப்பட்ட
thoaththiram	தோத்திரம்	தோத்திரம்
thootthiram	தோத்திரம்	தோத்திரம்
thothiram	தோத்திரம்	தொதிர்மம்
thoththiram	தோத்திரம்	தொத்திரம்
thondriyadhaaga	தோன்றியதாக	தொன்றியாக
thondriyadhaaka	தோன்றியதாக	தொன்றியாக
thondriyathaaga	தோன்றியதாக	தொன்றியாக
thondriyathaaka	தோன்றியதாக	தொன்றியாத
thontriyathaka	தோன்றியதாக	தொன்றியதாக
thoontriyathaaka	தோன்றியதாக	தொன்றியாத
thondriyadhu	தோன்றியது	தொன்றியது
thondriyathu	தோன்றியது	தொன்றியது
thontriyathu	தோன்றியது	தொன்றியது
thoontriyathu	தோன்றியது	தோன்றியது
thondriyadhai	தோன்றியதை	தொன்றியைய
thondriyathai	தோன்றியதை	தொன்றியைய
thontriyathai	தோன்றியதை	தொன்றியைய
thoontriyathai	தோன்றியதை	தோன்றியைய
thondriyavar	தோன்றியவர்	தொன்றியார்
thontriyavar	தோன்றியவர்	தொன்றியவர்
thoontriyavar	தோன்றியவர்	தோன்றியவர்
thondriyavai	தோன்றியவை	தொன்றியைய
thontriyavai	தோன்றியவை	தொன்றியைய
thoontriyavai	தோன்றியவை	தோன்றியைய
thoarum	தோறும்	தோரும்
thaotrtru	தோற்று	தோற்று
thoarru	தோற்று	தோர்று
thoatrtru	தோற்று	தோற்று
thoatru	தோற்று	தோற்று
thoattru	தோற்று	தோற்று
thoarruvikkappadum	தோற்றுவிக்கப்படும்	தோற்றுக்கப்படுக்கும
thoatruvikkappadum	தோற்றுவிக்கப்படும்	தோற்றுவிக்கப்பட்டும
thoattruvikkappadum	தோற்றுவிக்கப்படும்	தோற்றுவிக்கப்பட்டும
thoarruvikkappatta	தோற்றுவிக்கப்பட்ட	தோற்றுக்கப்பட்ட்ட
thoatruvikkappatta	தோற்றுவிக்கப்பட்ட	தோற்றுவிக்கப்பட்ட
thoattruvikkappatta	தோற்றுவிக்கப்பட்ட	தோற்றுவிக்கப்பட்ட
thoarruvikkum	தோற்றுவிக்கும்	தோற்றுவிக்கும்
thoatruvikkum	தோற்றுவிக்கும்	தோற்றுவிக்கும்
thoattruvikkum	தோற்றுவிக்கும்	தோற்றுவிக்கும்
thoarruviththa	தோற்றுவித்த	தோர்றுவித்த
thoatruviththa	தோற்றுவித்த	தோற்றுவித்த
thoattruviththa	தோற்றுவித்த	தோற்றுவித்த
thoarruviththathu	தோற்றுவித்தது	தோர்றுவித்தது
thoatruviththathu	தோற்றுவித்தது	தோற்றுவித்தது
thoattruviththathu	தோற்றுவித்தது	தோற்றுவித்து
thoalaal	தோலால்	தோலால்
thaan	தோல்வி	தான்
thoalvi	தோல்வி	தோல்வி
tholvi	தோல்வி	தொல்வி
thoolvi	தோல்வி	தோல்வி
thoalvigalai	தோல்விகளை	தோல்விகளை
thoalvigazhai	தோல்விகளை	தொல்விகளை
tholvigalai	தோல்விகளை	தொல்விகளை
tholvikalai	தோல்விகளை	தொல்விகளை
thoolvikalai	தோல்விகளை	தொல்விலைகளை
thoalvigalaiyum	தோல்விகளையும்	தோல்வியைகளும்
thoalvigazhaiyum	தோல்விகளையும்	தொல்வியைகளும்
tholvigalayum	தோல்விகளையும்	தொல்வியாகும்
tholvikalaiyum	தோல்விகளையும்	தொல்வியைகளும்
tholvikalayum	தோல்விகளையும்	தொல்வியாகும்
thoolvikalaiyum	தோல்விகளையும்	தொல்வியைகளும்
thoalvigal	தோல்விகள்	தோல்விகள்
thoalvigazh	தோல்விகள்	தோல்விகளை
tholvigal	தோல்விகள்	தொல்விகள்
tholvikal	தோல்விகள்	தொல்விகள்
thoolvikal	தோல்விகள்	தோல்விகள்
thoalviyaal	தோல்வியால்	தோல்வியால்
thoalviyin	தோல்வியின்	தோல்வியின்
thoalviyai	தோல்வியை	தோல்வியை
thriller	த்ரில்லர்	திரில்லிர்
nadunilaimai	நடுநிலைமை	நடுணிலையை
nadunilamai	நடுநிலைமை	நடுணிலையம்
nadaipera	நடைபெற	நடைப்பர்
nadaiperakkoodiya	நடைபெறக்கூடிய	நடைபெற்கோடியே
nadaiperath	நடைபெறத்	நடைபர்த்த
nadiperath	நடைபெறத்	நடிபர்த்த
nadaiperavillai	நடைபெறவில்லை	நடைபர்பலிலையில
nadaiperrum	நடைபெறும்	நடைபெற்றும்
nadaiperum	நடைபெறும்	நடைப்பரும்
nadaiperumbodhu	நடைபெறும்போது	நடைபெற்றும்பு
nadaiperumpoadhu	நடைபெறும்போது	நடைபெற்றும்போத
nadaiperumpothu	நடைபெறும்போது	நடைபெற்றும்பு
nadaiperuvadharku	நடைபெறுவதற்கு	நடைப்பருவதற்கு
nadaiperuvatharku	நடைபெறுவதற்கு	நடைப்பருவதற்கு
nadaiperuvadhu	நடைபெறுவது	நடைப்புறது
nadaiperuvathu	நடைபெறுவது	நடைப்புறது
nadhigalin	நதிகளின்	நதிகளின்
nadhigazhin	நதிகளின்	நதிகழின்
nadhikalin	நதிகளின்	நதிகளின்
nathigalin	நதிகளின்	நதிகளின்
nadhigalil	நதிகளில்	நதிகளில்
nadhigazhil	நதிகளில்	நதிகழில்
nadhikalil	நதிகளில்	நதிகளில்
nathigalil	நதிகளில்	நதிகளில்
nathikalil	நதிகளில்	நதிகளில்
nadhigalukku	நதிகளுக்கு	நதிகளுக்கு
nadhigazhukku	நதிகளுக்கு	நதிகழுக்கு
nadhikalukku	நதிகளுக்கு	நதிகளுக்கு
nathigalukku	நதிகளுக்கு	நதிகளுக்கு
nadhigal	நதிகள்	நதிகள்
nadhikal	நதிகள்	நதிகள்
nathigal	நதிகள்	நதிகள்
nadhikku	நதிக்கு	நதிக்கு
nathikku	நதிக்கு	நதிக்கு
nadhiyaaga	நதியாக	நதியாக
nadhiyaaka	நதியாக	நதியாக
nathiyaaga	நதியாக	நதியாக
nadhiyin	நதியின்	நதியின்
nathiyin	நதியின்	நாதியின்
nadhiyum	நதியும்	நதியும்
nathiyum	நதியும்	நதியும்
nadhiyai	நதியை	நதியை
nathiyai	நதியை	நதியை
nanavili	நனவிலி	நாவிிலி
nanmaigalum	நன்மைகளும்	நண்மைகளும்
nanmaigazhum	நன்மைகளும்	நண்மைகளும்
nanmaikalum	நன்மைகளும்	நண்மைகளும்
nanmaigalaiyum	நன்மைகளையும்	நண்மைகளையும்
nanmaigazhaiyum	நன்மைகளையும்	நண்மைகளையும்
nanmaikalaiyum	நன்மைகளையும்	நண்மைகளையும்
nanmaiyin	நன்மையின்	நண்மையின்
nanmaiyum	நன்மையும்	நண்மையும்
nanmaiyai	நன்மையை	நண்மையை
namo	நமோ	நாமோ
namoa	நமோ	நமோ
narachimma	நரசிம்ம	நரசிமம்
narasima	நரசிம்ம	நரசியம்
narasimma	நரசிம்ம	நரசமியம்
narachimmarin	நரசிம்மரின்	நராமிசரியம்
narasimarin	நரசிம்மரின்	நரரிசமின்
narasimmarin	நரசிம்மரின்	நரசமிமின்
narachimar	நரசிம்மர்	நரசிரம்
narachimmar	நரசிம்மர்	நரசமிமார்
narasimhar	நரசிம்மர்	நரசிரம்
narasimmar	நரசிம்மர்	நரசமிமம்
narambu	நரம்பு	நரம்பு
narampu	நரம்பு	நரம்பு
narambugalin	நரம்புகளின்	நரம்புகளின்
narambukalin	நரம்புகளின்	நரம்புகளின்
narampukalin	நரம்புகளின்	நரம்புகளின்
narambugalil	நரம்புகளில்	நரம்புகளில்
narambukalil	நரம்புகளில்	நரம்புகளில்
narampukalil	நரம்புகளில்	நரம்புகளில்
narambuth	நரம்புத்	நரம்பது
naramputh	நரம்புத்	நரம்புத்
narmadhai	நர்மதை	நர்மதை
narmathai	நர்மதை	நர்மதை
nalappanigal	நலப்பணிகள்	நாலப்பினாக்
nalappanikal	நலப்பணிகள்	நாலப்பினாக்
nalathu	நல்லது	நலது
nallathu	நல்லது	நல்லது
nalavan	நல்லவன்	நலவன்
nallavan	நல்லவன்	நல்லவன்
raga	நவீன	ரகக
raka	நவீன	ரகக
naveenamaana	நவீனமான	நேவனமான
naagareega	நாகரீக	நகரேக்க
naagareegaththin	நாகரீகத்தின்	நகரேகத்தின்
naagarigaththin	நாகரீகத்தின்	நாகரித்தின்
naagareegam	நாகரீகம்	நகரேக்கம்
naasaa	நாசா	நாசா
nasa	நாசா	நாச
naashik	நாசிக்	நாசிக்
naasik	நாசிக்	நாசிக்
naasiq	நாசிக்	நாசிக்
nashic	நாசிக்	நசிச்
nashik	நாசிக்	நசிக்
nasic	நாசிக்	நசிச்
nasik	நாசிக்	நசிக்
nasiq	நாசிக்	நாசிக்
naisism	நாசிசம்	நிச்சிம்
naisismm	நாசிசம்	நிசைம்ம்
najism	நாசிசம்	நாஜிஸ்
nasism	நாசிசம்	நாசிஸ்
nazism	நாசிசம்	நாஜிஸ்
nesismm	நாசிசம்	நிசிமம்
naadodikal	நாடோடிகள்	நாடோடிகள்
naadoodikal	நாடோடிகள்	நாடோடிகள்
nadoadigal	நாடோடிகள்	நடடடியால்
naattavar	நாட்டவர்	நாட்டவர்
naattin	நாட்டின்	நாட்டின்
naattiyam	நாட்டியம்	நாட்டியம்
naathar	நாதர்	நாதர்
nathar	நாதர்	நதர்
naangaam	நான்காம்	நாங்கம்
naankaam	நான்காம்	நாங்கமா
naatram	நாற்றம்	நாற்றம்
naattram	நாற்றம்	நாற்றம்
naalanthaa	நாலந்தா	நாலந்தா
naalanththaa	நாலந்தா	நாழந்தா
nalanda	நாலந்தா	நலந்தா
nalantha	நாலந்தா	நலந்த
naalo	நாளோ	நாலோ
nallloa	நாளோ	நால்லோ
nigalththappatta	நிகழ்த்தப்பட்ட	நிகழ்த்தப்பட்ட
nigazhththappatta	நிகழ்த்தப்பட்ட	நிகழ்த்தப்பட்ட
nikazhththappatta	நிகழ்த்தப்பட்ட	நிகழ்த்தப்பட்ட
nigalththappattu	நிகழ்த்தப்பட்டு	நிகழ்த்தப்பட்டு
nigazhththappattu	நிகழ்த்தப்பட்டு	நிகழ்த்தப்பட்டு
nikazhththappattu	நிகழ்த்தப்பட்டு	நிகழ்த்தப்பட்டு
nigalththuvathu	நிகழ்த்துவது	நிகழ்த்துவது
nigazhththuvadhu	நிகழ்த்துவது	நிகழ்த்துவது
nigazhththuvathu	நிகழ்த்துவது	நிகழ்த்துவது
nikazhththuvathu	நிகழ்த்துவது	நிகழ்த்துவது
nigalvu	நிகழ்வு	நிகழ்வு
nigazhvu	நிகழ்வு	நிகழ்வு
nikazhvu	நிகழ்வு	நிகழ்வு
nigalvugalaaga	நிகழ்வுகளாக	நிகழ்குவாக
nigazhvugalaaga	நிகழ்வுகளாக	நிகழ்வுகளாக
nigazhvugazhaaga	நிகழ்வுகளாக	நிகழ்குவாக
nikazhvukalaaka	நிகழ்வுகளாக	நிகழ்வுகளாக
nigalvugalilum	நிகழ்வுகளிலும்	நிகழ்வுள்ளும்
nigazhvugalilum	நிகழ்வுகளிலும்	நிகழ்குவிலும்
nigazhvugazhilum	நிகழ்வுகளிலும்	நிகழ்குவளிலும்
nikazhvukalilum	நிகழ்வுகளிலும்	நிகழ்வுகளிலும்
nigalvugalil	நிகழ்வுகளில்	நிகழ்குவில்ல்
nigazhvugalil	நிகழ்வுகளில்	நிகழ்குவில்ல்
nigazhvugazhil	நிகழ்வுகளில்	நிகழ்குவில்ல்
nikazhvukalil	நிகழ்வுகளில்	நிகழ்வுகளில்
nigalvugalukku	நிகழ்வுகளுக்கு	நிகழ்குவுகளுக்
nigazhvugalukku	நிகழ்வுகளுக்கு	நிகழ்குவுகளுக்
nigazhvugazhukku	நிகழ்வுகளுக்கு	நிகழ்குவுக்கு
nikazhvukalukku	நிகழ்வுகளுக்கு	நிகழ்குவுகளுக்
nigalvugalukkum	நிகழ்வுகளுக்கும்	நிகழ்குவுகளும்
nigazhvugalukkum	நிகழ்வுகளுக்கும்	நிகழ்குவுகளும்
nigazhvugazhukkum	நிகழ்வுகளுக்கும்	நிகழ்குவுகளுக்கும
nikazhvukalukkum	நிகழ்வுகளுக்கும்	நிகழ்குவுகளுக்கும
nigalvugaludan	நிகழ்வுகளுடன்	நிகழ்குவடுள்ளன
nigazhvugaludan	நிகழ்வுகளுடன்	நிகழ்வுகளுடன்
nigazhvugazhudan	நிகழ்வுகளுடன்	நிகழ்குவதுவன்
nikazhvukaludan	நிகழ்வுகளுடன்	நிகழ்குவதுள்ளன
nigalvugalum	நிகழ்வுகளும்	நிகழ்குவும்
nigazhvugalum	நிகழ்வுகளும்	நிகழ்குவுள்ம்
nigazhvugazhum	நிகழ்வுகளும்	நிகழ்குவுகளும்
nikazhvukalum	நிகழ்வுகளும்	நிகழ்வுகளும்
nigalvugalai	நிகழ்வுகளை	நிகழ்குவைல்
nigazhvugalai	நிகழ்வுகளை	நிகழ்குவைளை
nigazhvugazhai	நிகழ்வுகளை	நிகழ்குவை
nikazhvukalai	நிகழ்வுகளை	நிகழ்குவைளை
nigalvugalaich	நிகழ்வுகளைச்	நிகழ்குவைச்ல்
nigazhvugalaich	நிகழ்வுகளைச்	நிகழ்க்குவைல்
nigazhvugazhaich	நிகழ்வுகளைச்	நிகழ்க்குவைச்
nikazhvukalaich	நிகழ்வுகளைச்	நிகழ்குவைகளி
nigalvugal	நிகழ்வுகள்	நிகழ்குவல்
nigazhvugal	நிகழ்வுகள்	நிகழ்குவல்
nigazhvugazh	நிகழ்வுகள்	நிகழ்குவா
nikazhvukal	நிகழ்வுகள்	நிகழ்வுகள்
nigalvukku	நிகழ்வுக்கு	நிகழ்குவுக்
nigazhvukku	நிகழ்வுக்கு	நிகழ்க்குவு
nikazhvukku	நிகழ்வுக்கு	நிகழ்க்குவு
nigalvukkup	நிகழ்வுக்குப்	நிகழ்க்குப்
nigazhvukkup	நிகழ்வுக்குப்	நிகழ்க்குவு
nikazhvukkup	நிகழ்வுக்குப்	நிகழ்க்குவு
nichayikapata	நிச்சயிக்கப்பட்ட	நிகிச்கப்பட
nichchayikkappatta	நிச்சயிக்கப்பட்ட	நிச்சிக்கப்பட்ட
neenja	நிஞ்ஜா	நீன்
neenza	நிஞ்ஜா	நீன்
niinja	நிஞ்ஜா	நிஞ்ச
ninchjaa	நிஞ்ஜா	நிஞ்சா
ninja	நிஞ்ஜா	நிஞ்ச
ninjaa	நிஞ்ஜா	நிஞ்சா
ninza	நிஞ்ஜா	நின்
ninzaa	நிஞ்ஜா	நின்சா
nynjaa	நிஞ்ஜா	நிஞ்சா
nynzaa	நிஞ்ஜா	நிஞ்சா
ninaivaaga	நினைவாக	நினைவாக
ninaivaaka	நினைவாக	நினைவாக
ninaivvaaga	நினைவாக	நின்வைவாக
ninaivaagavae	நினைவாகவே	நின்வைகாக
ninaivaagave	நினைவாகவே	நினைவாகவே
ninaivaakave	நினைவாகவே	நினைவாகவே
ninaivuchchinnam	நினைவுச்சின்னம்	நினைச்சுகின்ம்
niyamana	நியமன	நியமான
niyamanathil	நியமனத்தில்	நியமானதில்
niyamanaththil	நியமனத்தில்	நியமணத்தில்
niyamanatthil	நியமனத்தில்	நியமணத்தில்
niyamikapadum	நியமிக்கப்படும்	நியமிக்கப்படும்
niyamikkappadum	நியமிக்கப்படும்	நியமிக்கப்படும்
niyamikkappatum	நியமிக்கப்படும்	நியமிக்கப்பட்டும்
niyamikavum	நியமிக்கவும்	நியமிகவும்
niyamikkavum	நியமிக்கவும்	நியமிக்கவும்
niyamikkum	நியமிக்கும்	நியமிக்கும்
niyamikum	நியமிக்கும்	நியமிக்கும்
nirai	நிரை	நிறை
nirvagikkappadum	நிர்வகிக்கப்படும்	நிர்விக்கப்படுக்கம
nirvakikkappadum	நிர்வகிக்கப்படும்	நிர்விக்கப்படுக்கம
nirvagikkappattu	நிர்வகிக்கப்பட்டு	நிர்விக்கப்பட்டு
nirvakikkappattu	நிர்வகிக்கப்பட்டு	நிர்விக்கப்பட்டு
nirvaagac	நிர்வாகச்	நிர்வாகக்
nirvaagach	நிர்வாகச்	நிர்வாக்க்
nirvaagaththaal	நிர்வாகத்தால்	நிர்கவாதத்தல்
nirvaagaththin	நிர்வாகத்தின்	நிர்கவாத்தின்
nirvaakaththin	நிர்வாகத்தின்	நிர்வாத்தின்
nirvaagaththirku	நிர்வாகத்திற்கு	நிர்கவ்த்திக்கு
nirvaagaththai	நிர்வாகத்தை	நிர்கவாத்தை
nirvaakaththai	நிர்வாகத்தை	நிர்கவாத்தை
nirvaakatthai	நிர்வாகத்தை	நிற்கவாத்தை
nirvakathai	நிர்வாகத்தை	நிற்கவதை
nirvaagaththaip	நிர்வாகத்தைப்	நிர்கவாத்தைப்
nirvaakaththaip	நிர்வாகத்தைப்	நிர்வாகத்தைப்
nirvaakatthaip	நிர்வாகத்தைப்	நிர்வாகத்தைப்
nirvakathaip	நிர்வாகத்தைப்	நிர்கவத்தை
nirvaagam	நிர்வாகம்	நிர்வாகம்
nirvaakam	நிர்வாகம்	நிர்வாகம்
nirvakam	நிர்வாகம்	நிர்வாகம்
nilath	நிலத்	நிலத்த்
nilaththu	நிலத்து	நிலத்து
nilathu	நிலத்து	நிலத்து
nilatthu	நிலத்து	நிலத்து
nilaparapai	நிலப்பரப்பை	நிலப்பரபை
nilapparappai	நிலப்பரப்பை	நிலப்பரப்பை
nilainiluvaiyil	நிலுவையில்	நிலைந்திலைவில்
niluvaiyil	நிலுவையில்	நிலுவையில்
nilainiruththi	நிலைநிறுத்தி	நிலைந்திரித்தி
neengalum	நீங்களும்	நீங்களும்
neengkalum	நீங்களும்	நீங்களும்
neengal	நீங்கள்	நீங்கள்
neengkal	நீங்கள்	நீங்கள்
neetti	நீட்டி	நீட்டி
neerilivu	நீரிழிவு	நீரிலிவு
neerizhivu	நீரிழிவு	நீரிழிவு
neeraetrtru	நீரேற்று	நேரிட்று
neeraetru	நீரேற்று	நேரிடு
neereatru	நீரேற்று	நீரிட்று
neeraik	நீரைக்	நேரைக்
neeroatta	நீரோட்ட	நீரோட்டா
kneel	நீல்	கின்ல்
neal	நீல்	நேல்
neel	நீல்	நீல்
neiil	நீல்	நெய்லில்
neil	நீல்	நெய்ல்
nel	நீல்	நெல்
niil	நீல்	நில்
nulainthavudan	நுழைந்தவுடன்	நுழைந்தவுடன்
nuzhaindhavudan	நுழைந்தவுடன்	நுழைந்தவுடன்
nuzhinththavudan	நுழைந்தவுடன்	நிழுந்தவின்ட
nulainthu	நுழைந்து	நுழைந்து
nuzhaindhu	நுழைந்து	நுழைந்து
nuzhinththu	நுழைந்து	நிழுந்து
noolagak	நூலகக்	நோலகக்
noolakak	நூலகக்	நோலகக்க்
noolagangalai	நூலகங்களை	நோலக்களை
noolakangalai	நூலகங்களை	நோலக்களைகள்
noolakangkalai	நூலகங்களை	நோலங்களைகள்
noolangangkalai	நூலகங்களை	நோலங்களைக்கள்
noolagaththin	நூலகத்தின்	நோலகத்தின்
noolakaththin	நூலகத்தின்	நோலகத்தின்
noolagaththukku	நூலகத்துக்கு	நோலத்துக்கு
noolakaththukku	நூலகத்துக்கு	நோலத்துக்கு
noolagamaaga	நூலகமாக	நோலமாகக
noolagamaaka	நூலகமாக	நோலமாகக
noolakamaaga	நூலகமாக	நோலமாகக
noolakamaaka	நூலகமாக	நோலமாககக
noolagam	நூலகம்	நோலகம்
noolakam	நூலகம்	நோலகம்
noolagar	நூலகர்	நோலகர்
noolakar	நூலகர்	நோலகர்
noolaar	நூலார்	நோலார்
noolaal	நூலால்	நோலால்
noolilirundhu	நூலிலிருந்து	நோலிலிருந்து
noolilirunthu	நூலிலிருந்து	நோலிலிருந்து
negili	நெகிழி	நீகிலி
negizhi	நெகிழி	நீகிழி
negizhyi	நெகிழி	நீகிழியி
nekili	நெகிழி	நீகிலி
nediya	நெடிய	நெடிய
network	நெட்வொர்க்	நெட்வர்
nedharlaandhu	நெதர்லாந்து	நேதர்லாந்து
netharlaanthu	நெதர்லாந்து	நீதர்லாந்து
netherlaanththu	நெதர்லாந்து	நீத்ராழ்த்து
netherland	நெதர்லாந்து	நீத்ரா்தல்
netriyil	நெற்றியில்	நெற்றியில்
nettriyil	நெற்றியில்	நெற்றியில்
nel	நெல்	நெல்
nellai	நெல்லை	நெல்லை
nellaik	நெல்லைக்	நெல்லைக்
nellaip	நெல்லைப்	நெல்லைப்
naespid	நெஸ்பிட்	நேச்பிட்
nesbit	நெஸ்பிட்	நெஸ்பிட்
nesbitt	நெஸ்பிட்	நெஸ்பிட்ட்
naethraa	நேத்ரா	நேத்ரா
nethra	நேத்ரா	நெத்தா
neerittu	நேரிட்டு	நீரிட்டு
nerittu	நேரிட்டு	நெரிட்டு
neritu	நேரிட்டு	நெரிட்டு
naiirobii	நைரோபி	நியர்போபி
nairobi	நைரோபி	நிரோபி
nairoobi	நைரோபி	நிரோப்பி
nairoopi	நைரோபி	நிரோப்பி
nerobi	நைரோபி	நேரோபி
nairobiyil	நைரோபியில்	நிரோயிலில்
nairopiyil	நைரோபியில்	நிறோபியில்
nokich	நோக்கிச்	நோக்கி
nokkich	நோக்கிச்	நோக்கிக்
nookkich	நோக்கிச்	நோக்கிக்
nokin	நோக்கின்	நோக்கின்
nokkin	நோக்கின்	நோக்கின்
nookkin	நோக்கின்	நோக்கின்
nokiyum	நோக்கியும்	நோக்கியும்
nokkiyum	நோக்கியும்	நோக்கியும்
nookkiyum	நோக்கியும்	நோக்கியும்
nokilum	நோக்கிலும்	நோக்கிலும்
nokkilum	நோக்கிலும்	நோக்கிலும்
nooyinaal	நோயினால்	நோயியான்
noyinaal	நோயினால்	நோயினால்
noyinal	நோயினால்	நோயின்
nooyuttra	நோயுற்ற	நூய்ட்டர்
noyutra	நோயுற்ற	நோய்று
noyuttra	நோயுற்ற	நூய்ற்ற
noaiththotrukal	நோய்த்தொற்றுகள்	நோய்த்தொற்குள்
noayththotrugal	நோய்த்தொற்றுகள்	நோய்த்தொற்கள்
noiththottrugal	நோய்த்தொற்றுகள்	நோடித்தொற்றுகள்
pagirnthuk	பகிர்ந்துக்	பகிர்ந்துக்
pakirnthuk	பகிர்ந்துக்	பகிர்ந்துக்
bhagujan	பகுஜன்	பகுஜன்
pagujan	பகுஜன்	பகுஜன்
pakujan	பகுஜன்	பகுஜன்
paguthiyai	பகுதியை	பகுதியை
pakuthiyai	பகுதியை	பகுதியை
paguthiyaich	பகுதியைச்	பகுதியைச்
pakuthiyaich	பகுதியைச்	பகுதியைச்
paguthiyaip	பகுதியைப்	பகுதியைப்
pakuthiyaip	பகுதியைப்	பகுதியைப்
paagoda	பகோடா	பாகோடா
paagooda	பகோடா	பாகோடா
pagoda	பகோடா	பகோடா
pagodaa	பகோடா	பகோடா
pagooda	பகோடா	பகோடோ
pagoodaa	பகோடா	பகோடா
pagoovda	பகோடா	கோபோட்
pagoowda	பகோடா	கோபாட்
pagovda	பகோடா	கபோபாட்
pagowda	பகோடா	கபோபா
paguda	பகோடா	பகுடா
pakoadaa	பகோடா	கோபாடா
pakoda	பகோடா	பகோடா
pakooda	பகோடா	பகோடோ
pakootaa	பகோடா	பகோடா
pasukkalai	பசுக்களை	பசுக்களை
pasukkazhai	பசுக்களை	பாசுக்கை
pasukkazhil	பசுக்களை	பாசுக்கில்
padagai	படகை	படகை
padakai	படகை	படகை
padangalaaga	படங்களாக	படங்களாக
padangalaaka	படங்களாக	படங்களாக
padangkalaaka	படங்களாக	படங்களாக
padangalaana	படங்களான	படங்களான
padangkalaana	படங்களான	படங்களான
padangalil	படங்களில்	படங்களில்
padangkalil	படங்களில்	படங்களில்
pandangalil	படங்களில்	பண்டங்களில்
padangalukku	படங்களுக்கு	படங்களுக்கு
padangkalukku	படங்களுக்கு	படங்களுக்கு
padangalum	படங்களும்	படங்களும்
padanggalum	படங்களும்	படங்களும்
padappidippum	படப்பிடிப்பும்	படப்பிப்பியும்
padarndha	படர்ந்த	படர்ந்த
padarntha	படர்ந்த	படர்ந்த
padalaththin	படலத்தின்	படலத்தின்
padalaththai	படலத்தை	படலத்தை
padi	படி	படி
padigalil	படிகளில்	படிகளில்
padikalil	படிகளில்	படிகளில்
padigalum	படிகளும்	படிகளும்
padikalum	படிகளும்	படிகளும்
padigalai	படிகளை	படிகளை
padikalai	படிகளை	படிகளை
padiththaal	படித்தால்	படித்தால்
paditthaal	படித்தால்	படித்தால்
padinilaigal	படிநிலைகள்	படினிலைகள்
padinilaikal	படிநிலைகள்	படினிலைகள்
padinilaiyil	படிநிலையில்	படினிலையில்
padippadiyaana	படிப்படியான	படிப்பியான
padipaip	படிப்பைப்	படிப்பை
padippaip	படிப்பைப்	படிப்பைப்
patippaip	படிப்பைப்	படிப்பைப்
padimangal	படிமங்கள்	படிமங்கள்
padimankal	படிமங்கள்	படிமங்கள்
patimankal	படிமங்கள்	படிம்்கள்
padimathai	படிமத்தை	படிமதை
padimaththai	படிமத்தை	படிமத்தை
padimatthai	படிமத்தை	படிமைத்தை
patimatthai	படிமத்தை	படிமைத்தை
padiyilum	படியிலும்	படியிலும்
patiyilum	படியிலும்	படியிலும்
paduthoalvi	படுதோல்வி	படுதோல்வில்
padutholvi	படுதோல்வி	படுத்தோலி
paduthoolvi	படுதோல்வி	படுதோல்வி
patuthoolvi	படுதோல்வி	பாடுத்லோவி
paduthik	படுத்திக்	படுதிக்
paduththik	படுத்திக்	படுத்திக்
padutthik	படுத்திக்	படுத்திக்
patutthik	படுத்திக்	படுத்திக்
padaitha	படைத்த	படைத்த
padaiththa	படைத்த	படைத்த
padaittha	படைத்த	படைத்த
pataittha	படைத்த	படைத்த
padaithathaga	படைத்ததாக	படைத்தாக
padaithathaka	படைத்ததாக	படைத்ததாக
padaiththathaaga	படைத்ததாக	படைத்ததாக
padaiththathaaka	படைத்ததாக	படைத்ததாக
padaitthathaaka	படைத்ததாக	படைத்ததாக
pataitthathaaka	படைத்ததாக	படைத்ததாக
padaithal	படைத்தல்	படைத்தல்
padaiththal	படைத்தல்	படைத்தல்
padaitthal	படைத்தல்	படைத்தல்
pataitthal	படைத்தல்	படைத்தல்
padaithavan	படைத்தவன்	படைத்தான்
padaiththavan	படைத்தவன்	படைத்தவன்
padaitthavan	படைத்தவன்	படைத்தவன்
pataitthavan	படைத்தவன்	படைத்தவன்
padaithar	படைத்தார்	படைத்தார்
padaiththaar	படைத்தார்	படைத்தார்
padaitthaar	படைத்தார்	படைத்தார்
pataitthaar	படைத்தார்	படைத்தார்
padaiththullathu	படைத்துள்ளது	படைத்துள்ளது
padaithulathu	படைத்துள்ளது	படைத்துள்ளது
padaitthullathu	படைத்துள்ளது	படைத்துள்ளது
pataitthullathu	படைத்துள்ளது	படைத்துள்ளது
padaiththullaar	படைத்துள்ளார்	படைத்துள்ளார்
padaithular	படைத்துள்ளார்	படைத்துள்ள
padaitthullaar	படைத்துள்ளார்	படைத்துள்ளார்
pataitthullaar	படைத்துள்ளார்	படைத்துள்ளார்
padaiyani	படையணி	படையின்
pataiyani	படையணி	படையானி
padaiyanigal	படையணிகள்	படையானிகள்
padaiyanikal	படையணிகள்	படையானிகள்
pataiyanikal	படையணிகள்	படையானிகள்
padaiyinaraal	படையினரால்	படையினார்
padaiyinaral	படையினரால்	படையினர்
pataiyinaraal	படையினரால்	படையியார்
padaiyinarin	படையினரின்	படையினர்ன்
pataiyinarin	படையினரின்	படையினன்றன்
padaiyinarai	படையினரை	படையினை
padayinarai	படையினரை	படையினர்
patayinarai	படையினரை	படையினர்
pattaalum	பட்டாலும்	பாட்டாலும்
panayam	பணயம்	பணயம்
panigalilum	பணிகளிலும்	பணிகளிலும்
panigazhilum	பணிகளிலும்	பணிகளிலும்
panigalil	பணிகளில்	பணிகளில்
panigalukkaana	பணிகளுக்கான	பணிகளுக்கான
panigazhukkaana	பணிகளுக்கான	பணிகழுக்கான
panigalaich	பணிகளைச்	பணிகளைச்
panigazhaich	பணிகளைச்	பணிகழைச்
panik	பணிக்	பணிக்
panikku	பணிக்கு	பணிக்கு
panikkum	பணிக்கும்	பணிக்கும்
panit	பணித்	பாணிட்
panith	பணித்	பணித்
paniyagam	பணியகம்	பணியகம்
paniyakam	பணியகம்	பணியகம்
paniyaaga	பணியாக	பணியாக
paniyaaka	பணியாக	பணியாக
paniyaalarin	பணியாளரின்	பணியாளரின்
paniyil	பணியில்	பணியில்
paniyaiyum	பணியையும்	பணியையும்
panivum	பணிவும்	பணிவும்
panbaadugalil	பண்பாடுகளில்	பாண்பாடுகளில்
panpaadugalil	பண்பாடுகளில்	பாண்பாடுகளில்
panpaadugazhil	பண்பாடுகளில்	பண்பாடுகளில்
panpaadukalil	பண்பாடுகளில்	பாண்பாடுகளில்
panbadugalai	பண்பாடுகளை	பண்படுகளை
panpaadugalai	பண்பாடுகளை	பண்பாடுகளை
panpaadugazhai	பண்பாடுகளை	பண்பாடுகளை
panpaadukalai	பண்பாடுகளை	பண்பாடுகளை
panbaadugal	பண்பாடுகள்	பண்பாடுகள்
panpaadugal	பண்பாடுகள்	பண்பாடுகள்
panpaadukal	பண்பாடுகள்	பண்பாடுகள்
panbaana	பண்பான	பண்பான
padhikka	பதிக்க	பதிக்க
pathikka	பதிக்க	பதிக்க
keelkkanakku	பதினெண்	கீழ்க்கக்கு
keezhkkanakku	பதினெண்	கீழ்க்கங்கு
kilkkanakku	பதினெண்	கில்க்க்க்கு
padhinoaru	பதினோரு	பதினோரு
pathinoaru	பதினோரு	பதினோரு
padhipiththaar	பதிப்பித்தார்	பதிபித்தார்
pathippiththaar	பதிப்பித்தார்	பதிப்பித்தார்
pathippitthaar	பதிப்பித்தார்	பதிப்பித்தார்
padhipiththu	பதிப்பித்து	பதிிப்துத்
pathippiththu	பதிப்பித்து	பதிப்பித்து
pathippitthu	பதிப்பித்து	பதிப்பித்து
bathilaliththaan	பதிலளித்தான்	பதிலிலத்தான்
pathilaliththaan	பதிலளித்தான்	பதிலிலத்தான்
bathilaliththaar	பதிலளித்தார்	பதிலில்த்தார்
pathilaliththaar	பதிலளித்தார்	பதிலிலத்தார்
paththaandugalukku	பத்தாண்டுகளுக்கு	பாத்தாள்குக்குக்
paththaandukalukku	பத்தாண்டுகளுக்கு	பாத்தாள்குக்குக்
paththandukalukku	பத்தாண்டுகளுக்கு	பத்தாளுக்குக்கு
paththaandugalukkum	பத்தாண்டுகளுக்கும்	பாத்தாண்டுக்கும்
paththaandukalukkum	பத்தாண்டுகளுக்கும்	பாத்தான்டுக்குக்கும்
paththin	பத்தின்	பத்தின்
paththo	பத்தோ	பத்தோ
paththoa	பத்தோ	பத்தோ
padmanaaba	பத்மநாப	பட்மானா
pathmanaaba	பத்மநாப	பத்மான
pathmanaapa	பத்மநாப	பத்மானப
pandhi	பந்தி	பந்தி
panthi	பந்தி	பந்தி
panththi	பந்தி	பந்தி
pandrikku	பன்றிக்கு	பண்றிக்கு
panrikku	பன்றிக்கு	பண்றிக்கு
payanitha	பயணித்த	பயனித்
payaniththa	பயணித்த	பயனித்த
payanithar	பயணித்தார்	பயனித்தர்
payaniththaar	பயணித்தார்	பயனித்தார்
payirgalaana	பயிர்களான	பயிர்களான
payirkalaana	பயிர்களான	பயிற்களான
payirgalai	பயிர்களை	பயிற்களை
payirkalai	பயிர்களை	பயிற்களை
paiyrkalaiyum	பயிர்களையும்	பையற்களையும்
payirgalaiyum	பயிர்களையும்	பயிற்களையும்
payirkalaiyum	பயிர்களையும்	பயிற்களையும்
paiyrkal	பயிர்கள்	பையற்கள்
payirkal	பயிர்கள்	பயிற்கள்
parappalavil	பரப்பளவில்	பரப்பலலில்
parappazhavil	பரப்பளவில்	பரப்பாளில்
parappuraigal	பரப்புரைகள்	பறப்புறைகள்
parappuraikal	பரப்புரைகள்	பறப்புறைகள்
parchinai	பரிசினை	பர்சினை
parichinai	பரிசினை	பரிசினை
parisinai	பரிசினை	பரிசினை
parindhuraikka	பரிந்துரைக்க	பரிந்துரைக்க
parinthuraikka	பரிந்துரைக்க	பரிந்துரைக்க
parindhuraikkappadum	பரிந்துரைக்கப்படும்	பரிந்துருக்கப்பட்டம்
parinthuraikkappadum	பரிந்துரைக்கப்படும்	பரிந்துருக்கப்பட்டம்
parinthuraikkappatum	பரிந்துரைக்கப்படும்	பரிந்துருக்கப்பட்டம்
parindhuraikkum	பரிந்துரைக்கும்	பரிந்துரைக்கும்
parinththuraikkum	பரிந்துரைக்கும்	பரிந்துருக்கைக்
parinthuraikkum	பரிந்துரைக்கும்	பரிந்துருக்கை
parimaatra	பரிமாற்ற	பரிமாற்ற
parimaattra	பரிமாற்ற	பரிமாற்ற
parimaatrangalai	பரிமாற்றங்களை	பரிமார்டாகளை
parimaatrangkalai	பரிமாற்றங்களை	பரிமார்டங்களை
parimaattrangalai	பரிமாற்றங்களை	பரிமார்ட்டைகள்
parimaattrankalai	பரிமாற்றங்களை	பரிமார்ட்டைகள்
parimaatrangal	பரிமாற்றங்கள்	பரிமார்டாக்கள்
parimaatrangkal	பரிமாற்றங்கள்	பரிமார்டங்கள்
parimaattrangal	பரிமாற்றங்கள்	பரிமாற்றா்கள்
parimaattrangalai	பரிமாற்றங்கள்	பரிமார்ட்டைகள்
parimaattrankal	பரிமாற்றங்கள்	பரிமாற்றா்்கள்
parimaattrankalai	பரிமாற்றங்கள்	பரிமார்ட்டைகள்
parimaatraththin	பரிமாற்றத்தின்	பரிமாரத்தின்
parimaattraththin	பரிமாற்றத்தின்	பரிமாரத்தின்ற்
parimaatram	பரிமாற்றம்	பரிமாற்றம்
parimaattram	பரிமாற்றம்	பரிமாற்றம்
barma	பர்மா	பர்மா
barmaa	பர்மா	பர்மா
berma	பர்மா	பெர்மா
burma	பர்மா	புர்மா
burmaa	பர்மா	புர்மா
buurma	பர்மா	பூர்மா
buurmaa	பர்மா	பூர்மா
parma	பர்மா	பர்மா
parmaa	பர்மா	பர்மா
barmaavin	பர்மாவின்	பர்மாய்வின்
burmaavin	பர்மாவின்	புர்மாயின்
burmavin	பர்மாவின்	புர்மாவின்
parmaavin	பர்மாவின்	பர்மாய்வின்
barmaavil	பர்மாவில்	பர்மாய்லில்
burmaavil	பர்மாவில்	புர்மாவில்
burmavil	பர்மாவில்	புர்மாவில்
parmaavil	பர்மாவில்	பர்மாய்லில்
parmavil	பர்மாவில்	பர்மாவில்
parappathu	பறப்பது	பரப்பது
parra	பற்ற	பரர்
patra	பற்ற	பற்ற
patrra	பற்ற	பற்ற
pattra	பற்ற	பற்ற
patraamal	பற்றாமல்	பற்றாால்
patrraamal	பற்றாமல்	பற்றாமல்
pattraamal	பற்றாமல்	பாற்றாலம்
patrinaal	பற்றினால்	பற்றினால்
pattrinaal	பற்றினால்	பற்றினால்
parrulla	பற்றுள்ள	பரர்ளுள்
patrulla	பற்றுள்ள	பற்றுள்ள
pattrulla	பற்றுள்ள	பற்றுள்ள
palagai	பலகை	பலைக்
palakai	பலகை	பலகை
palagaigalil	பலகைகளில்	பலைகளில்
palagaikalil	பலகைகளில்	பலைகளைகளில்
palakaikalil	பலகைகளில்	பலைகளைகளில்
palakaiyil	பலகைகளில்	பலைகையில்
palacharakku	பலசரக்கு	பலசர்ககு
palasarakku	பலசரக்கு	பலசருக்கு
balanaaga	பலனாக	பலானாக
balanaaka	பலனாக	பலானாக
palanaaga	பலனாக	பலணாக
palanaaka	பலனாக	பலணாக
palavarrilum	பலவற்றிலும்	பலவற்றிலும்
palavatrilum	பலவற்றிலும்	பலவற்றிலும்
palavatrrilum	பலவற்றிலும்	பலற்றிலும்
palavattrilum	பலவற்றிலும்	பாளவற்றிலும்
pallakku	பல்லக்கு	பல்லக்கு
pallavar	பல்லவர்	பல்லவர்
pallavargalin	பல்லவர்களின்	பல்லவர்களின்
pallavargazhin	பல்லவர்களின்	பல்லவர்கிின்
pallina	பல்லின	பல்லினா
pavudar	பவுடர்	பவுடர்
povder	பவுடர்	போட்டர்
powdar	பவுடர்	போட்டர்
powder	பவுடர்	போட்டர்
pavurnami	பவுர்ணமி	பவருமணி
pournami	பவுர்ணமி	பூர்ணமி
pauli	பவுலி	பாலி
paulii	பவுலி	பாலி
pauuli	பவுலி	பாலி
pavuli	பவுலி	பவுளி
bowlin	பவுலின்	போலின்
pavulin	பவுலின்	பவுளின்
paagupaadugal	பாகுபாடுகள்	பாகுபாடுகள்
paakupaadukal	பாகுபாடுகள்	பாகுபாடுகள்
paadalilum	பாடலிலும்	பாடலிலும்
paatalilum	பாடலிலும்	பாடலிலும்
paandavar	பாண்டவர்	பாண்டர்
paantavar	பாண்டவர்	பாண்டர்
pandavar	பாண்டவர்	பண்டவர்
paandavargalin	பாண்டவர்களின்	பாண்டவரிகளின்
paandavarkalin	பாண்டவர்களின்	பாண்டவரிகளின்
paantavarkalin	பாண்டவர்களின்	பாண்டவர்களின்
pandavargalin	பாண்டவர்களின்	பண்டவர்களின்
paandavargalukku	பாண்டவர்களுக்கு	பாண்டவர்களுக்கு
paandavarkalukku	பாண்டவர்களுக்கு	பாண்டவர்களுக்கு
paantavarkalukku	பாண்டவர்களுக்கு	பான்றவர்களுக்கு
pandavargalukku	பாண்டவர்களுக்கு	பண்டவர்களுக்கு
paathagamaaka	பாதகமாக	பாதகாக
paathakamaaka	பாதகமாக	பாதகாகமா
paathaagamaana	பாதகமான	பாதாாகன
paathaakamaana	பாதகமான	பாதாகான
paathagamaana	பாதகமான	பாதாகமான
paathakamaana	பாதகமான	பாதகமான
paadhi	பாதி	பாதி
paathi	பாதி	பாதி
baathiththu	பாதித்து	பாதித்து
paathiththu	பாதித்து	பாதித்து
paadhiyei	பாதியை	பாதியி
paathiyai	பாதியை	பாதியை
baathaikalil	பாதைகளில்	பாதிகளைல்
paathaikalil	பாதைகளில்	பாதிகளைல்
baathaikalaiyum	பாதைகளையும்	பாதைகளையும்
paathaikalaiyum	பாதைகளையும்	பாதைகளையும்
baathaikal	பாதைகள்	பாதைகள்
paathaikal	பாதைகள்	பாதைகள்
baathaiyaaka	பாதையாக	பாதையாக
paathaiyaaka	பாதையாக	பாதையாக
paathaiyin	பாதையின்	பாதையின்
baathaiyilirinthu	பாதையிலிருந்து	பாதியிலிருந்து
paathaiyilirinthu	பாதையிலிருந்து	பாதியிலிருந்து
paathaiyilirunththu	பாதையிலிருந்து	பாதியிலிருந்து
paathaiyilirunthu	பாதையிலிருந்து	பாதியிலிருந்து
paathaiyum	பாதையும்	பாதையும்
bath	பாத்	பத்
beth	பாத்	பேத்
pat	பாத்	பாட்
baanarji	பானர்ஜி	பாராஜி
banerji	பானர்ஜி	பாஞர்சி
paanarji	பானர்ஜி	பாராஜி
baaba	பாபா	பாபா
baabaa	பாபா	பாபா
baba	பாபா	பாப
babaa	பாபா	பாபா
baabpaa	பாப்பா	பாப்பா
paapa	பாப்பா	பாப
paappaa	பாப்பா	பாப்பா
papa	பாப்பா	பபா
papaa	பாப்பா	பபா
pappa	பாப்பா	பப்பா
paamban	பாம்பன்	பாம்பன்
paampan	பாம்பன்	பாம்பான்
paaraattappatta	பாராட்டப்பட்ட	பாராட்டப்பட்ட
paaris	பாரிஸ்	பாரிஸ்
paeris	பாரிஸ்	பேரிஸ்
pariis	பாரிஸ்	பரிஸ்
paris	பாரிஸ்	பரிஸ்
pariss	பாரிஸ்	பரிஸ்
paarungal	பாருங்கள்	பாருங்கள்
paarungkal	பாருங்கள்	பாருங்கள்
paarunkal	பாருங்கள்	பாருங்கள்
baalan	பாலன்	பாலன்
baillon	பாலன்	பால்லோன்
bailon	பாலன்	பாலோன்
bailun	பாலன்	பைல்ல்
bailuun	பாலன்	பைலுன்
balan	பாலன்	பாலன்
ballon	பாலன்	பால்லோன்
balon	பாலன்	பாலன்
bellon	பாலன்	பெல்லோன்
belun	பாலன்	பெலுன்
paalan	பாலன்	பாலான்
palan	பாலன்	பலன்
baalu	பாலு	பாலு
balu	பாலு	பாலு
paalu	பாலு	பாலு
balaiya	பாலையா	பலையா
paalaiyaa	பாலையா	பாலையா
bhaavangalai	பாவங்களை	பாவங்களை
paavangalai	பாவங்களை	பாவங்களை
paavangkalai	பாவங்களை	பாவங்களை
paavankalai	பாவங்களை	பாவங்களை
paavaththin	பாவத்தின்	பாவத்தின்
paavaththai	பாவத்தை	பாத்தை
bhaavaththaith	பாவத்தைத்	பாவத்தைத்
paavaththaith	பாவத்தைத்	பாவத்தைத்
baavanaigal	பாவனைகள்	பாவனைகள்
bhaavanaigal	பாவனைகள்	பாவனைகள்
paavanaikal	பாவனைகள்	பாவனைகள்
paavam	பாவம்	பாவம்
pavam	பாவம்	பவம்
paavai	பாவை	பாவை
baav	பாவ்	பாவ்
paav	பாவ்	பாவ்
pav	பாவ்	பாவ்
piggu	பிக்கு	பிக்கு
pikku	பிக்கு	பிக்கு
bjb	பிஜேபி	பிப்
bjp	பிஜேபி	பாப்
pidyuuddari	பிட்யூட்டரி	பிடுடியூட்
pituitari	பிட்யூட்டரி	பிடுடிரிய்
pituitarii	பிட்யூட்டரி	படுடிடிரை
pituitary	பிட்யூட்டரி	பிட்டுயிர்
pitutari	பிட்யூட்டரி	பிடுடிரி
pitutary	பிட்யூட்டரி	பிட்டுர்
pituuitarii	பிட்யூட்டரி	படுடியூரிய்
pituuitary	பிட்யூட்டரி	படுடியோர்
pituutary	பிட்யூட்டரி	பிடுட்டர்
piththu	பித்து	பித்து
pinburaththil	பின்புறத்தில்	பின்பருத்தில்
pinpuraththil	பின்புறத்தில்	பின்புரத்தில்
pinburamulla	பின்புறமுள்ள	பின்புறுமால்
pinpuramulla	பின்புறமுள்ள	பின்புறுமாள்
pinburam	பின்புறம்	பின்பரம்
pinpuram	பின்புறம்	பின்பரம்
binvaangi	பின்வாங்கி	பின்வாங்கி
binvaangki	பின்வாங்கி	பின்வாங்கி
pinvaangi	பின்வாங்கி	பின்வாங்கி
pinvaangki	பின்வாங்கி	பின்வாங்கி
pee	பியா	பே
peea	பியா	பே
peeia	பியா	பீ
peeya	பியா	பெயா
pia	பியா	பி
piaa	பியா	பியா
piia	பியா	பியா
piiaa	பியா	பியா
piiya	பியா	பியா
piya	பியா	பியா
piyaa	பியா	பியா
pirachurankalai	பிரசுரங்களை	பிருசர்களை
pirasurangalai	பிரசுரங்களை	பிருசரங்களை
pirasurangkalai	பிரசுரங்களை	பிருசரங்களை
prachurankalai	பிரசுரங்களை	பிருச்சுகளை
pirachuramaanathu	பிரசுரமானது	பிரசுரமாதுது
pirasuramaanathu	பிரசுரமானது	பிரசுராமது
prachuramaanathu	பிரசுரமானது	பிரசுமாருதது
prasuramaanathu	பிரசுரமானது	பிரசுமாருநதத
piradhaana	பிரதான	பிரதான
pirathaana	பிரதான	பிரதான
piradhaani	பிரதானி	பிரதானி
pirathaani	பிரதானி	பிரதாதினி
piraththyeaga	பிரத்யேக	பிரத்தியாக
pirathyaeka	பிரத்யேக	பிரத்தேயாக
praththiyaeka	பிரத்யேக	பிரத்தியாக
bhrammatthin	பிரம்மத்தின்	பிரம்மாத்தின்
biramatthin	பிரம்மத்தின்	பிரமாத்தின்
pirammaththin	பிரம்மத்தின்	பிரம்மத்தின்
brammanin	பிரம்மனின்	பிரம்மனின்
pirammanin	பிரம்மனின்	பிரமமனனின்
brammanukku	பிரம்மனுக்கு	பிரமமனும்குக்
pirammanukku	பிரம்மனுக்கு	பிரமம்ணுக்கு
brahaman	பிரம்மன்	பிராமன்
brahamann	பிரம்மன்	பிராமனன்
brahhman	பிரம்மன்	பிராமன்
brahman	பிரம்மன்	பிராமன்
brahmun	பிரம்மன்	பிராமன்
brahmuun	பிரம்மன்	பிராமுன்
bramman	பிரம்மன்	பிரம்மன்
piramman	பிரம்மன்	பிரமம்ன்
brush	பிரஷ்	பிருஷ்
fresh	பிரஷ்	பிரஸ்
pirash	பிரஷ்	பிராஷ்
prash	பிரஷ்	பிராஷ்
braamanar	பிராமணர்	பிராானர்
piraamanar	பிராமணர்	பிராமானர்
praamanar	பிராமணர்	பிராமானர்
braamanargal	பிராமணர்கள்	பிராமானர்கள்
braamanarkal	பிராமணர்கள்	பிராமானர்கள்
piraamanarkal	பிராமணர்கள்	பிராமணர்கள்
praamanarkal	பிராமணர்கள்	பிராமணர்கள்
pirithadhu	பிரித்தது	பிரித்து
piriththathu	பிரித்தது	பிரித்தது
priththathu	பிரித்தது	பிரித்தது
parant	பிறந்த	பாரண்ட்
perant	பிறந்த	பெராண்ட்
piaanta	பிறந்த	பியா்டா
piraant	பிறந்த	பிராண்ட்
pirandha	பிறந்த	பிரந்த
piranta	பிறந்த	பிரண்ட
pirantha	பிறந்த	பிரந்த
pirandhadhum	பிறந்ததும்	பிரந்ததும்
piranthathum	பிறந்ததும்	பிரந்ததும்
pirandhadhai	பிறந்ததை	பிரந்ததை
piranthathai	பிறந்ததை	பிரந்ததை
pirandhavan	பிறந்தவன்	பிரந்தவன்
piranthavan	பிறந்தவன்	பிரந்தவன்
piranthaan	பிறந்தான்	பிரந்தான்
piranthaalum	பிறந்தாலும்	பிரந்தாலும்
piranthaal	பிறந்தால்	பிரந்தால்
pirarin	பிறரின்	பிரிரன்
pirarum	பிறரும்	பிருரம்
pirarai	பிறரை	பிரரை
piravum	பிறவும்	பிரவும்
pirgaalach	பிற்காலச்	பிர்கால்
pirkaalach	பிற்காலச்	பிர்கால்
pirgaalaththil	பிற்காலத்தில்	பிர்காலத்தில்
pirkaalaththil	பிற்காலத்தில்	பிர்காலத்தில்
pirpaguthi	பிற்பகுதி	பிர்பகுதி
pirpakuthi	பிற்பகுதி	பிர்பகுதி
pirpaguthiyil	பிற்பகுதியில்	பிர்பகுதியில்
pirpakuthiyil	பிற்பகுதியில்	பிர்பகுதியில்
filipinej	பிலிப்பைன்ஸ்	பிலிலிபின்
filipines	பிலிப்பைன்ஸ்	பிலிலிஸ்பி
filipinez	பிலிப்பைன்ஸ்	பிலிலிபின்
filippines	பிலிப்பைன்ஸ்	பிலிப்பிஸ்
fillipinnez	பிலிப்பைன்ஸ்	பில்லிலிப்பின்
philipines	பிலிப்பைன்ஸ்	பிலிலிப்ஸ்
philipinez	பிலிப்பைன்ஸ்	பிலிலிபின்
philipinnez	பிலிப்பைன்ஸ்	பிலிலின்பின்
philippines	பிலிப்பைன்ஸ்	பிலிப்பின்ஸ்
phillipinez	பிலிப்பைன்ஸ்	பில்லிலிப்
phillipinnej	பிலிப்பைன்ஸ்	பில்லிப்பின்
phillipinnez	பிலிப்பைன்ஸ்	பில்லிலிப்பின்
pilippains	பிலிப்பைன்ஸ்	பிலிப்பின்
pilaikkum	பிழைக்கும்	பிலைக்கும்
pizhaikkum	பிழைக்கும்	பிழைக்கும்
pilaiyaana	பிழையான	பிளையான
pizhaiyaana	பிழையான	பிழையான
bisinas	பிஸினஸ்	பிசனிஸ்
business	பிஸினஸ்	புசினஸ்
pisinas	பிஸினஸ்	பிசனிஸ்
beach	பீச்	பேச்
beaich	பீச்	பேச்
beaych	பீச்	பேச்
bech	பீச்	பேக்
beech	பீச்	பீக்
beechh	பீச்	பேச்
beich	பீச்	பெச்
beiich	பீச்	பெய்ச்
beych	பீச்	பெச்
bichh	பீச்	பிச்
biich	பீச்	பிக்
biichh	பீச்	பிச்
peach	பீச்	பேச்
pech	பீச்	பேச்
peech	பீச்	பேச்
pich	பீச்	பிச்
piich	பீச்	பிச்
fees	பீஸ்	பிஸ்
peace	பீஸ்	பேக்
peas	பீஸ்	பேஸ்
pees	பீஸ்	பீஸ்
peice	பீஸ்	பெக்
piece	பீஸ்	பிக்
pugalpetrtrathu	புகழ்பெற்றது	புகல்ப்பெற்றது
pukalpetrtrathu	புகழ்பெற்றது	புகல்பற்றித்து
pukalpettrathu	புகழ்பெற்றது	புகல்ப்பட்டு
pukazhpetrathu	புகழ்பெற்றது	புகப்பாற்து
pukazhpettrathu	புகழ்பெற்றது	புகப்பெற்றது
pugalpetrtravar	புகழ்பெற்றவர்	புகல்பெற்றவர்
pukalpetrtravar	புகழ்பெற்றவர்	புகல்ப்பெற்றார்
pukalpettravar	புகழ்பெற்றவர்	புகல்ப்பட்டர்
pukazhpetravar	புகழ்பெற்றவர்	புகப்பர்வர்
pukazhpettravar	புகழ்பெற்றவர்	புகப்பா்வர்ட்
pugalpetrtru	புகழ்பெற்று	புகல்பெற்று
pukalpetrtru	புகழ்பெற்று	புகல்பெற்று
pukalpettru	புகழ்பெற்று	புகல்ப்பெற்று
pukazhpetru	புகழ்பெற்று	புகாப்பெற்
pukazhpettru	புகழ்பெற்று	புகாப்பெற்று
bookhari	புகாரி	போகரி
bookharii	புகாரி	போகர்ி
booqhari	புகாரி	பூகரி
bukhaari	புகாரி	புகாரி
bukhaarii	புகாரி	புகாரி
bukhari	புகாரி	புகரி
bukharii	புகாரி	புகரிதி
buqhaari	புகாரி	புகாரி
buqhari	புகாரி	புகரி
buqharii	புகாரி	புகர்சி
buukhaari	புகாரி	புகாரி
buukhari	புகாரி	புகரி
buukharii	புகாரி	புகராதி
pokaari	புகாரி	போகாரி
pugaari	புகாரி	புகாரி
pukaari	புகாரி	புகாரி
pukari	புகாரி	புகரி
pujangal	புஜங்கள்	பூஜங்கள்
pujankal	புஜங்கள்	புஜங்கள்
puduchcheariyin	புதுச்சேரியின்	புடச்சியரிலின்
puthuchchaeriyin	புதுச்சேரியின்	புதுச்சிரியின்
puthucheri	புதுச்சேரியின்	புதுரசி
padanggalil	புதுப்	படங்களில்
padankalil	புதுப்	படங்களில்
patankalil	புதுப்	படங்களில்
pudhumaiyaana	புதுமையான	புதுமையான
puthumaiyaana	புதுமையான	புதுமையான
pudhuvai	புதுவை	புதுவை
puthuvai	புதுவை	புதுவை
pudhaiththa	புதைத்த	புதைத்த
puthaiththa	புதைத்த	புதைத்த
buddha	புத்த	புட்த
budhdha	புத்த	புத்த
buththa	புத்த	புத்த
puththa	புத்த	புத்த
puththam	புத்தம்	புத்தம்
buddharukku	புத்தருக்கு	புடத்துக்கு
budhdharukku	புத்தருக்கு	புத்தருக்கு
buththarukku	புத்தருக்கு	புத்தருக்கு
puththaandu	புத்தாண்டு	புத்தாண்டு
punarvaalvu	புனர்வாழ்வு	புனரவாவுள்
punarvaazhvu	புனர்வாழ்வு	புனரவாவர்
punidhargalin	புனிதர்களின்	புனிதர்களின்
punitharkalin	புனிதர்களின்	புனிதர்களின்
punae	புனே	புண
pune	புனே	புனி
punea	புனே	புனா
punee	புனே	புணி
punii	புனே	புணி
puune	புனே	பூனி
puunee	புனே	பூனி
punaeyil	புனேயில்	புணையில்
puneayil	புனேயில்	புணயில்
puneiyl	புனேயில்	புணிய்ல்
puneyil	புனேயில்	புணியில்
punaevil	புனேவில்	புணவில்
puneavil	புனேவில்	புணவில்
punevil	புனேவில்	புணவில்
ciripputan	புன்	சிறிப்புட்டன்
pan	புன்	பான்
pon	புன்	போன்
pun	புன்	புன்
puun	புன்	புன்
sirippudan	புன்	சிறிப்புடன்
purandu	புரண்டு	புரண்டு
puravi	புரவி	புரவி
kollaa	புரிந்து	கொள்ளா
kollaalaam	புரிந்து	கொள்ளாாாம்
kollaatha	புரிந்து	கொள்ளாத
kollaavum	புரிந்து	கொள்ளாவும்
kollalaam	புரிந்து	கொள்ளாாம்
kollalam	புரிந்து	கொள்ளாம்
kollata	புரிந்து	கொல்லாத
kollavum	புரிந்து	கொள்ளவும்
puribavargal	புரிபவர்கள்	புறிபர்கள்
puriyum	புரியும்	புரியும்
purivadhai	புரிவதை	புரிவதை
purivathai	புரிவதை	புரிவதை
puruva	புருவ	புருவ
puruvam	புருவம்	புருவம்
pulampeyar	புலம்பெயர்	புலம்பாய்
pulavargalaal	புலவர்களால்	புலவர்களால்
pulavarkalaal	புலவர்களால்	புவலர்களால்
pulavargalin	புலவர்களின்	புளவர்களின்
pulavarkalin	புலவர்களின்	புளவர்களின்
pulavargalil	புலவர்களில்	புவலர்களில்
pulavarkalil	புலவர்களில்	புவலர்களில்
pulavargalukku	புலவர்களுக்கு	புவளர்களுக்கு
pulavarkalukku	புலவர்களுக்கு	புவளர்களுக்கு
pulavargalum	புலவர்களும்	புளவர்களும்
pulavarkalum	புலவர்களும்	புளவர்களும்
bulet	புல்லட்	புல்ட்
bullat	புல்லட்	புள்ளாட்
bullet	புல்லட்	புல்லிட்
buulet	புல்லட்	பால்ட்
buullet	புல்லட்	புல்லிட்
pullad	புல்லட்	புள்ளாட்
pullat	புல்லட்	புள்ளா
blue	புளூ	பிலு
puloo	புளூ	புலோ
puluu	புளூ	புழு
puvikku	புவிக்கு	புவிக்கு
puviyin	புவியின்	புவியின்
puviyil	புவியில்	புவியில்
bushkar	புஷ்கர்	புஷ்கர்
pushkar	புஷ்கர்	புச்கர்
puskar	புஷ்கர்	புச்கர்
pusqar	புஷ்கர்	புஸ்கர்
puuskar	புஷ்கர்	புச்கர்
pooshkin	புஷ்கின்	போஸ்கின்
pooskin	புஷ்கின்	போஸ்கின்
poosqin	புஷ்கின்	போஸ்கின்
pushkeen	புஷ்கின்	புச்கின்
pushkin	புஷ்கின்	புச்கின்
pushkinn	புஷ்கின்	புச்கின்
puskeen	புஷ்கின்	புக்கின்
puskiin	புஷ்கின்	புச்கின்
puskin	புஷ்கின்	புக்கின்
puskinn	புஷ்கின்	புஸ்கின்
pusqeen	புஷ்கின்	புக்கின்
pusqin	புஷ்கின்	புக்கின்
pusqinn	புஷ்கின்	புஸ்கின்
puuskeen	புஷ்கின்	புக்கின்
puuskin	புஷ்கின்	புச்கின்
puuskinn	புஷ்கின்	பூஸ்கின்
bookambam	பூகம்பம்	பூக்கம்ம்
poogambam	பூகம்பம்	பூகம்பம்
pookambam	பூகம்பம்	பூகம்பம்
puukambam	பூகம்பம்	பூகம்பம்
puukampam	பூகம்பம்	பூகம்பம்
poojya	பூஜ்ய	பூஜ்யா
puujya	பூஜ்ய	பூஜியா
poojyam	பூஜ்யம்	பூஜ்யம்
puujiyam	பூஜ்யம்	பூசியம்
puujyam	பூஜ்யம்	பூஜ்யம்
poonagari	பூநகரி	போனகரி
poonakari	பூநகரி	போனகரி
puunagari	பூநகரி	பூனகரி
puunakari	பூநகரி	புணகரி
poonaigalai	பூனைகளை	போனைகளை
poonaikalai	பூனைகளை	போனைகளை
puunaigalai	பூனைகளை	புணைகளை
puunaikalai	பூனைகளை	புணைகளை
poonaigal	பூனைகள்	போனைகள்
poonaikal	பூனைகள்	போனைகள்
puunaigal	பூனைகள்	புணைகள்
puunaikal	பூனைகள்	புணைகள்
poonaiyai	பூனையை	போனையை
poonaiyei	பூனையை	போனையை
poorna	பூர்ணா	பூர்னா
poornaa	பூர்ணா	பூர்னா
puurnaa	பூர்ணா	புர்ான
poolae	பூலே	போல்
puulae	பூலே	பூலை
poolai	பூளை	போலை
puulai	பூளை	புலை
pennukku	பெண்ணுக்கு	பென்குக்கு
pennnudan	பெண்ணுடன்	பென்னாட்டன்
pennudan	பெண்ணுடன்	பென்டுண்ட்
pennum	பெண்ணும்	பென்மும்
penmani	பெண்மணி	பென்மானி
penmanigal	பெண்மணிகள்	பென்மாயிக்
penmanikal	பெண்மணிகள்	பென்மையங்கள்
penmaniyaaga	பெண்மணியாக	பென்மாயாயக
penmaniyaaka	பெண்மணியாக	பென்மையாக
penmaniyin	பெண்மணியின்	பென்மானியின்
penmaniyum	பெண்மணியும்	பென்மாயியும்
peyarum	பெயரும்	பெயரும்
peyarchchi	பெயர்ச்சி	பெயர்ச்சி
periyavan	பெரியவன்	பெரியாவன்
periyavar	பெரியவர்	பெரியவர்
periyavargalukku	பெரியவர்களுக்கு	பெரியவற்களுக்கு
periyavargal	பெரியவர்கள்	பெரியவர்கள்
periyavai	பெரியவை	பெரியைய
periyoar	பெரியோர்	பெரியோர்
periyor	பெரியோர்	பெரியோர்
perugiya	பெருகிய	பெருகிய
perukiya	பெருகிய	பெருகிய
perumidham	பெருமிதம்	பெருமிதம்
perumitham	பெருமிதம்	பெருமிதம்
bart	பெர்ட்	பார்ட்
bert	பெர்ட்	பெர்ட்
paerd	பெர்ட்	பேர்ட்
bay	பே	பா
bee	பே	பீ
beei	பே	பீ
bei	பே	பே
beii	பே	பெய்
faie	பே	பே
faye	பே	பேய்
fayee	பே	பேயி
pee	பே	பே
phaye	பே	பேய்
paechupavar	பேசுபவர்	பேசுபார்
paesubavar	பேசுபவர்	பேசப்பர்
pesupavar	பேசுபவர்	பெசுபார்
paenalgal	பேனல்கள்	பேணல்கள்
paenalkal	பேனல்கள்	பேணல்கள்
peanalkal	பேனல்கள்	பெணல்கள்
penalkal	பேனல்கள்	பென்லகள்
paep	பேப்	பேப்
pap	பேப்	பப்
peap	பேப்	பேப்
peep	பேப்	பீப்
pep	பேப்	பெப்
bearaasiriyarin	பேராசிரியரின்	பாராரியிரின்
paeraasiriyarin	பேராசிரியரின்	பாரரியிரினின்
pearaasiriyarin	பேராசிரியரின்	பாராரியிரின்
paerunthil	பேருந்தில்	பேருந்தில்
pearunthil	பேருந்தில்	பெருந்தில்
perunthil	பேருந்தில்	பெருந்தில்
beal	பேல்	பேல்
bel	பேல்	பெல்
pael	பேல்	பேல்
pel	பேல்	பெல்
bealai	பேழை	பேலை
paelai	பேழை	பேலை
pelai	பேழை	பெலை
pezhai	பேழை	பேழை
paelaiyil	பேழையில்	பேலையில்
paezhaiyil	பேழையில்	பேழையில்
pezhaiyil	பேழையில்	பெழையில்
paigalai	பைகளை	பைகளை
paikalai	பைகளை	பைகளை
podhunala	பொதுநல	பொதுனா
pothunala	பொதுநல	பொதுனா
podhuvudamai	பொதுவுடமை	பொதுவுடைய
pothuvudamai	பொதுவுடமை	பொதுவுடைய
ponnai	பொன்னை	பொன்னை
pori	பொரி	போரி
porikkum	பொரிக்கும்	போரிக்கும்
poriththa	பொரித்த	பொரித்த
ubayoagangkal	பொருட்கள்	உபோயங்கள்
ubayoakangkal	பொருட்கள்	உபோயகங்கள்
upayokankal	பொருட்கள்	உபயக்கங்கள்
poruththappatta	பொருத்தப்பட்ட	பொருத்தப்பட்ட
poruththappattulla	பொருத்தப்பட்டுள்ள	பொருத்தப்பட்டுள்ள
poruththappatulla	பொருத்தப்பட்டுள்ள	பொருத்தப்பட்டுள்ள
porundhakkoodiya	பொருந்தக்கூடிய	பொருந்தோக்கிடோய்
porundhdhakkoodiya	பொருந்தக்கூடிய	பொருந்தோக்கிட்டோ
porunthakkoodiya	பொருந்தக்கூடிய	பொருந்தோக்கோடிய
porundhaadha	பொருந்தாத	பொருந்தா
porundhdhaadha	பொருந்தாத	பொருந்ததா
porunthaatha	பொருந்தாத	பொருந்தா
porundhum	பொருந்தும்	பொருந்தும்
porunthum	பொருந்தும்	பொருந்தும்
porulaagavea	பொருளாகவே	பொருளாாக
porulaakavae	பொருளாகவே	பொருளாாகவே
porulukku	பொருளுக்கு	பொருளுக்கு
porulukkum	பொருளுக்கும்	பொருளுக்கும்
poraamaiyum	பொறாமையும்	போரைமையும்
poriththa	பொறித்த	பொரித்த
porimuraiyil	பொறிமுறையில்	பொரிமுறையில்
poriyiyal	பொறியியல்	போரியியல்
poruththa	பொறுத்த	பொருத்த
poruththal	பொறுத்தல்	பொருத்தல்
poruththae	பொறுத்தே	பொருத்தே
poruththe	பொறுத்தே	பொருத்தே
poruththea	பொறுத்தே	பொருத்தே
poruppaettraar	பொறுப்பேற்றார்	பொறுப்பெற்றா்
poruppetraar	பொறுப்பேற்றார்	பொறுப்பர்ர்்
poruppettraar	பொறுப்பேற்றார்	பொறுப்பெற்றா்
porupeattrullar	பொறுப்பேற்றுள்ளார்	பூறுபெற்றுள்ளார்
poruppaettrullaar	பொறுப்பேற்றுள்ளார்	பொறுப்பெற்றுள்ளார்
poruppetrullaar	பொறுப்பேற்றுள்ளார்	பொறுப்பெர்ள்ளார்
poakka	பொழுது	போக்க
poluthu	பொழுது	பொழுத்து
pozhudhu	பொழுது	பொழுது
pozhuthu	பொழுது	பொழுத்து
poluthupokkukku	பொழுதுபோக்குக்கு	பொழுத்துள்குக்கு
poluthupookkukku	பொழுதுபோக்குக்கு	பொலுதுத்புக்குக்கு
pozhudhupoakkuk	பொழுதுபோக்குக்கு	பொழுதுப்பக்க்க்
baus	பொஸ்	பாஸ்
bauus	பொஸ்	பாஸ்
bos	பொஸ்	பாஸ்
boss	பொஸ்	போஸ்
bous	பொஸ்	போஸ்
bouus	பொஸ்	போஸ்
paoos	பொஸ்	போஸ்
bogach	போகச்	போக்க்
poagach	போகச்	போக்க்
pogach	போகச்	போக்க்
pokach	போகச்	போக்க்
poagath	போகத்	போகத்
pogath	போகத்	போகத்
pokath	போகத்	போகத்
bhoagam	போகம்	போகம்
boagam	போகம்	போகம்
bogam	போகம்	போகம்
bhoagar	போகர்	போகர்
boagar	போகர்	போகர்
bogar	போகர்	போகர்
poagavae	போகவே	போகவே
poagavea	போகவே	போகவே
pogave	போகவே	போகவே
poagaamal	போகாமல்	போகாமல்
poakkaaga	போக்காக	போக்காக
poakkaaha	போக்காக	போக்கா
poakkuvaraththin	போக்குவரத்தின்	போக்குவத்தின்
poakkuvaraththirku	போக்குவரத்திற்கு	போக்குவதற்கிறது
boassu	போசு	போச்
poasu	போசு	போசு
boadi	போடி	போடி
poadi	போடி	போடி
poattigalin	போட்டிகளின்	போட்டிகளின்
poattikalin	போட்டிகளின்	போட்டிகளின்
poattigalilum	போட்டிகளிலும்	போட்டிகளிலும்
poattikalilum	போட்டிகளிலும்	போட்டிகளிலும்
poattigalil	போட்டிகளில்	போட்டிகளில்
poattikalil	போட்டிகளில்	போட்டிகளில்
poattigalukkaana	போட்டிகளுக்கான	போட்டிக்களைக்
poattikalukkaana	போட்டிகளுக்கான	போட்டிக்களைக்க
poattigalukku	போட்டிகளுக்கு	போட்டிகளுக்கு
poattikalukku	போட்டிகளுக்கு	போட்டிகளுக்கு
poattigalum	போட்டிகளும்	போட்டிகளும்
poattigalaiyuim	போட்டிகளையும்	போட்டியைகளையும்
poattigalaiyum	போட்டிகளையும்	போட்டியகளையும்
poattikalaiyum	போட்டிகளையும்	போட்டியகளையும்
poattigal	போட்டிகள்	போட்டிகள்
poattikal	போட்டிகள்	போட்டிகள்
poattikku	போட்டிக்கு	போட்டிக்கு
poattith	போட்டித்	போட்டித்
tervil	போட்டித்	தெர்வில்
thaervil	போட்டித்	தேர்வில்
poattiyaaga	போட்டியாக	போட்டியாக
poattiyaaka	போட்டியாக	போட்டியாக
poattiyaalarkalin	போட்டியாளர்களின்	போட்டியல்களின்
poattiyalargalin	போட்டியாளர்களின்	போட்டியலிலர்கின்
poattiyaalargalai	போட்டியாளர்களை	போட்டியலாளர்கள்
poattiyaalarkalai	போட்டியாளர்களை	போட்டியாளர்களை
poattiyilirindhu	போட்டியிலிருந்து	போட்டியிலிருந்து
poattiyilirunthu	போட்டியிலிருந்து	போட்டியிலிருந்து
poattiyum	போட்டியும்	போட்டியும்
poattiayai	போட்டியை	போட்டையி
poattiyai	போட்டியை	போட்டியை
poattiyei	போட்டியை	போட்டியி
poattiyaith	போட்டியைத்	போட்டையில்
poattiyeith	போட்டியைத்	போட்டியிய்
poathellaam	போதெல்லாம்	போதல்லால்
poandrathu	போன்றது	போன்றது
poantrathu	போன்றது	போன்றது
poandravar	போன்றவர்	போன்றவர்
poantravar	போன்றவர்	போன்றவர்
poandravarkalukku	போன்றவர்களுக்கு	போன்றவற்குகளு
poantravargalukku	போன்றவர்களுக்கு	போன்றவற்குகளு
poantravarkalukku	போன்றவர்களுக்கு	போன்றவற்குகளு
poandravarkal	போன்றவர்கள்	போன்றவர்கள்
poanravarkal	போன்றவர்கள்	போன்றவர்கள்
poantravargal	போன்றவர்கள்	போன்றவர்கள்
poantravarkal	போன்றவர்கள்	போன்றவர்கள்
poandrum	போன்றும்	போன்றும்
poanrum	போன்றும்	போன்றும்
poantrum	போன்றும்	போன்றும்
poandrae	போன்றே	போன்றே
poanrae	போன்றே	போன்றே
poantrae	போன்றே	போன்றே
bauing	போயிங்	பாய்க்
bauuing	போயிங்	பூயங்
boaing	போயிங்	போய்்
boaying	போயிங்	போயிங்
boeengs	போயிங்	பெங்க்
boeing	போயிங்	பெய்ஸ்
boiings	போயிங்	போயிங்ஸ்
boing	போயிங்	போய்க்
booeengs	போயிங்	போன்ஸ்
booeing	போயிங்	போய்
poaying	போயிங்	போயிங்
poayina	போயின	போயின
poyina	போயின	போயின
poarkkaala	போர்க்கால	போர்க்கால
poarkkaalaththil	போர்க்காலத்தில்	போர்க்களத்தில்
board	போர்ட்	பார்ட்
ford	போர்ட்	பார்ட்
poard	போர்ட்	போர்ட்
poart	போர்ட்	போர்ட்
poord	போர்ட்	போர்ட்
poort	போர்ட்	போர்ட்
port	போர்ட்	பார்ட்
poalak	போலக்	போலக்
polak	போலக்	போலக்
poalirukkum	போலிருக்கும்	போலிருக்கும்
polirukkum	போலிருக்கும்	பொலிருக்கும்
poalum	போலும்	போலம்
polum	போலும்	பொழும்
bole	போலே	பாலி
bolee	போலே	பாலி
boole	போலே	போலி
fole	போலே	பாலி
folee	போலே	போலி
foleey	போலே	பாலியி
folei	போலே	பாலி
foley	போலே	பாலி
foli	போலே	பாலி
folii	போலே	போலி
foole	போலே	போலி
foolee	போலே	போலி
fooley	போலே	போலி
fooli	போலே	போலி
foolii	போலே	போலி
phole	போலே	போலி
pholee	போலே	போலி
pholey	போலே	பாலிய்
pholi	போலே	போலி
pholii	போலே	போலி
poalae	போலே	போல
poale	போலே	போல்
polae	போலே	போல்
poolee	போலே	போலி
magalaai	மகளாய்	மகாலை
magalaay	மகளாய்	மகாலய
makalaai	மகளாய்	மகாலை
makalaay	மகளாய்	மகாலைய்
magalaiyum	மகளையும்	மகளையும்
makalaiyum	மகளையும்	மகளையும்
magaaraajan	மகாராஜன்	மகாராஜன்
mahaaraajan	மகாராஜன்	மாாராஜான்
maharajan	மகாராஜன்	மகராஜன்
makaaraajan	மகாராஜன்	மகாராஜன்
magaalingam	மகாலிங்கம்	மாகல்கினம்
magaalingkam	மகாலிங்கம்	மாகல்கிங்கம்
mahalingam	மகாலிங்கம்	மாலகிங்ம்
makaalingam	மகாலிங்கம்	மாகாலின்கம்
makaalingkam	மகாலிங்கம்	மாகல்கிங்கம்
magaal	மகால்	மகால்
mahal	மகால்	மால்
makaal	மகால்	மகால்
magimai	மகிமை	மகிமை
makimai	மகிமை	மகிமை
magilchchiyai	மகிழ்ச்சியை	மகிழ்ச்சியை
makilchchiyai	மகிழ்ச்சியை	மகில்ச்சியை
makizhchchiyai	மகிழ்ச்சியை	மகிழ்ச்சியை
magilchchiyaiyum	மகிழ்ச்சியையும்	மகில்ச்சியியும்
makilchchiyaiyum	மகிழ்ச்சியையும்	மகில்ச்சியியும்
makizhchchiyaiyum	மகிழ்ச்சியையும்	மாிக்ச்சியையும்
magilchchiyoadu	மகிழ்ச்சியோடு	மகில்ச்சியோடு
makilchchiyoadu	மகிழ்ச்சியோடு	மகில்ச்சியோடு
makizhchchiyoadu	மகிழ்ச்சியோடு	மகிழ்ச்சியோடு
maheshvari	மகேஸ்வரி	மாசேவரி
maheswari	மகேஸ்வரி	மாஸ்வரி
makaesvari	மகேஸ்வரி	மகேஸ்வரி
makkiya	மக்கிய	மக்கிய
maggum	மக்கும்	மக்கும்
makkum	மக்கும்	மக்கும்
machuuthi	மசூதி	மாசுதி
masoodi	மசூதி	மாசோடி
masoothi	மசூதி	மசோதி
masuthi	மசூதி	மாசுதி
masuuthi	மசூதி	மசுதி
machuuthiukal	மசூதிகள்	மசுதிகுகள்
masoothigal	மசூதிகள்	மசோதிகள்
masoothikal	மசூதிகள்	மசோதிகள்
masuthigal	மசூதிகள்	மசுதிகள்
masuuthigal	மசூதிகள்	மசுதிகள்
machuuthiyil	மசூதியில்	மாசுதியில்
masoothiyil	மசூதியில்	மாசதியில்
masuthiyil	மசூதியில்	மாசுதியில்
masuuthiyil	மசூதியில்	மசுதியில்
madanthai	மடந்தை	மடந்தை
matanthai	மடந்தை	மடன்தை
madaalayam	மடாலயம்	மடாலாம்
mataalayam	மடாலயம்	மாடாலயம்
mattumae	மட்டுமே	மட்டுமே
manakka	மணக்க	மகன்க
manakkaal	மணக்கால்	மகங்கால்
manappathu	மணப்பது	மனப்பது
manamurivu	மணமுறிவு	மனமுறிவு
maninaera	மணிநேர	மனினேரா
maninera	மணிநேர	மனினே
maninaerangal	மணிநேரங்கள்	மனினேரங்கள்
maninaeranggal	மணிநேரங்கள்	மனினேரங்கள்
maninerangkal	மணிநேரங்கள்	மனினேரங்கள்
maninaeraththirku	மணிநேரத்திற்கு	மனிநாரித்திற்கு
manineraththirku	மணிநேரத்திற்கு	மனிநரித்திற்கு
maninaeram	மணிநேரம்	மனினரமம்
manineram	மணிநேரம்	மனினரமம்
manimuththaaru	மணிமுத்தாறு	மனிமுத்துறா
manimuththaru	மணிமுத்தாறு	மனிமுறத்து
manneeral	மண்ணீரல்	மன்னேரல்
manneeril	மண்ணீரல்	மன்னேரில்
madhar	மதர்	மதார்
mathar	மதர்	மதர்
mother	மதர்	மாத்ர்
madhurakavi	மதுரகவி	மதுரகவி
madurakavi	மதுரகவி	மடுரகவி
mathurakavi	மதுரகவி	மதுரகவி
maddhiyath	மத்தியத்	மதித்திய
maththiyath	மத்தியத்	மத்தியத்
mandhamaaga	மந்தமாக	மந்தாமக
manthamaaga	மந்தமாக	மந்தாமாக
manthamaaka	மந்தமாக	மந்தாமக
mandhar	மந்தர்	மந்தர்
manthar	மந்தர்	மந்தர்
manaaluththam	மனஅழுத்தம்	மாலந்துதம்
manaalzhuththam	மனஅழுத்தம்	மாலந்துத்தில்
manaazhuththam	மனஅழுத்தம்	மாநாழுத்தம்
manathoadu	மனதோடு	மகநோடு
manappaadam	மனப்பாடம்	மானப்பாம்
manam	மனம்	மானம்
manaigalil	மனைகளில்	மணைகளில்
manaikalil	மனைகளில்	மணைகளில்
manaiyil	மனையில்	மணையில்
mannarai	மன்னரை	மன்னாரை
marakkattai	மரக்கட்டை	மரக்கட்டை
marakattaigalai	மரக்கட்டைகளை	மரகட்டைகளை
marakkattaikalai	மரக்கட்டைகளை	மரக்கடைக்கைலை
maraththinaal	மரத்தினால்	மரத்தினால்
maraththin	மரத்தின்	மரத்தின்
marabuvali	மரபுவழி	மரபுவலில்
marabuvazhi	மரபுவழி	மரபுவிி
maravalli	மரவள்ளி	மராளவில்
mariyannai	மரியன்னை	மரியனை
mariina	மரீனா	மரினா
mariinaa	மரீனா	மரியான
marina	மரீனா	மரினா
marinaa	மரீனா	மரினா
maru	மரு	மரு
marukkal	மருக்கள்	மருக்கள்
maruththuvamanaigalukku	மருத்துவமனைகளுக்கு	மருத்துவைகளுக்கும்
maruththuvamanaikalukku	மருத்துவமனைகளுக்கு	மருத்துவைகளுக்கும்
maruththuvamanaikku	மருத்துவமனைக்கு	மருத்துவதுக்ககம்
maruththuvamanaiyaaga	மருத்துவமனையாக	மருத்துவதாயகமா
maruththuvamanaiyaaka	மருத்துவமனையாக	மருத்துவதாயாக
maruththuvamanaiyin	மருத்துவமனையின்	மருத்துவதியமைன்
maruththuvamanaiyil	மருத்துவமனையில்	மருத்துவதியமையில்
marundhae	மருந்தே	மருந்தே
marunthae	மருந்தே	மருந்தே
marunththae	மருந்தே	மருந்தே
marukkappatta	மறுக்கப்பட்ட	மருக்கப்பட்ட
marukkum	மறுக்கும்	மருக்கும்
maraivaal	மறைவால்	மறைவால்
matravar	மற்றவர்	மற்றவர்
matrtravar	மற்றவர்	மற்றவர்
mattravar	மற்றவர்	மற்றவர்
matravargalaal	மற்றவர்களால்	மற்றவர்களால்
matrtravargalaal	மற்றவர்களால்	மற்றவர்களால்
matrtravarkalaal	மற்றவர்களால்	மற்றவற்களால்
mattravarkalaal	மற்றவர்களால்	மற்றவர்களால்
matravargalukku	மற்றவர்களுக்கு	மற்றவர்களுக்கு
matrtravargalukku	மற்றவர்களுக்கு	மற்றவற்குகளுக்
matrtravarkalukku	மற்றவர்களுக்கு	மற்றவற்குகளுக்
mattravarkalukku	மற்றவர்களுக்கு	மற்றவற்குகளுக்
matravargalukkum	மற்றவர்களுக்கும்	மற்றவர்களுக்கும்
matrtravargalukkum	மற்றவர்களுக்கும்	மற்றவற்குகளும்
matrtravarkalukkum	மற்றவர்களுக்கும்	மற்றவற்குகளும்
mattravarkalukkum	மற்றவர்களுக்கும்	மற்றவற்குகளும்
matravargaludan	மற்றவர்களுடன்	மற்றவர்களுடன்
matrtravargaludan	மற்றவர்களுடன்	மற்றவற்களுடன்
matrtravarkaludan	மற்றவர்களுடன்	மற்றவற்களுடன்
mattravarkaludan	மற்றவர்களுடன்	மற்றவற்களுடன்
matravargalai	மற்றவர்களை	மற்றவர்களை
matrtravargalai	மற்றவர்களை	மற்றவற்களை
matrtravarkalai	மற்றவர்களை	மற்றவற்களை
mattravarkalai	மற்றவர்களை	மற்றவற்களை
matravargalaip	மற்றவர்களைப்	மற்றவர்களை
matrtravargalaip	மற்றவர்களைப்	மற்றவர்களைப்
matrtravarkalaip	மற்றவர்களைப்	மற்றவர்களைப்
mattravarkalaip	மற்றவர்களைப்	மற்றவர்களைப்
malattu	மலட்டு	மலட்டு
malarin	மலரின்	மாளரின்
malaril	மலரில்	மாளரில்
malarai	மலரை	மலைரை
indraiya	மலர்	இந்றிய
inraiya	மலர்	இன்றைய
intraiya	மலர்	இந்றிய
malargalaal	மலர்களால்	மல்லகாலல்
malarkalaal	மலர்களால்	மல்றகளால்
malargalin	மலர்களின்	மலர்களின்
malarkalin	மலர்களின்	மலர்களின்
malargalai	மலர்களை	மல்களை
malarkalai	மலர்களை	மல்றகளை
malargal	மலர்கள்	மல்களர்
malarkal	மலர்கள்	மல்களர்
malivaaga	மலிவாக	மலிவாக
malivaaka	மலிவாக	மலிவாக
maadangal	மாடங்கள்	மாடங்கள்
maadangkal	மாடங்கள்	மாடங்கள்
maatangkal	மாடங்கள்	மாடங்கள்
maadaththil	மாடத்தில்	மாதத்தில்
maataththil	மாடத்தில்	மாடத்தில்
maadam	மாடம்	மாடம்
maatam	மாடம்	மாட்டம்
maanikkak	மாணிக்கக்	மாணிக்க்
manickkak	மாணிக்கக்	மிங்கிக்க்
maan	மாண்	மான்
maann	மாண்	மான்
maadhiriyaaga	மாதிரியாக	மாதிரியாக
maadhiriyaaka	மாதிரியாக	மாதிரியாக
maathiriyaaga	மாதிரியாக	மாதிரியாக
maathiriyaaka	மாதிரியாக	மாதிரியாக
maarkandaeya	மார்க்கண்டேய	மார்க்காடியே
maarkkandaeya	மார்க்கண்டேய	மார்க்காட்யே
markandeya	மார்க்கண்டேய	மார்காட்டியா
markkandaeya	மார்க்கண்டேய	மார்க்காடிய
maarkkandaeyan	மார்க்கண்டேயன்	மார்க்காண்டியன்
markandeyan	மார்க்கண்டேயன்	மார்காண்டியன்
maarban	மார்பன்	மார்பான்
maarpin	மார்பன்	மார்பின்
maarbil	மார்பில்	மார்பில்
maarpil	மார்பில்	மாற்பில்
maaraagak	மாறாகக்	மாறகக்
maaraakak	மாறாகக்	மாறகக்
maaraagath	மாறாகத்	மாராத்
maaraakath	மாறாகத்	மாராகத்
maattramadaintha	மாற்றமடைந்து	மாற்றமையத்த
maattramadainthu	மாற்றமடைந்து	மாற்றமையது
mattramadaindhu	மாற்றமடைந்து	மற்றமையடுது
maattru	மாற்று	மாற்று
maatrtruk	மாற்றுக்	மாற்றுக்
maattruk	மாற்றுக்	மாற்றுக்
maattruch	மாற்றுச்	மாற்றுச்
maatrum	மாற்றும்	மாற்றும்
maattrum	மாற்றும்	மாற்றும்
maalaimurasu	மாலைமுரசு	மாலமுறைசு
malaimurasu	மாலைமுரசு	மலைமுறாசு
maalaiyilum	மாலையிலும்	மாலையிலும்
maalaiyil	மாலையில்	மாலையில்
maalaiyaiyum	மாலையையும்	மாலையையும்
maaligai	மாளிகை	மாலிகை
maalikai	மாளிகை	மாளிகை
maaligaigal	மாளிகைகள்	மாளிகளைக்
maalikaikal	மாளிகைகள்	மாளிகளைக்
maaligaikkul	மாளிகைக்குள்	மாளிகளிக்கு
maalikaikkul	மாளிகைக்குள்	மாளிகளக்கு
maaligaiyin	மாளிகையின்	மாளிகையின்
maalikaiyin	மாளிகையின்	மாளிகையின்
maaligaiyai	மாளிகையை	மாளிகையை
maalikaiyai	மாளிகையை	மாளிகையை
maavilakku	மாவிளக்கு	மாவிலக்கு
maavoa	மாவோ	மாவோ
maavoo	மாவோ	மாவோ
mao	மாவோ	மா
maoo	மாவோ	மோ
maoow	மாவோ	மோவா
maov	மாவோ	மாவ்
maow	மாவோ	மாவ்
mau	மாவோ	மா
mavoo	மாவோ	மோவோ
maavoavin	மாவோவின்	மாவாவின்
maavoovin	மாவோவின்	மாவோவின்
maasgoa	மாஸ்கோ	மாக்கோ
maaskoa	மாஸ்கோ	மாஸ்கோ
maaskoo	மாஸ்கோ	மாக்கோ
maskoo	மாஸ்கோ	மக்கோ
moosccoov	மாஸ்கோ	மூச்சோட்
mooscoo	மாஸ்கோ	மோசோ
mooscoow	மாஸ்கோ	மூச்சோ
mosccov	மாஸ்கோ	மாஸ்கோ
mosccow	மாஸ்கோ	மோச்சோ
moscoo	மாஸ்கோ	மோசோ
moscov	மாஸ்கோ	மோஸ்க்
moscow	மாஸ்கோ	மோஸ்கோ
moscu	மாஸ்கோ	மோச்கு
maaskoavil	மாஸ்கோவில்	மாஸ்கோவில்
maaskoovil	மாஸ்கோவில்	மாக்கோலிவில்
massgoavil	மாஸ்கோவில்	மச்சோகில்
moscowil	மாஸ்கோவில்	மாஸ்டில்
mikka	மிக்க	மிக்க
mikkadhaaga	மிக்கதாக	மிக்கதாக
mikkathaaka	மிக்கதாக	மிக்கதாக
mikku	மிக்கு	மிக்கு
michchigan	மிச்சிகன்	மிச்சிக்
michigan	மிச்சிகன்	மிகிசன்
midhakkum	மிதக்கும்	மிதக்கும்
mithakkum	மிதக்கும்	மிதக்கும்
midhappu	மிதப்பு	மிதப்பு
mithappu	மிதப்பு	மிதப்பு
midhavaadha	மிதவாத	மிதாவத
mithavaatha	மிதவாத	மிதாவதா
midhilai	மிதிலை	மிதிலை
mithilai	மிதிலை	மிதிலை
miyaanmar	மியான்மர்	மியான்மர்
myanmar	மியான்மர்	மான்யம்
meov	மியாவ்	மேவ்
meow	மியாவ்	மேவா
mev	மியாவ்	மே
meva	மியாவ்	மே
mew	மியாவ்	மே
mewa	மியாவ்	மே
meyaavu	மியாவ்	மெயாவு
miev	மியாவ்	மீவ்
miew	மியாவ்	மீவ்
miyaav	மியாவ்	மியாவ்
miyav	மியாவ்	மியாவ்
mirsaa	மிர்ஸா	மிர்சா
mirshaa	மிர்ஸா	மிர்சா
mirzaa	மிர்ஸா	மிர்சா
milagu	மிளகு	மிலகு
milaku	மிளகு	மிலகு
mee	மீ	மே
mie	மீ	மீ
mii	மீ	மி
miie	மீ	மீ
meenavargalin	மீனவர்களின்	மேனவர்களின்
meenavarkalin	மீனவர்களின்	மேனவர்களின்
meenavargal	மீனவர்கள்	மேனவர்கள்
meenavarkal	மீனவர்கள்	மேனவர்கள்
meena	மீனா	மீனா
meenaa	மீனா	மேனா
mena	மீனா	மேனா
miina	மீனா	மினா
miinaa	மீனா	மினா
mina	மீனா	மினா
meengalil	மீன்களில்	மெங்களில்
meenkalil	மீன்களில்	மெங்களில்
meengalum	மீன்களும்	மெங்களும்
meenkalum	மீன்களும்	மென்களும்
meengalai	மீன்களை	மெங்களை
meenkalai	மீன்களை	மென்களை
meengalaik	மீன்களைக்	மெங்களைக்
meenkalaik	மீன்களைக்	மென்களைக்
meara	மீரா	மேரா
meera	மீரா	மேரா
meeraa	மீரா	மேரா
meiira	மீரா	மெயர்
meira	மீரா	மேற்
miira	மீரா	மிரா
miiraa	மீரா	மிறா
mira	மீரா	மிரா
miraa	மீரா	மிரா
meeraan	மீரான்	மேரான்
meeran	மீரான்	மேரன்
meelaad	மீலாத்	மேலாட்
meelaath	மீலாத்	மேலாத்
mugam	முகம்	முகம்
mukam	முகம்	முகம்
thaan	முகம்	தான்
muguntha	முகுந்த	முகுந்த
mukunda	முகுந்த	முகுண்ட
mukundha	முகுந்த	முகுந்த
mukundhdha	முகுந்த	முகுந்த
mukuntha	முகுந்த	முகுந்த
thiruththum	முடி	திருத்தும்
tiruttum	முடி	திருட்டும்
mudigaludan	முடிகளுடன்	முடிகளுடன்
mudikaludan	முடிகளுடன்	முடிகளுடன்
mudigalum	முடிகளும்	முடிகளும்
mudikalum	முடிகளும்	முடிகளும்
mudigalai	முடிகளை	முடிகளை
mudikalai	முடிகளை	முடிகளை
mudigal	முடிகள்	முடிகள்
mudikal	முடிகள்	முடிகள்
boadhu	முடிக்கும்	போது
poadhu	முடிக்கும்	போது
poathu	முடிக்கும்	போது
potu	முடிக்கும்	போட்டு
mudindhdhana	முடிந்தன	முடிந்தன
mudinthana	முடிந்தன	முடிந்தன
mudiyaamal	முடியாமல்	முடியாலம்
mudiyaamai	முடியாமை	முடியாமை
mudiyin	முடியின்	முடியின்
mudiyil	முடியில்	முடியில்
mudiyai	முடியை	முடியை
mudivadaiyum	முடிவடையும்	முடையவடும்
mudivin	முடிவின்	முடிவின்
mudivilum	முடிவிலும்	முடிவிலும்
mudivae	முடிவே	முடிவே
muthanilai	முதனிலை	முதனிலை
muthalamaichchar	முதலமைச்சர்	முதலமைச்சர்
muthalamaichchargal	முதலமைச்சர்கள்	முதலைச்சர்கள்
muthalamaichcharkal	முதலமைச்சர்கள்	முதலைச்சர்கள்
muthaluthavi	முதலுதவி	முதல்வது
muthaludhavip	முதலுதவிப்	முதல்வதுப்
muthaluthavip	முதலுதவிப்	முதல்வதுப்
munaivadhaaga	முனைவதாக	முனைவதாக
munaivathaaka	முனைவதாக	முனைவதாக
munnani	முன்னணி	முன்னாி
munnaniyil	முன்னணியில்	முன்னாயிலில்
munnaniyum	முன்னணியும்	முன்னாணியும்
munnarae	முன்னரே	முன்னே
padugindrana	முன்னெடுக்கப்	படுகின்றன
padukinrana	முன்னெடுக்கப்	படுகின்றன
padukintrana	முன்னெடுக்கப்	படுகின்றன
patukinrana	முன்னெடுக்கப்	படுகின்றன
munnedukappatta	முன்னெடுக்கப்பட்ட	முன்னோட்கப்பட்ட
munnedukkappatta	முன்னெடுக்கப்பட்ட	முன்னீட்கப்பட்ட்ட
munnetukkappatta	முன்னெடுக்கப்பட்ட	முன்னீட்கப்பட்ட்ட
munnedukkum	முன்னெடுக்கும்	முன்னெட்குக்கும்
munnetukkum	முன்னெடுக்கும்	முன்னெட்குக்கும்
munmaadhiriyaga	முன்மாதிரியாக	முன்மாதியாகி
munmaadhiriyaka	முன்மாதிரியாக	முன்மாதியாகி
munmaathiriyaaga	முன்மாதிரியாக	முன்மாதியாறக
munmaathiriyaaka	முன்மாதிரியாக	முன்மாதியாறக
munmadiriyaga	முன்மாதிரியாக	முன்மியிடக்க
munvaiththa	முன்வைத்த	முன்வதைத்
munvaiththaanr	முன்வைத்தனர்	முன்வத்தன்ற
munvaiththanar	முன்வைத்தனர்	முன்வத்தனர்
muppathu	முப்பது	முப்பது
muppathukkum	முப்பதுக்கும்	முப்பத்துக்கும்
muyandra	முயன்ற	முயன்ற
muyanra	முயன்ற	முயனர்
muyantra	முயன்ற	முயன்ற
muyandrathaaga	முயன்றதாக	முயன்றதாக
muyandrathaaha	முயன்றதாக	முயற்தாத
muyandrathaaka	முயன்றதாக	முயற்றதாக
muyanrathaaka	முயன்றதாக	முயன்றதாக
muyantrathaaga	முயன்றதாக	முயற்றதாக
muyantrathaaka	முயன்றதாக	முயற்றதாக
muyandrathu	முயன்றது	முயன்றது
muyanrathu	முயன்றது	முயனற்றது
muyantrathu	முயன்றது	முயன்றது
muyandrana	முயன்றன	முயன்றன
muyanrana	முயன்றன	முயனர்
muyantrana	முயன்றன	முயன்றன
muyandraan	முயன்றான்	முயான்றான்
muyanraan	முயன்றான்	முயானர்
muyantraan	முயன்றான்	முயான்றான்
muyanru	முயன்று	முயன்று
muyantru	முயன்று	முயன்று
murachu	முரசு	முறசு
murasu	முரசு	முராசு
muraigaettil	முறைகேட்டில்	முறைக்கடில்
muraikaettil	முறைகேட்டில்	முறைக்கடில்
muraikettil	முறைகேட்டில்	முறைக்கிட்டில்
muraimai	முறைமை	முறைமை
muraimaiyaanathu	முறைமையானது	முறையாளதுு
muraimaiyin	முறைமையின்	முறையையின்
muraimaiyil	முறைமையில்	முறையையில்
murpatta	முற்பட்ட	முற்பட்ட
murpattanar	முற்பட்டனர்	முற்பட்டனர்
murpattapoathu	முற்பட்டபோது	முற்பாப்பட்டது
murpattapoothu	முற்பட்டபோது	முற்பாட்போது
murpattapothu	முற்பட்டபோது	முற்பாட்ப்து
murpattaan	முற்பட்டான்	முற்பாட்டன்
theevai	முல்லைத்	தேவை
tivai	முல்லைத்	திவை
mullum	முள்ளும்	முல்லும்
mullai	முள்ளை	முல்லை
mulunera	முழுநேர	முலுனே
muzhunaera	முழுநேர	முழுநார
muzhunera	முழுநேர	முழுந்தா
moodupani	மூடுபனி	மூடுபானி
moondraavadhu	மூன்றாவது	மொன்றாவது
moondraavathu	மூன்றாவது	மொன்றாவது
moor	மூர்	மோர்
mur	மூர்	முர்
muur	மூர்	மூர்
moolakkooru	மூலக்கூறு	மோலக்கூறு
moolakkoorugalin	மூலக்கூறுகளின்	மோலக்குகிலுரின்
moolakkoorukalin	மூலக்கூறுகளின்	மோலக்குகிலுரின்
moolakkoorugalai	மூலக்கூறுகளை	மூகல்குகையுள்
moolakkoorukalai	மூலக்கூறுகளை	மோகல்குகையுள்
mechchi	மெச்சி	மேச்சி
maegalai	மேகலை	மேகளை
maekalai	மேகலை	மேகளை
megalai	மேகலை	மேகளை
madein	மேட்டின்	மேடன்
maettin	மேட்டின்	மேட்டின்
mate	மேட்டின்	மேட்
matein	மேட்டின்	மேட்ன்
maeniyil	மேனியில்	மேனியில்
maembaalaththai	மேம்பாலத்தை	மேம்பாலதத்தி
maempaalaththai	மேம்பாலத்தை	மேம்பாலதைத்
meampaalaththai	மேம்பாலத்தை	மேம்பாலதைத்
maicroa	மைக்ரோ	மைக்ரோ
maikro	மைக்ரோ	மைக்ரோ
maikroa	மைக்ரோ	மைக்ரோ
maikroo	மைக்ரோ	மைக்ரோ
maiqro	மைக்ரோ	மைக்ரோ
mekro	மைக்ரோ	மேக்ரோ
micro	மைக்ரோ	மிக்கோ
microo	மைக்ரோ	மிக்கோ
micru	மைக்ரோ	மிக்
mikro	மைக்ரோ	மிக்ரோ
mykro	மைக்ரோ	மிக்ரோ
mykroo	மைக்ரோ	மிக்ரோ
myqro	மைக்ரோ	மிக்கோ
moe	மோ	மோ
moo	மோ	மோ
mooe	மோ	மோ
moasaeyin	மோசேயின்	மோசசியின்
moaseayin	மோசேயின்	மோசாயின்
mosaeyin	மோசேயின்	மோசியின்
moad	மோட்	மோட்
moat	மோட்	மோட்
mod	மோட்	மோட்
mode	மோட்	மோடி
mood	மோட்	மோட்
mote	மோட்	மாட்
iaak	யாக்	யாக்
iacc	யாக்	இாக்
iak	யாக்	ஹாக்
iakk	யாக்	இக்க்
iokk	யாக்	இக்க்
yaak	யாக்	யாக்
yaaq	யாக்	யாக்
yacc	யாக்	யாக்
yak	யாக்	யாக்
yakk	யாக்	யாக்க்
yaq	யாக்	யாக்
yaqq	யாக்	காக்
yok	யாக்	யாக்
yokk	யாக்	யாக்க்
yoqq	யாக்	யாக்க்
iaang	யாங்	யாங்
ianag	யாங்	இாக
iang	யாங்	இங்க்
yaang	யாங்	யாங்
yan	யாங்	யான்
yanag	யாங்	யாக்
yang	யாங்	யங்க்
yaadhavar	யாதவர்	தாவர்
yaathavar	யாதவர்	தாயவர்
yaadhavarkal	யாதவர்கள்	தாயர்கள்
yaathavargal	யாதவர்கள்	தாயர்கள்
yaathavarkal	யாதவர்கள்	தாயர்கள்
iaadav	யாதவ்	ஆடவவ்
iadav	யாதவ்	இடவ்
iaduv	யாதவ்	இடுவு
jadav	யாதவ்	ஜடவ்
jadaw	யாதவ்	ஜடவ
yaadav	யாதவ்	ஆடவ்
yaadaw	யாதவ்	யாட்
yaadhav	யாதவ்	ஆதவத்
yaathav	யாதவ்	யாத்வ
yadav	யாதவ்	ஆடவ்
yadaw	யாதவ்	யடவ
yaduuv	யாதவ்	யடுவு
yaduv	யாதவ்	யடுவு
yaduw	யாதவ்	யடுவ
yatav	யாதவ்	யட்வ
zadav	யாதவ்	ஜடவ்
yaavarum	யாவரும்	யாவரும்
yaahoo	யாஹூ	யாோ
yahoo	யாஹூ	யோோ
yaaka	யோக	யாக
yoaga	யோக	யோகா
yoaka	யோக	யோகா
yoga	யோக	யோகா
yaakangkalai	யோகங்களை	யாகங்களை
yoagangkalai	யோகங்களை	கோயங்களை
yoakangalai	யோகங்களை	கோயங்களை
yoakangkalai	யோகங்களை	கோயங்களை
yoagaththil	யோகத்தில்	கோதத்தில்
yoakaththil	யோகத்தில்	யாகத்தில்
yookaththil	யோகத்தில்	யூகத்தில்
yoakaththai	யோகத்தை	கோயத்தை
yogaththai	யோகத்தை	கோயத்தை
yookaththai	யோகத்தை	கோய்ததை
yoagaa	யோகா	யோகா
yoakaa	யோகா	யோகா
yoga	யோகா	யோகா
yogaa	யோகா	யோகா
yooga	யோகா	யூகா
yookaa	யோகா	யூகா
youga	யோகா	யூகா
yoachanai	யோசனை	சோயனை
yoasanai	யோசனை	சோனையை
yoosanai	யோசனை	சூனைய
yoasanaiyin	யோசனையின்	சோயனையின்
yoosanaiyin	யோசனையின்	சூனையனின்
yoasanaiyai	யோசனையை	சோனையை
yoosanaiyai	யோசனையை	சூனையை
yosanaiyai	யோசனையை	சூனையை
jordan	யோர்தான்	ஜோர்ட்
yoarthaan	யோர்தான்	யர்தான்
yoorthaan	யோர்தான்	ஊர்தான்
rachippathil	ரசிப்பதில்	ரரிப்பத்தில
rasippathil	ரசிப்பதில்	ரரிப்பதில்
ranchi	ரஞ்சி	ரஞ்சி
ranjchi	ரஞ்சி	ரஞ்சி
ranji	ரஞ்சி	ரஞ்சி
ranchith	ரஞ்சித்	ரஞ்சித்
ranjchith	ரஞ்சித்	ரஞச்சி
ranjeet	ரஞ்சித்	ராஞ்சி
ranjeit	ரஞ்சித்	ராஞ்சி
ranjiit	ரஞ்சித்	ராஞ்சி
ranjit	ரஞ்சித்	ராஞ்சி
ranjith	ரஞ்சித்	ரஞ்சி
ranjyt	ரஞ்சித்	ராஞ்சி
ranzeet	ரஞ்சித்	ராண்டி
ranzeit	ரஞ்சித்	ராஞ்சி
ranzit	ரஞ்சித்	ராஞ்சி
ranzyt	ரஞ்சித்	ராஞ்சி
runjeet	ரஞ்சித்	ருஞ்சே
runjiit	ரஞ்சித்	ராஞ்சிட்
runzeet	ரஞ்சித்	ருண்டில்
ruunjeet	ரஞ்சித்	ரர்்சி
rail	ரயில்	ரைய்
raill	ரயில்	ரைல்ல்
raiyl	ரயில்	ரைய்
rayil	ரயில்	ரயில்
rayl	ரயில்	ராய்
reil	ரயில்	ரெய்ல்
rel	ரயில்	ரேல்
rell	ரயில்	ரெல்ல்
ravikkai	ரவிக்கை	ரவிக்கை
ravudi	ரவுடி	ரவுடி
rovdy	ரவுடி	ரா்பி
rowdi	ரவுடி	ராட்
rowdy	ரவுடி	ராட்
rashiya	ரஷ்ய	ரசியா
rashya	ரஷ்ய	ரஷ்யா
rassia	ரஷ்ய	ரசிசா
russia	ரஷ்ய	ரஷ்யா
raagul	ராகுல்	ராகுல்
raahul	ராகுல்	ராலு
raahuul	ராகுல்	ராலு
ragul	ராகுல்	ரகுல்
rahool	ராகுல்	ராலல்
rahul	ராகுல்	ராலு
rahuul	ராகுல்	ராலு
rakul	ராகுல்	ரகுக்
raajan	ராஜன்	ராஜன்
rajan	ராஜன்	ராஜன்
raajaraaja	ராஜராஜ	ராஜராஜா
rajaraja	ராஜராஜ	ரரஜஜா
raajjiyam	ராஜ்ஜியம்	ராஜ்ஜியம்
rajjiyam	ராஜ்ஜியம்	ரஜ்சியம்
raanuvaththin	ராணுவத்தின்	ராணவத்தின்
raanuvam	ராணுவம்	ராணுவம்
raat	ராத்	ராட்
raath	ராத்	ராத்
raamachchandhira	ராமச்சந்திர	ராசம்சிரத்தா
raamachchanthira	ராமச்சந்திர	ராசம்சரித்தா
ramachandra	ராமச்சந்திர	ரமாசந்தார்
raamu	ராமு	ராமு
ramu	ராமு	ராம்
raayin	ராயின்	ராயின்
raiyin	ராயின்	ரையின்
raavin	ராவின்	ராவின்
ravin	ராவின்	ரவின்
rawin	ராவின்	ராவின்
ring	ரிங்	ரிங்
reader	ரீடர்	ரேடர்
reedar	ரீடர்	ரேடர்
ruchi	ருசி	ருச்
rusi	ருசி	ருசி
rendu	ரெண்டு	ரெண்டு
raadaun	ரேடான்	ராடன்
raadauun	ரேடான்	ராடன்
raadon	ரேடான்	ராடன்
radon	ரேடான்	ராடன்
reedan	ரேடான்	ரீடன்
raemand	ரேமண்ட்	ராமண்ட்
raemant	ரேமண்ட்	ராமண்ட்
raimond	ரேமண்ட்	ரியம்்
raymond	ரேமண்ட்	ரயம்்
reemand	ரேமண்ட்	ரிமண்ட்
roo	ரோ	ரோ
roow	ரோ	ரோவ்
rov	ரோ	ரோவ்
row	ரோ	ரோவ்
landanin	லண்டனின்	லண்டனின்
londanin	லண்டனின்	லூண்டினன்
londonin	லண்டனின்	லூன்டினன்
lav	லவ்	லவ்
lov	லவ்	லோவ்
love	லவ்	லோவி
low	லவ்	லோவா
lowe	லவ்	லோவி
luuv	லவ்	லூவ்
luv	லவ்	லுவ்
luw	லவ்	லுவா
laak	லாக்	லாக்
lack	லாக்	லாக்க்
lock	லாக்	லாக்க்
laaba	லாப	லாபா
laba	லாப	லபா
laabam	லாபம்	லாப்
laapam	லாபம்	லாப்பம்
laalu	லாலு	லாளு
lalu	லாலு	லாலு
linam	லிங்கம்	லினம்
lingam	லிங்கம்	லிங்கம்
linggam	லிங்கம்	லிங்கம்
lingkam	லிங்கம்	லிங்கம்
linkam	லிங்கம்	லிங்கம்
lemeted	லிமிடெட்	லிடமேட்ட்
limidaed	லிமிடெட்	லிமிட்ட்ட்
limitade	லிமிடெட்	லிமிட்ட்ட்
limited	லிமிடெட்	லிமிட்ட்ட்
limitedd	லிமிடெட்	லிமிட்ட்ட்
leeli	லில்லி	லெலி
leelii	லில்லி	லெலி
liili	லில்லி	லிலி
liilii	லில்லி	லிலி
liilly	லில்லி	லில்லி
liily	லில்லி	லிலி
lilee	லில்லி	லிலி
lili	லில்லி	லிலி
lilii	லில்லி	லிலி
lilli	லில்லி	லில்லி
lilly	லில்லி	லில்லி
lily	லில்லி	லிலி
lyly	லில்லி	லிலிய்
leagueil	லீக்கில்	லெக்கில்
leakkil	லீக்கில்	லெக்கில்
leena	லீனா	லீனா
leenaa	லீனா	லெனா
lena	லீனா	லெனா
liina	லீனா	லினா
lina	லீனா	லினா
looyi	லூயி	லூயி
louie	லூயி	லூய்
louis	லூயி	லூசி
louuie	லூயி	லூய்
luuyi	லூயி	லூயி
looyis	லூயிஸ்	லூசிய்
loues	லூயிஸ்	லோஸ்
louis	லூயிஸ்	லூசி
louues	லூயிஸ்	லூஸ்
louuis	லூயிஸ்	லூசி
lues	லூயிஸ்	லுஸ்
luis	லூயிஸ்	லைஸ்
luues	லூயிஸ்	லூஸ்
luuis	லூயிஸ்	லூசி
luuyis	லூயிஸ்	லூசிய்
leptinan	லெப்டினன்	லெட்பினன்
lace	லெஸ்	லாக்
laes	லெஸ்	லாஸ்
lais	லெஸ்	லைஸ்
laiss	லெஸ்	லைஸ்
lays	லெஸ்	லாஸ்
layss	லெஸ்	லாஸ்
leis	லெஸ்	லெஸ்
les	லெஸ்	லிஸ்
less	லெஸ்	லிஸ்
laac	லேக்	லாக்
laak	லேக்	லாக்
laakh	லேக்	லாக்
laaq	லேக்	லாக்
laaqh	லேக்	லாக்
lac	லேக்	லாக்
laek	லேக்	லேக்
lake	லேக்	லக்கி
lakh	லேக்	லக்
laqh	லேக்	லக்
leek	லேக்	லிக்
vaguththanar	வகுத்தனர்	வகுத்தனர்
vakuththanar	வகுத்தனர்	வகுத்தனர்
vaguththulladhu	வகுத்துள்ளது	வகுத்துள்ளது
vaguththullathu	வகுத்துள்ளது	வகுத்துள்ளது
vakuththullathu	வகுத்துள்ளது	வகுத்துள்ளது
vagaith	வகைத்	வகைத்
vakaith	வகைத்	வகைத்
vakkiramaana	வக்கிரமான	வக்கிறமான
vakbu	வக்பு	வக்பு
vakpu	வக்பு	வாக்பு
vangadesa	வங்கதேச	வங்காட
vangathaesa	வங்கதேச	வங்காதே
vangkadhaesa	வங்கதேச	வங்கேசதா
vangadhaesaththil	வங்கதேசத்தில்	வங்காதத்தில்
vangathaesaththil	வங்கதேசத்தில்	வங்காதத்தில்
vangkadhaesaththil	வங்கதேசத்தில்	வங்காதத்தில்
vangaali	வங்காளி	வங்களி
vangkaali	வங்காளி	வங்களில்
vasam	வசம்	வசாம்
vasiththa	வசித்த	வசித்த
vasiththaar	வசித்தார்	வசித்தார்
vadakkae	வடக்கே	வடக்கே
vadakke	வடக்கே	வடக்கி
vadamaerkae	வடமேற்கே	வடமேற்கே
vatamaerkae	வடமேற்கே	வடமேற்கே
vadikka	வடிக்க	வடிக்க
vadikkum	வடிக்கும்	வடிக்கும்
vadivaana	வடிவான	வடிவான
vadivil	வடிவில்	வடிவில்
vatti	வட்டி	வட்டி
vana	வண	வான
ven	வண	வென்
wen	வண	வின்
vanigar	வணிகர்	வணிக்்
vanikar	வணிகர்	வணிக்்
vanigarkalukku	வணிகர்களுக்கு	வணிகள்க்குகளு
vanikarkalukku	வணிகர்களுக்கு	வணிகள்க்குகளு
vadhanam	வதனம்	வதாமம்
vathanam	வதனம்	வதாமம்
wadhanam	வதனம்	வதாமம்
vanaviyal	வனவியல்	வணவியல்
vamsa	வம்ச	வாம்
vamsaththin	வம்சத்தின்	வம்சத்தின்
vamsaththu	வம்சத்து	வம்சத்து
vamchi	வம்சி	வாம்சி
vamsi	வம்சி	வாமி
vayathaagum	வயதாகும்	வாயதாகும்
vayathaakum	வயதாகும்	வாயதாகும்
vayathilum	வயதிலும்	வயிதலும்
vayathilaeyae	வயதிலேயே	வயதிலேயே
varagu	வரகு	வருக
varadha	வரத	வரதா
varatha	வரத	வரத
vardha	வரத	வர்த
varadhar	வரதர்	வரதர்
varathar	வரதர்	வரத்தர்
varalaattru	வரலாற்று	வராளத்து
varalaattruk	வரலாற்றுக்	வராளத்துக்க்
varalaattrukku	வரலாற்றுக்கு	வராளருத்துக்கு
varalaattrudan	வரலாற்றுடன்	வராளத்துடன்
varalaattrup	வரலாற்றுப்	வராளர்றுப்
varavaerka	வரவேற்க	வரவர்க்
varavaerkum	வரவேற்கும்	வரவர்கும்
varigalin	வரிகளின்	வரிகளின்
varikalin	வரிகளின்	வரிகளின்
varigalil	வரிகளில்	வரிகளில்
varikalil	வரிகளில்	வரிகளில்
varigalukku	வரிகளுக்கு	வரிகளுக்கு
varikalukku	வரிகளுக்கு	வரிகளுக்கு
varigalum	வரிகளும்	வரிகளும்
varikalum	வரிகளும்	வரிகளும்
varikku	வரிக்கு	வரிக்கு
varich	வரிச்	வரிச்
varinum	வரினும்	வரினும்
panaththai	வரிப்	பணத்தை
panattai	வரிப்	பணட்டை
variyaaga	வரியாக	வரியாக
variyaaka	வரியாக	வரியாக
variyin	வரியின்	வரியின்
variyum	வரியும்	வரியும்
varumaaru	வருமாறு	வருமாறு
variya	வறிய	வரியா
valimaiyaanathu	வலிமையானது	வளிமையானது
valuvaaga	வலுவாக	வழுவாக
valuvaaka	வலுவாக	வழுவாக
valuvvaaga	வலுவாக	வழுவாக
valaiyamaippai	வலையமைப்பை	வளையைப்பை
valaiyamaippu	வலையமைப்பை	வளையைப்பு
valaiththathu	வளைத்தது	வழைத்தது
valaivaaga	வளைவாக	வழைவாக
valaivaaka	வளைவாக	வழைவாக
valakkarignarum	வழக்கறிஞரும்	வழக்கருகின்றம
valakkarinarum	வழக்கறிஞரும்	வழக்கருகினம்
vazhakkarinarum	வழக்கறிஞரும்	வழக்கிறமும்
valakkugalin	வழக்குகளின்	வழக்குகளின்
valakkukalin	வழக்குகளின்	வழக்குகளின்
vazhakkukalin	வழக்குகளின்	வழக்குகளின்
valakkugalai	வழக்குகளை	வழக்குகளை
valakkukalai	வழக்குகளை	வழக்குகளை
vazhakkukalai	வழக்குகளை	வழக்குகளை
valakkugal	வழக்குகள்	வழக்குகள்
valakkukal	வழக்குகள்	வழக்குகள்
vazhakkukal	வழக்குகள்	வழக்குகள்
valakkuth	வழக்குத்	வழக்குத்
vazhakkuth	வழக்குத்	வழக்குத்
valakkum	வழக்கும்	வழக்கும்
vazhakkum	வழக்கும்	வழக்கும்
valangappada	வழங்கப்பட	வழங்கப்பட்ட
vazhangappada	வழங்கப்பட	வழங்கப்பட்ட
vazhanggappada	வழங்கப்பட	வழங்கப்பட்ட
valangappadaatha	வழங்கப்படாத	வழங்கப்பட்ட
vazhangappadaadha	வழங்கப்படாத	வழங்கப்பட்டா
vazhanggappattathaa	வழங்கப்படாத	வழங்கப்பட்டதா
valangappadum	வழங்கப்படும்	வழங்கப்படும்
valangkappadum	வழங்கப்படும்	வழங்கப்படும்
vazhanggappadum	வழங்கப்படும்	வழங்கப்படும்
vazhangkappadum	வழங்கப்படும்	வழங்கப்படும்
valangavillai	வழங்கவில்லை	வழங்களிலை
valangkavillai	வழங்கவில்லை	வழங்கவில்லை
vazhangkavillai	வழங்கவில்லை	வழங்களில்லை
valinadaththa	வழிநடத்த	வழிநாதத்த
vazhinadaththa	வழிநடத்த	வழிநத்த
valiyil	வழியில்	வழியில்
vazhiyil	வழியில்	வழியில்
valiyillai	வழியில்லை	வளிலியில்
vazhiyillai	வழியில்லை	வழியில்லை
valiyae	வழியே	வழியே
valiyea	வழியே	வழியே
vazhiyae	வழியே	வழியே
valukkum	வழுக்கும்	வழுக்கும்
vazhukkum	வழுக்கும்	வழுக்கும்
vavuniyaavil	வவுனியாவில்	வவுவியாலில்
vavuniyavil	வவுனியாவில்	வவுவியில்
vastook	வஸ்தோக்	வாட்டோக்
vastuk	வஸ்தோக்	வாட்டுக்
voostook	வஸ்தோக்	வோஸ்டோக்
vostok	வஸ்தோக்	வோஸ்ட்க்
vostook	வஸ்தோக்	வோஸ்டோக்
vostoq	வஸ்தோக்	வோஸ்ட்
wastuk	வஸ்தோக்	வாட்டுக்
wastuq	வஸ்தோக்	வாஸ்டுக்
wastuuk	வஸ்தோக்	வாஸ்டுக்
woostook	வஸ்தோக்	வோஸ்டோக்
wostok	வஸ்தோக்	வோஸ்ட்க்
wostook	வஸ்தோக்	வோஸ்டோக்
wostooq	வஸ்தோக்	வோஸ்டோக்
wostuk	வஸ்தோக்	வோஸ்டுக்
vaagana	வாகன	வாகான
vaakana	வாகன	வாகான
vaagananggalil	வாகனங்களில்	வாகஙங்களில்
vaaganangkalil	வாகனங்களில்	வாகஙங்களில்
vaakanangkalil	வாகனங்களில்	வாகஙங்களில்
vaagananggalum	வாகனங்களும்	வாகஙங்களும்
vaaganangkalum	வாகனங்களும்	வாகஙங்களும்
vaakanangkalum	வாகனங்களும்	வாகஙங்களும்
vaagananggalai	வாகனங்களை	வாகங்களை
vaaganangkalai	வாகனங்களை	வாகங்களை
vaakanangkalai	வாகனங்களை	வாகங்களை
vaagananggal	வாகனங்கள்	வாகங்கள்
vaaganangkal	வாகனங்கள்	வாகஙங்கள்
vaakanangkal	வாகனங்கள்	வாகங்கங்கள்
vaaganaththin	வாகனத்தின்	வாகத்தின்
vaakanaththin	வாகனத்தின்	வாகத்தின்
vaaganaththilirunththu	வாகனத்திலிருந்து	வாகநித்திலிருந்து
vaaganaththilirunthu	வாகனத்திலிருந்து	வாகநிதிதிருந்து
vaakanaththilirunththu	வாகனத்திலிருந்து	வாககிந்திருந்து
vaakanaththilirunthu	வாகனத்திலிருந்து	வாகநித்திருந்து
vaaganaththil	வாகனத்தில்	வாகத்தில்
vaakanaththil	வாகனத்தில்	வாகநதத்தில்
vaaganap	வாகனப்	வாகப்ப
vaakanap	வாகனப்	வாகக்்
vaaganamaana	வாகனமான	வாகணாமான
vaaganamana	வாகனமான	வாகணமான
vaakanamaana	வாகனமான	வாகானமான
vaakanamana	வாகனமான	வாகணமான
vaak	வாக்	வாக்
vag	வாக்	வாக்
vak	வாக்	வாக்
wag	வாக்	வாக்
wak	வாக்	வாக்
walk	வாக்	வால்க்
vaangappatta	வாங்கப்பட்ட	வாங்கப்பட்ட
vaanggappatta	வாங்கப்பட்ட	வாங்கப்பட்ட
vaangkappatta	வாங்கப்பட்ட	வாங்கப்பட்ட
vaangalil	வாங்கலில்	வாங்களில்
vaanggalil	வாங்கலில்	வாங்களில்
vaangal	வாங்கல்	வாங்கள்
vaanggal	வாங்கல்	வாங்கள்
vaangguvatharku	வாங்குவதற்கு	வாங்குவதற்கு
vaangkuvatharku	வாங்குவதற்கு	வாங்குவதற்கு
vaangguvathu	வாங்குவது	வாங்குவது
vaangkuvathu	வாங்குவது	வாங்குவது
vaangguvathai	வாங்குவதை	வாங்குவதை
vaangkuvathai	வாங்குவதை	வாங்குவதை
vaasippavargal	வாசிப்பவர்கள்	வாசிப்பர்கள்
vaachippil	வாசிப்பில்	வாச்பிலிப்
vaasippil	வாசிப்பில்	வாசிப்பில்
vaachippai	வாசிப்பை	வாச்பிப்பை
vaasippai	வாசிப்பை	வாசிப்பை
vaadi	வாடி	வாடி
vadi	வாடி	வடி
wadi	வாடி	வடி
wadii	வாடி	வடி
vaatch	வாட்ச்	வாட்ச்
watch	வாட்ச்	வட்ச்
vaani	வாணி	வானி
vani	வாணி	வானி
vaathittanar	வாதிட்டனர்	வாடித்தனர்
vaathumai	வாதுமை	வாதுமை
vaamana	வாமன	வாமான
vamana	வாமன	வமான
vaayilaaga	வாயிலாக	வாயிலாக
vaayilaaka	வாயிலாக	வாயிலாக
vaayilaagath	வாயிலாகத்	வாயியாத்த
vaayilaakath	வாயிலாகத்	வாயிலாத்த
vaayilaagap	வாயிலாகப்	வாயியாக்
vaayilaakap	வாயிலாகப்	வாயியாகப்
vaariyaaga	வாரியாக	வாரியாக
vaariyaaka	வாரியாக	வாரியாக
vaalt	வால்ட்	வால்ட்
vald	வால்ட்	வால்ட்
valt	வால்ட்	வால்
vaoolt	வால்ட்	வால்ட்
vault	வால்ட்	வால்ட்
vauult	வால்ட்	வால்ட்
volt	வால்ட்	வால்ட்
vult	வால்ட்	வுள்
vuult	வால்ட்	வால்ட்
walt	வால்ட்	வால்ட்
waoolt	வால்ட்	வால்ட்
wault	வால்ட்	வால்ட்
wult	வால்ட்	வால்ட்
vaalidankal	வாழிடங்கள்	வாளிடங்கள்
vaazhidanggal	வாழிடங்கள்	வாழிடங்கள்
vaazhidangkal	வாழிடங்கள்	வாழிடங்கள்
vaazhitangkal	வாழிடங்கள்	வாழிட்டங்கள்
vaalidam	வாழிடம்	வாளிடம்
vaazhaidam	வாழிடம்	வாழைத்
vaazhidam	வாழிடம்	வாழிடம்
vaazhitam	வாழிடம்	வாழித்ம்
vaalai	வாழை	வாளை
vaazhai	வாழை	வாழை
vaalaiyaaga	வாழையாக	வாழையாக
vaazhaiyaaga	வாழையாக	வாழையாக
vaazhaiyaaka	வாழையாக	வாழையாக
vaazhga	வாழ்க	வாழ்க
vaazhka	வாழ்க	வாழ்க
valamudan	வாழ்க	வலமுடன்
valamutan	வாழ்க	வலமுடன்
vaazhvathaaga	வாழ்வதாக	வாழ்தவாக
vaazhvathaal	வாழ்வதால்	வாழ்தால்
vaalvukku	வாழ்வுக்கு	வாழ்வுக்கு
vaazhvukku	வாழ்வுக்கு	வாழ்வுக்கு
vaalvoar	வாழ்வோர்	வால்வோர்
vaazhvoar	வாழ்வோர்	வாழ்வோர்
vaas	வாஸ்	வாஸ்
vase	வாஸ்	வாஷி
was	வாஸ்	வாஸ்
vigaaraiyil	விகாரையில்	விகாரையில்
viharaiyil	விகாரையில்	விரையில்
vikaaraiyil	விகாரையில்	விகாரையில்
vikkirama	விக்கிரம	விக்கிறமா
vikkrama	விக்கிரம	விக்கரமம
vikrama	விக்கிரம	விற்கமா
visaariththu	விசாரித்து	விசாரித்து
vichaesha	விசேஷ	விசசா
visaesha	விசேஷ	விஷா
vichaikal	விசைகள்	விசைகள்
visaigal	விசைகள்	விசைகள்
visaikal	விசைகள்	விசைகள்
vichaikku	விசைக்கு	விசைக்கு
visaikku	விசைக்கு	விசைக்கு
visaiyaal	விசையால்	விசாயல்
visaiyil	விசையில்	விசையில்
visaiyum	விசையும்	விசையும்
visaiyai	விசையை	விசையை
vingngnaani	விஞ்ஞானி	விங்கனனின்
vinjnjaani	விஞ்ஞானி	விஞ்சனாி
vinniaani	விஞ்ஞானி	வின்னாயின்
vingngnaanikalukku	விஞ்ஞானிகளுக்கு	விங்ங்கின்குக்கு
vinjnjaanikalukku	விஞ்ஞானிகளுக்கு	விஞ்சாரிங்குக்கு
vinniaanigalukku	விஞ்ஞானிகளுக்கு	வின்நியாங்குக்கு
vingngnaanikal	விஞ்ஞானிகள்	விங்ங்கிங்கள்
vinjnjaanikal	விஞ்ஞானிகள்	விஞ்சனியாக்
vinniaanigal	விஞ்ஞானிகள்	வின்னியாங்கள்
vingngnaaniyaana	விஞ்ஞானியான	விங்ங்கனியான
vinjnjaaniyaana	விஞ்ஞானியான	விஞ்சனாயான
vinniaaniyaana	விஞ்ஞானியான	வின்னியானாய
vidayangalil	விடயங்களில்	விடையங்களில்
vidayanggalil	விடயங்களில்	விடைகங்களில்
vidayangkalil	விடயங்களில்	விடையங்களில்
vidayanggalum	விடயங்களும்	விடைங்களும்
vidayangkalum	விடயங்களும்	விடைங்களும்
vitayangkalum	விடயங்களும்	விட்யங்களும்
vidayanggal	விடயங்கள்	விடைகங்கள்
vidayangkal	விடயங்கள்	விடையங்கள்
vitayangkal	விடயங்கள்	விடையங்கள்
vidayaththil	விடயத்தில்	விடைத்தில்
vitayaththil	விடயத்தில்	விடைத்தில்
vidayaththaiyum	விடயத்தையும்	விடையத்தையும்
vitayaththaiyum	விடயத்தையும்	விடையத்தையும்
poaraattam	விடுதலைப்	போராட்டம்
porattam	விடுதலைப்	போரட்டம்
viduthalaip	விடுதலைப்	விடுத்தைப்
vidum	விடும்	விடும்
vittaalum	விட்டாலும்	விட்டாலும்
vittup	விட்டுப்	விட்டுப்
viththiyaachangkal	வித்தியாசங்கள்	வித்தியங்களக்க
viththiyaasanggal	வித்தியாசங்கள்	வித்தியாங்களக்
viththiyaasangkal	வித்தியாசங்கள்	வித்தியாங்களக்
viththiyaasankal	வித்தியாசங்கள்	வித்தியாங்கள்
viththiyaachappadum	வித்தியாசப்படும்	வித்திசப்பாயும்
viththiyaasappadum	வித்தியாசப்படும்	வித்தியாபப்படும்
vidhdhiyaasaalai	வித்தியாசாலை	வித்தியாாலை
vidhyaasaalai	வித்தியாசாலை	வித்சாயால
vidhyasalai	வித்தியாசாலை	வித்சாயலை
vidyasalai	வித்தியாசாலை	விட்சாயலை
viththiyaasaalai	வித்தியாசாலை	வித்தியாாசை
vinaa	வினா	வினா
vinaavirku	வினாவிற்கு	வினாவிற்கு
vinaavukku	வினாவுக்கு	வினாவுக்கு
vibaththaal	விபத்தால்	விபத்தால்
vipaththaal	விபத்தால்	விபத்தால்
booshan	விபூதி	போசன்
vibhoodhi	விபூதி	விபோதி
viboodhi	விபூதி	விபோதி
viboothi	விபூதி	விபோதி
vimarisaiyaaga	விமரிசையாக	விமிரசையாக
vimarisaiyaaka	விமரிசையாக	விமிரையாக
vimarsiththathu	விமர்சித்தது	விமர்ச்த்தது
vimarsiththatu	விமர்சித்தது	விமர்ச்சித்து
vimarsiththanar	விமர்சித்தனர்	விமிர்ச்தர்்
vimarsiththu	விமர்சித்து	விமர்ச்தித்
vimaanangalil	விமானங்களில்	விமானங்களில்
vimaananggalil	விமானங்களில்	விமாங்களில்
vimaananggalai	விமானங்களை	விமமங்களை
vimaanankalai	விமானங்களை	விமன்்மைகள்
veem	விம்	வீம்
viim	விம்	விம்
vim	விம்	விம்
vimm	விம்	விம்
weem	விம்	வீம்
wiim	விம்	விம்
wim	விம்	விம்
wimm	விம்	விம்ம்
viyaabaari	வியாபாரி	வியாபாரி
viyaapaari	வியாபாரி	வியாபாரி
viyaabaarigalukkum	வியாபாரிகளுக்கும்	வியாரப்பாகுக்கும்
viyaapaarigalukkum	வியாபாரிகளுக்கும்	வியாரப்பாகிகுக்கும
viyaabaarigal	வியாபாரிகள்	வியாபாரிகள்
viyaapaarigal	வியாபாரிகள்	வியாபாரிகள்
viyabaarigal	வியாபாரிகள்	வியாரபிகள்
viralaal	விரலால்	விரளால்
virivaagak	விரிவாகக்	விரிவாகக்
virivaagap	விரிவாகப்	விரிவாகப்
virivaagavum	விரிவாகவும்	விரிவாகவும்
virivagavum	விரிவாகவும்	விரிவவககும்
virivurai	விரிவுரை	விரிவுறை
virkum	விற்கும்	விர்கும்
virkumpoadhu	விற்கும்போது	விற்கும்போது
virkumpoathu	விற்கும்போது	விற்கும்போது
virpathum	விற்பதும்	விற்பதும்
vitrtra	விற்ற	விற்ற
vittra	விற்ற	விற்ற
villiamin	வில்லியமின்	விள்ளியிம்
villiyamin	வில்லியமின்	விள்ளியியம்
williamin	வில்லியமின்	வில்லியிம்
villai	வில்லை	வில்லை
villaigalai	வில்லைகளை	விள்ளைகளை
villaikalai	வில்லைகளை	விள்ளைகளை
vilimbu	விளிம்பு	விலிம்பு
vilimpu	விளிம்பு	விலிம்பு
vilimbugalil	விளிம்புகளில்	விளிம்புகளில்
vilimbukalil	விளிம்புகளில்	விளிம்புகளில்
vilimpugalil	விளிம்புகளில்	விளிம்புகளில்
vilimpukalil	விளிம்புகளில்	விளிம்புகளில்
vilaindha	விளைந்த	விளைந்த
vilaintha	விளைந்த	விளைந்த
vilaindhadhu	விளைந்தது	விளைந்தது
vilaindhathu	விளைந்தது	விளைந்தது
vilainthadhu	விளைந்தது	விளைந்தது
vilainthathu	விளைந்தது	விளைந்தது
vilaindhu	விளைந்து	விளைந்து
vilainthu	விளைந்து	விளைந்து
vilaiyaadinaal	விளையாடினால்	விளையாடியால்
vilaiyaadum	விளையாடும்	விளையாடும்
vilaiyaadumpoadhu	விளையாடும்போது	விளையோடுப்போது
vilaiyaadumpoathu	விளையாடும்போது	விளையாடுப்போது
vilaiyaaduvadharku	விளையாடுவதற்கு	விளையாடுவதற்கு
vilaiyaaduvatharku	விளையாடுவதற்கு	விளையாடுவதற்கு
vilaiyaaduvadhu	விளையாடுவது	விளையாடுவது
vilaiyaaduvathu	விளையாடுவது	விளையாடுவது
vilaiyaattaaka	விளையாட்டாக	விளையாட்டாக
vilaiyattaaga	விளையாட்டாக	விளையாட்டாக
vilaiyattaaka	விளையாட்டாக	விளையாட்டாக
vilayaattaaga	விளையாட்டாக	விளையாட்டாக
vivariththa	விவரித்த	விவிரத்த
vivariththu	விவரித்து	விவிரத்து
vivaagaraththu	விவாகரத்து	விவாகரத்து
vivaakaraththu	விவாகரத்து	விவாகரத்து
vivakaaraththu	விவாகரத்து	விவகாகத்து
veesa	வீச	வீசா
veesi	வீசி	வீசி
veechinaar	வீசினார்	விசானிர்
veesinaan	வீசினார்	விசானன்
veesinaar	வீசினார்	விசானிர்
veechum	வீசும்	வீசும்
veesum	வீசும்	வீசும்
veechumpoathu	வீசும்போது	வெச்முப்பது
veesumpoathu	வீசும்போது	வெய்சுப்போது
veetirku	வீட்டிற்கு	வீட்டிக்கு
veettirgu	வீட்டிற்கு	வீட்டிர்கு
veettirku	வீட்டிற்கு	வீட்டிருக்
veeraraagavan	வீரராகவன்	வேரராகவன்
veeraraakavan	வீரராகவன்	வேரராகவன்
veeraraghavan	வீரராகவன்	வேரரகவதன்
veeraraagavum	வீரராகவும்	வேரராகவும்
veeraraakavum	வீரராகவும்	வேரராகவும்
veetriruntha	வீற்றிருந்த	வீற்றிருந்த
veetrtriruntha	வீற்றிருந்த	வெற்றிருந்த
veettriruntha	வீற்றிருந்த	வெற்றிருந்த
veelchchi	வீழ்ச்சி	வெள்ச்சி
veerzhchchi	வீழ்ச்சி	வீர்ச்சில்
veezhchchi	வீழ்ச்சி	வெழ்ச்சி
veelchchikku	வீழ்ச்சிக்கு	வெள்சிச்கு
veerzhchchikku	வீழ்ச்சிக்கு	வீர்ச்சிக்கு
veezhchchikku	வீழ்ச்சிக்கு	வெழ்ச்சிக்கு
veelchchiyaal	வீழ்ச்சியால்	வெள்ச்சியால்
veezhchchiyaal	வீழ்ச்சியால்	வெழ்ச்சியால்
veelchchiyai	வீழ்ச்சியை	வெள்ச்சியை
veezhchchiyai	வீழ்ச்சியை	வெழ்ச்சியை
veelnththa	வீழ்ந்த	வெழ்ந்த
veezhntha	வீழ்ந்த	வீழ்ந்த
veelnththathil	வீழ்ந்ததில்	வெழ்ந்ததில்
veezhnthathil	வீழ்ந்ததில்	வெழ்ந்தில்
veelnththaar	வீழ்ந்தார்	வெழ்ந்தார்
veezhnthaar	வீழ்ந்தார்	விழ்ந்தார்
veelnththu	வீழ்ந்து	வெழ்ந்து
veezhnthu	வீழ்ந்து	வீழ்ந்து
vekkai	வெக்கை	வேக்கை
vedikka	வெடிக்க	வீடிக்க
vedikkaatha	வெடிக்காத	வெடிக்காத
vedikkumpoathu	வெடிக்கும்போது	வெடிக்கும்போது
vettiya	வெட்டிய	வெட்டிய
vettiyaan	வெட்டியான்	வெட்டியான்
veppa	வெப்ப	வெப்ப
veppak	வெப்பக்	வேப்பக்
calanam	வெப்பச்	காலமண்
chalanam	வெப்பச்	சாலனம்
salanam	வெப்பச்	சாலனம்
veppach	வெப்பச்	வெப்பாச்
veppath	வெப்பத்	வேப்பத்
veppaththaal	வெப்பத்தால்	வெப்பத்தால்
veppaththil	வெப்பத்தில்	வெப்பத்தில்
veppaththai	வெப்பத்தை	வெப்பத்தை
veppaththaik	வெப்பத்தைக்	வெப்பத்தைக்
veppamaana	வெப்பமான	வெப்பாமான
veppamaanathu	வெப்பமானது	வெப்பாமது
veppamum	வெப்பமும்	வேப்பமும்
veppam	வெப்பம்	வேப்பம்
veruththu	வெறுத்து	வெருத்து
verumaiyaana	வெறுமையான	வெறுமையான
vetrikaramaakath	வெற்றிகரமாகத்	வெற்றிகாகதற்
vetrtrigaramaagath	வெற்றிகரமாகத்	வெற்றிகமற்றத
vetrtrikaramaakath	வெற்றிகரமாகத்	வெற்றிகமற்றதா
vetrikaramaakap	வெற்றிகரமாகப்	வெற்றிகப்பாக
vetrtrigaramaagap	வெற்றிகரமாகப்	வெற்றிறப்பாக
vetrtrikaramaakap	வெற்றிகரமாகப்	வெற்றிறப்பாக
velippadaiyaana	வெளிப்படையான	வெளிப்படையான
velippataiyaana	வெளிப்படையான	வெளிப்படையான
velipppadaiyaana	வெளிப்படையான	வெளிப்பியாான
velippaadae	வெளிப்பாடே	வெளிப்பாட
velippura	வெளிப்புற	வெளிப்புர
velippurak	வெளிப்புறக்	வெளிப்புர்க்
velippurath	வெளிப்புறத்	வெளிப்புரத்
velippuraththil	வெளிப்புறத்தில்	வெளிப்புத்தில்
velippuramaaga	வெளிப்புறமாக	வெளிப்புரமாக
veliyaagi	வெளியாகி	வெளியாகி
veliyaaki	வெளியாகி	வெளியாகி
veliyaagina	வெளியாகின	வெளியாகின
veliyaakina	வெளியாகின	வெளியாகின
veliyidappatta	வெளியிடப்பட்ட	வெளியிடப்பட்ட
veliyidappattadhu	வெளியிடப்பட்டது	வெளியிடப்பட்டது
veliyidappattathu	வெளியிடப்பட்டது	வெளியிடப்பட்டது
veliyidappattu	வெளியிடப்பட்டு	வெளியிடப்பட்டு
vaedkai	வேட்கை	வேட்கை
vaetgai	வேட்கை	வேட்கை
vaetkai	வேட்கை	வேட்கை
vaedkaiyil	வேட்கையில்	வேட்கையில்
vaetkaiyil	வேட்கையில்	வேட்கையில்
vaedhangkalin	வேதங்களின்	வேதங்களின்
vaethangalin	வேதங்களின்	வேதங்களின்
vaethangkalin	வேதங்களின்	வேதங்களின்
vaedhangkalai	வேதங்களை	வேதங்களை
vaethangalai	வேதங்களை	வேதங்களை
vaethangkalai	வேதங்களை	வேதங்களை
vaedhangkalaiyum	வேதங்களையும்	வேதங்களையும்
vaethangalaiyum	வேதங்களையும்	வேதங்களையும்
vaethangkalaiyum	வேதங்களையும்	வேதங்களையும்
vaedhangkal	வேதங்கள்	வேதங்கள்
vaethangal	வேதங்கள்	வேதங்கள்
vaethangkal	வேதங்கள்	வேதங்கள்
vaedham	வேதம்	வேதம்
vaetham	வேதம்	வேதம்
vedam	வேதம்	வேடம்
vedham	வேதம்	வேதம்
vaedhaala	வேதாள	வேதால
vaethaala	வேதாள	வேதால
vedhaala	வேதாள	வேதால
vaedhik	வேதிக்	வேதிக்
vaethik	வேதிக்	வேதிக்
vaedhiya	வேதிய	வேதிய
vaethiya	வேதிய	வேதிய
vaeyappatta	வேயப்பட்ட	வேயப்பட்ட
vaeril	வேரில்	வேரில்
giragavaasiyaa	வேற்று	கிராகாசியா
gragavaasiyaa	வேற்று	கிராகாசியா
kiragavaasiyaa	வேற்று	கிராகாசியா
kirakavaasiyaa	வேற்று	கிறகாசாயாய
kirakavaciya	வேற்று	கிரகக்சியா
vaeloor	வேலூர்	வேலோர்
vellore	வேலூர்	வெல்லோரி
vaelaigalilum	வேலைகளிலும்	வேளைகளிலும்
vaelaikalilum	வேலைகளிலும்	வேளைகளிலும்
vaelaigalil	வேலைகளில்	வேளைகளில்
vaelaikalil	வேலைகளில்	வேளைகளில்
vaelaigalukku	வேலைகளுக்கு	வேளைகளுக்கு
vaelaikalukku	வேலைகளுக்கு	வேளைகளுக்கு
vaelaigalaiyum	வேலைகளையும்	வேளையைகளும்
vaelaikalaiyum	வேலைகளையும்	வேளையகளையும்
vaelaigal	வேலைகள்	வேளைகள்
vaelaikal	வேலைகள்	வேளைகள்
vaelaikkaaga	வேலைக்காக	வேளைக்காக
vaelaikkaaka	வேலைக்காக	வேளைக்காக
vaelaikku	வேலைக்கு	வேளைக்கு
chellavum	வேலைக்குச்	செல்லவும்
vaelaikkuch	வேலைக்குச்	வேளைக்குச்
vealaikkuch	வேலைக்குச்	வேளைக்குச்
thittangalukku	வேலைத்	திட்டங்களுக்கு
thittangkalukku	வேலைத்	திட்டங்களுக்கு
thittaththin	வேலைத்	திட்டத்தின்
tittankalukku	வேலைத்	திட்டங்களுக்கு
vaelaiththittangal	வேலைத்திட்டங்கள்	வேளைத்திட்்பட்
vaelaiththittanggal	வேலைத்திட்டங்கள்	வேளைத்திடங்கள்
vaelaiththittangkal	வேலைத்திட்டங்கள்	வேளைத்திடங்கள்
vaelaiyilirunththu	வேலையிலிருந்து	வேளையிலிருந்து
vaelaiyilirunthu	வேலையிலிருந்து	வேளையிலிருந்து
vealaiyilirunthu	வேலையிலிருந்து	வேளையிலிருந்து
vaelaiyum	வேலையும்	வேளையும்
vealaiyum	வேலையும்	வெளையும்
vaelaangganni	வேளாங்கண்ணி	வேளாங்கானின்
vaelaangkanni	வேளாங்கண்ணி	வேளாங்காணி
vealaankanni	வேளாங்கண்ணி	வாளாங்கானின்
velankanni	வேளாங்கண்ணி	வெளங்கானி
vaiguntaththil	வைகுண்டத்தில்	வைக்கொட்தில்
vaikundaththil	வைகுண்டத்தில்	வைக்குட்தில்
vaiguntam	வைகுண்டம்	வைக்குணம்
vaikundam	வைகுண்டம்	வைக்குணம்
vaiko	வைகோ	வைக்
vaikoa	வைகோ	வைக்கோ
vaibava	வைபவ	வைபா
vaipava	வைபவ	வைப்பா
vaibav	வைபவ்	வைப்
vaibhav	வைபவ்	வைப்
vaipav	வைபவ்	வைப்பா
shaa	ஷா	சா
shah	ஷா	சா
shaavin	ஷாவின்	சாவின்
shahvin	ஷாவின்	சாவின்
shavin	ஷாவின்	சவின்
scot	ஸ்காட்	ச்டோ
scott	ஸ்காட்	சா்ட்
skaat	ஸ்காட்	சாக்டா
skad	ஸ்காட்	ச்கா்
spais	ஸ்பைஸ்	ஸ்பாஸ்
spice	ஸ்பைஸ்	ஸ்பிக்
shreenivaacha	ஸ்ரீநிவாச	சிரீனாவியா
sreenivaasa	ஸ்ரீநிவாச	ரிஸ்வீனா
srinivaacha	ஸ்ரீநிவாச	சிர்சினாவா
srinivaasa	ஸ்ரீநிவாச	சிர்சினாவா
srinivasa	ஸ்ரீநிவாச	சிர்வினாச
shreerangkam	ஸ்ரீரங்கம்	சிரீரங்கம்
sreerangam	ஸ்ரீரங்கம்	சிரீராங்கம்
srirangam	ஸ்ரீரங்கம்	சிர்ராங்கம்
sriranggam	ஸ்ரீரங்கம்	சிர்ரிங்கம்
srirangkam	ஸ்ரீரங்கம்	சிர்ரிங்கம்
svaram	ஸ்வரம்	சிவார்
swaram	ஸ்வரம்	சுவரரம்
sveet	ஸ்வீட்	ச்வீட்
sviid	ஸ்வீட்	சிவ்டி
sweet	ஸ்வீட்	ஸ்வீட்
swiit	ஸ்வீட்	சுவிட்
hangari	ஹங்கேரி	ஹங்கிரி
hangary	ஹங்கேரி	ஹங்கிர
hanggaeri	ஹங்கேரி	ஹங்கேரி
hankeari	ஹங்கேரி	ஹங்கேரி
hankeeri	ஹங்கேரி	ஹங்கேிி
hungaeri	ஹங்கேரி	ஹுங்கேரி
hungari	ஹங்கேரி	ஹுங்கிர
hungarii	ஹங்கேரி	ஹுங்கிரி
hungary	ஹங்கேரி	ஹுங்கரி
hungeery	ஹங்கேரி	ஹுங்கே
hungeri	ஹங்கேரி	ஹுங்கிரி
hungery	ஹங்கேரி	ஹுங்கி
huungarii	ஹங்கேரி	ஹூங்கியர்
huungary	ஹங்கேரி	ஹூங்கர்
huungery	ஹங்கேரி	ஹூங்கி
handar	ஹண்டர்	ஹந்தார்
hantar	ஹண்டர்	ஹந்தார்
hanter	ஹண்டர்	ஹந்திர்
huntar	ஹண்டர்	ஹுந்தார்
huntarr	ஹண்டர்	ஹுந்தர்
hunter	ஹண்டர்	ஹுந்திர்
hunterr	ஹண்டர்	ஹுந்டர்
huuntar	ஹண்டர்	ஹூன்டர்
huunter	ஹண்டர்	ஹூன்டர்
huunterr	ஹண்டர்	ஹூன்டர்
hampi	ஹம்பி	ஹாம்பி
haam	ஹாம்	ஹாம்
haem	ஹாம்	ஹாம்
haim	ஹாம்	ஹாம்
ham	ஹாம்	ஹாம்
hamm	ஹாம்	ஹம்ம்
haum	ஹாம்	ஹா்
hauum	ஹாம்	ஹாம்
haym	ஹாம்	ஹாம்
hom	ஹாம்	ஹாம்
home	ஹாம்	ஹாம்
haarisan	ஹாரிசன்	ஹாரிஷ்
haarison	ஹாரிசன்	ஹாரிஸ்
haarisun	ஹாரிசன்	ஹாரிஸ்
hareeson	ஹாரிசன்	ஹரிசன்
harisan	ஹாரிசன்	ஹரிஷன்
harisaun	ஹாரிசன்	ஹரிசன்
harison	ஹாரிசன்	ஹரிஷ்
harreeson	ஹாரிசன்	ராஜிர்
harriison	ஹாரிசன்	ஹரிர்சின்
harrisaun	ஹாரிசன்	ராஜிர்சன்
harrisauun	ஹாரிசன்	ராஜிரான்
harrison	ஹாரிசன்	ஹரிஸ்
he	ஹி	ஹே
hi	ஹி	ஹி
hills	ஹில்ஸ்	ஹில்ல்ஸ்
hils	ஹில்ஸ்	ஹில்ஸ்
hook	ஹூக்	ஹோக்
hooq	ஹூக்	ஹாக்
huk	ஹூக்	ஹுக்
huuk	ஹூக்	ஹுக்
helsiinkii	ஹெல்சின்கி	ஹெல்சிலிகி
helsinki	ஹெல்சின்கி	ஹெல்சிக்
helsinqi	ஹெல்சின்கி	ஹெல்சினி
health	ஹெல்த்	ஹால்த்
haerath	ஹேரத்	ஏரத்த்
hearath	ஹேரத்	ஹாரத்
herath	ஹேரத்	ஹரத்த்
heyrath	ஹேரத்	ஹெயர்த்
haikkoo	ஹைக்கூ	ஹைக்கோ
haiku	ஹைக்கூ	ஹாக்கு
hikkoo	ஹைக்கூ	ஹிக்கோ
haidrookarpan	ஹைட்ரோகார்பன்	ஹைத்ரோப்பன்
hidrocarbon	ஹைட்ரோகார்பன்	ஹிட்பர்சன்
hydrocarbon	ஹைட்ரோகார்பன்	இத்ராப்பர்
hydroocarboon	ஹைட்ரோகார்பன்	இத்ரோபோர்யன்
hoali	ஹோலி	ஹோலி
holee	ஹோலி	ஹாலி
holey	ஹோலி	ஹாலிய்
holi	ஹோலி	ஹாலி
holii	ஹோலி	ஹோலி
hollee	ஹோலி	ஹால்லி
hollei	ஹோலி	ஹால்லி
holley	ஹோலி	ஹால்லி
holli	ஹோலி	ஹாலில்
hollii	ஹோலி	ஹால்லி
holly	ஹோலி	ஹாலில்
holy	ஹோலி	ஹாலி
hooli	ஹோலி	ஹாலி
hoolii	ஹோலி	ஹோலி
hoollee	ஹோலி	ஹோல்லி
hoolley	ஹோலி	ஹால்லி
hoolli	ஹோலி	ஹாலில்
hoolly	ஹோலி	ஹாலில்
hooly	ஹோலி	ஹாலி
huli	ஹோலி	ஹுளி
