Input	Target	Predicted
fire	ஃபயர்	பிரி
phayar	ஃபயர்	பயர்
baar	ஃபார்	பார்
bar	ஃபார்	பார்
far	ஃபார்	பார்
for	ஃபார்	போர்
hpaar	ஃபார்	ஹாப்ரர்
agatrtri	அகற்றி	அகற்றி
agattri	அகற்றி	அகற்றி
akatrtri	அகற்றி	அகற்றி
agatrtrinaar	அகற்றினார்	அகற்றினார்
akatrinaar	அகற்றினார்	அகற்றினார்
akatrtrinaar	அகற்றினார்	அகற்றினார்
academi	அகாதமி	அகாடமி
academy	அகாதமி	அகாடமி
angiekariththathu	அங்கீகரித்தது	அங்கேரிக்தது
angkeekariththathu	அங்கீகரித்தது	அங்கேகிரத்து
angkeegaara	அங்கீகார	அங்கீகரா
angkeekaara	அங்கீகார	அங்கீகரா
angkeegaaraththai	அங்கீகாரத்தை	அங்கேகாரத்தை
angkeekaaraththai	அங்கீகாரத்தை	அங்கேகாரத்தை
anggeegaaram	அங்கீகாரம்	அங்கீகராம்
anggeekaaram	அங்கீகாரம்	அங்கீகராம்
angiekaaram	அங்கீகாரம்	அங்கீகராம்
angkeekaaram	அங்கீகாரம்	அங்கீகராம்
asan	அசன்	அசன்
aasin	அசின்	ஆசின்
asin	அசின்	அசின்
asaiyaadha	அசையாத	அசையாத
asaiyaatha	அசையாத	அசையாத
stationaree	அசையாத	ஸ்டானியேட்
stationari	அசையாத	ஸ்டானியரர்
stationarii	அசையாத	ஸ்டானியவரி
stationary	அசையாத	ஸ்டாடன்யர்
stationri	அசையாத	ஸ்டூட்னரி
stetionaree	அசையாத	ஸ்டீட்னியேர்
stetionary	அசையாத	ஸ்டேடின்யர்
stetionri	அசையாத	ஸ்டேட்னிரியின்
asaiaamal	அசையாமல்	அசையாமல்
asaiyaamal	அசையாமல்	அசையாமல்
asaiyamal	அசையாமல்	அசையமலால்
ashoka	அசோக	அசோக்
asoga	அசோக	அசோக
asoka	அசோக	அசோக்
ashokarin	அசோகரின்	அசோக்ரின்
asokarin	அசோகரின்	அசோகரின்
ashokar	அசோகர்	அசோகர்
asokar	அசோகர்	அசோகர்
ajai	அஜய்	ஆஜை
ajaii	அஜய்	அஜ்
ajay	அஜய்	ஆஜ்ய்
aje	அஜய்	ஆஜே
azai	அஜய்	அழை
azay	அஜய்	அழை
adakkinaar	அடக்கினார்	அடக்கினார்
adanggiyirukkum	அடங்கியிருக்கும்	அடங்கியின்கும்
adangiyirukkum	அடங்கியிருக்கும்	அடங்கியினுக்கும்
adankiyirukkum	அடங்கியிருக்கும்	அடங்கியினுக்கும்
adangkiyullathu	அடங்கியுள்ளது	அடங்கியுள்ளது
adams	அடம்ஸ்	ஆடம்ஸ்
adigalaal	அடிகளால்	அடிகளால்
adigalin	அடிகளின்	அடிகளின்
adigalil	அடிகளில்	அடிகளில்
adikalil	அடிகளில்	அடிகளில்
adigalai	அடிகளை	அடிகளை
adigazhai	அடிகளை	அடிகாலை
adikalai	அடிகளை	அடிகளை
adigal	அடிகள்	அடிகள்
adikal	அடிகள்	அடிக்கள்
adikkadip	அடிக்கடிப்	அடிக்கடிப்
adikkum	அடிக்கும்	அடிக்கும்
adippadaiyilaana	அடிப்படையிலான	அடிப்படையிலான
adippadaiyilaanadhu	அடிப்படையிலானது	அடிப்படையானது
adippadaiyilaanathu	அடிப்படையிலானது	அடிப்படையாலது
adippadiyilaanathu	அடிப்படையிலானது	அடிப்படியானது
adiyaaga	அடியாக	அடியாக
adiyaga	அடியாக	அடியாக
adiyaka	அடியாக	அடியாக
adiyin	அடியின்	அடியின்
adiyil	அடியில்	அடியில்
atiyil	அடியில்	அடியில்
adiye	அடியே	அடி
adiyee	அடியே	அடியே
atiyee	அடியே	அடி
adiyodu	அடியோடு	அடியோடு
adiyoodu	அடியோடு	அடியோடு
atiyootu	அடியோடு	அடியோடு
adivayirrai	அடிவயிற்றை	அடிவியற்றை
adivayitrai	அடிவயிற்றை	அடிவையிற்றை
adivayittrai	அடிவயிற்றை	அடிவையிற்றை
ativayirrai	அடிவயிற்றை	அடிவையிற்றை
addes	அடிஸ்	ஆட்டிஸ்
addis	அடிஸ்	ஆட்டிஸ்
addiss	அடிஸ்	எட்டிஸ்
addys	அடிஸ்	ஆட்டிஸ்
addyss	அடிஸ்	டைட்சிஸ்
ades	அடிஸ்	அடெஸ்
adis	அடிஸ்	அடிஸ்
adyss	அடிஸ்	அடிஸ்
adukka	அடுக்க	அடுக்க
adukkaaga	அடுக்காக	அடுக்காக
adukkaaka	அடுக்காக	அடுக்காக
atukkaaga	அடுக்காக	அடுக்காக
atukkaaka	அடுக்காக	அடுக்காக
aduththu	அடுத்து	அடுத்து
aduthu	அடுத்து	அடுத்து
adutthu	அடுத்து	அடுத்து
attaak	அட்டாக்	அட்டாக்
attack	அட்டாக்	அட்டாக்
anivadhae	அணிவதே	அணிவதே
anivadhey	அணிவதே	அணிவதி
anivathae	அணிவதே	அணிவதே
anivathey	அணிவதே	அணிவதே
adhigappadiyaana	அதிகப்படியான	அதிகப்படியான
athigappadiyaana	அதிகப்படியான	அதிகப்படியான
athikappatiyaana	அதிகப்படியான	அதிகப்படியான
adhikamaana	அதிகமான	அதிகமான
adikamaana	அதிகமான	அடிகமான
athikamaana	அதிகமான	அதிகமான
atikamaana	அதிகமான	அதிகமான
adhikamaanavai	அதிகமானவை	அதிகமானவை
athigamaanavai	அதிகமானவை	அதிகமானவை
athikamaanavai	அதிகமானவை	அதிகமானவை
adhikamaanoor	அதிகமானோர்	அதிகமானூர்
athigamaanoor	அதிகமானோர்	அதிகமானூர்
athikamaanoar	அதிகமானோர்	அதிகமானோர்
athiradith	அதிரடித்	அதிராத்தி
athiradip	அதிரடிப்	அதிராடிப்
adhilirundhdha	அதிலிருந்த	அதிலிருந்த
athiliruntha	அதிலிருந்த	அதிலிருந்த
adhilulla	அதிலுள்ள	அதிலுள்ள
athilulla	அதிலுள்ள	அதிலுள்ள
adele	அதிலே	அடேல்
adhilae	அதிலே	அதிலே
adhile	அதிலே	அதில்
athilae	அதிலே	அதிலே
athile	அதிலே	அதில்
adheedha	அதீத	அதிதே
adhidha	அதீத	அதித
atheetha	அதீத	அதீத
athitha	அதீத	அதித்த
athaepoola	அதேபோல	அதேபோல
atheepola	அதேபோல	அதீபோல
athepola	அதேபோல	அதேபோல
advaita	அத்வைத	அட்வைட்ட
advaitha	அத்வைத	அட்வைத்த
athvaidha	அத்வைத	அத்வைத
athvaitha	அத்வைத	அத்வைத்த
advaidam	அத்வைதம்	அட்வைடம்
advaitham	அத்வைதம்	அட்வைத்தம்
adwaytham	அத்வைதம்	அடுவாயம்
athvaidham	அத்வைதம்	அத்விதம்
athvaitham	அத்வைதம்	அத்விதம்
andhach	அந்தச்	அந்தச்
anthac	அந்தச்	அந்தாக்
anthach	அந்தச்	அந்தச்
andhath	அந்தத்	அந்தத்
anthath	அந்தத்	அந்தத்
andham	அந்தம்	அந்தம்
antham	அந்தம்	அந்தம்
andhu	அந்து	அந்து
anthu	அந்து	அந்து
ana	அனா	அன்
anaa	அனா	அண்யா
anna	அனா	அண்ணா
annaa	அனா	அண்ணா
anaadhai	அனாதை	அனாதை
anaathai	அனாதை	அனாதை
anaadhaiyaana	அனாதையான	அனந்தாயான
anaathaiyaana	அனாதையான	அனந்தாயான
anupallavee	அனுபல்லவி	அனுபல்பேலே
anupallavi	அனுபல்லவி	அனுபல்பவில்
anupazhavee	அனுபல்லவி	அனுபலேவே
anupazhavi	அனுபல்லவி	அனுபவழி
anubavikkum	அனுபவிக்கும்	அனுபவிக்கும்
anupavikkum	அனுபவிக்கும்	அனுபவிக்கும்
anupavikum	அனுபவிக்கும்	அனுபவிக்கும்
anuraadhapura	அனுராதபுர	அனுதராபபு
anuraathapura	அனுராதபுர	அனுநராபபு
anuradhapura	அனுராதபுர	அனுதரப்பட்ர
anurathapura	அனுராதபுர	அனுதரப்படரர்ற
anushka	அனுஷ்கா	அணுஷ்
anushkaa	அனுஷ்கா	அணுஷ்பா
andriyum	அன்றியும்	அன்றியும்
antriyum	அன்றியும்	அன்றியும்
abaabaa	அபாபா	அபாபா
ababa	அபாபா	அபாபா
abbaba	அபாபா	அப்பா
apapa	அபாபா	அப்பா
aboo	அபூ	அபோ
abu	அபூ	அபு
aboorva	அபூர்வ	அப்ர்வ
apoorva	அபூர்வ	அப்பூர்வ
aboorvamaaga	அபூர்வமாக	அப்துவராக
aboorvamaaka	அபூர்வமாக	அப்த்வமாக
aburvamaaka	அபூர்வமாக	அபுர்வமாக
apoorvamaaga	அபூர்வமாக	அப்பூரமாக
apoorvamaaka	அபூர்வமாக	அப்பூரமாக
abdhul	அப்துல்	ஆப்துல்
abdool	அப்துல்	அப்டோல்
abdul	அப்துல்	ஆப்டல்
abduul	அப்துல்	அப்டல்
abthul	அப்துல்	ஆப்துல்
appaguthiyil	அப்பகுதியில்	அப்பகுதியில்
appakuthiil	அப்பகுதியில்	அப்பகுதில்
appakuthiyil	அப்பகுதியில்	அப்பகுதியில்
appaguthiyai	அப்பகுதியை	அப்பகுதியை
appakuthiai	அப்பகுதியை	அப்பகுதியை
appakuthiyai	அப்பகுதியை	அப்பகுதியை
appadaththin	அப்படத்தின்	அப்படத்தின்
appadatthin	அப்படத்தின்	அப்படத்தின்
appadam	அப்படம்	அப்படம்
appen	அப்பெண்	அப்பெண்
appenn	அப்பெண்	அப்பெண்ணி
appoluthuthaan	அப்பொழுதுதான்	அப்பொழுதுதான்
appoluthuthan	அப்பொழுதுதான்	அப்பொழுத்தன்
appozhuthuthaan	அப்பொழுதுதான்	அப்புதுதுதான்
apppozhuthuthaan	அப்பொழுதுதான்	அப்பொழுதுதான்
aposthalar	அப்போஸ்தலர்	அப்போல்தார்
appoashthalar	அப்போஸ்தலர்	அப்போலத்தா்
appoosthalar	அப்போஸ்தலர்	அப்போல்தார்
apposthalar	அப்போஸ்தலர்	அப்போல்தார்
americargalin	அமெரிக்கர்களின்	அமெர்சிகர்களின்
americarkalin	அமெரிக்கர்களின்	அமெரிக்கர்களின்
amerikkargalin	அமெரிக்கர்களின்	அமெரிக்கர்களின்
amerikkarkalin	அமெரிக்கர்களின்	அமெரிக்கர்களின்
americaavin	அமெரிக்காவின்	அமெரிக்காவின்
americavin	அமெரிக்காவின்	அமெரிக்காவின்
amerikkaavin	அமெரிக்காவின்	அமெரிக்காவின்
americaavirkum	அமெரிக்காவிற்கும்	அமெரிக்காவிறும்
americavirkkum	அமெரிக்காவிற்கும்	அமெரிக்கவீர்கும்
americavirkum	அமெரிக்காவிற்கும்	அமெரிக்கவிற்கும்
amerikkaavirkum	அமெரிக்காவிற்கும்	அமெரிக்காவிற்கும்
americaavilum	அமெரிக்காவிலும்	அமெரிக்காவிலும்
americavilum	அமெரிக்காவிலும்	அமெரிக்கவிலும்
amerikkaavilum	அமெரிக்காவிலும்	அமெரிக்காவிலும்
americaavilulla	அமெரிக்காவிலுள்ள	அமெர்சிக்லாலிலால்
americavilulla	அமெரிக்காவிலுள்ள	அமெரீக்கவில்லாலு
amerikkaavilulla	அமெரிக்காவிலுள்ள	அமெரிக்காவில்லால்
americaavudan	அமெரிக்காவுடன்	அமெரிக்காவுடன்
americavudan	அமெரிக்காவுடன்	அமெரிக்கவாடன்
amerikkaavudan	அமெரிக்காவுடன்	அமெரிக்காவுடன்
americaavum	அமெரிக்காவும்	அமெரிக்காவும்
americavum	அமெரிக்காவும்	அமெரிக்கவும்
amerikkaavum	அமெரிக்காவும்	அமெரிக்காவும்
amaichchu	அமைச்சு	அமைச்சு
amaichu	அமைச்சு	அமைச்சு
amaiththup	அமைத்துப்	அமைத்துப்
amaithup	அமைத்துப்	அமைத்துப்
amaitthup	அமைத்துப்	அமைத்துப்
amaiththum	அமைத்தும்	அமைத்தும்
amaithum	அமைத்தும்	அமைத்தும்
amaitthum	அமைத்தும்	அமைத்தும்
perrullatu	அமையப்	பெர்ளுடல்
petrtrullathu	அமையப்	பெற்றுள்ளது
petrullathu	அமையப்	பெற்றுள்ளது
amsa	அம்ச	அம்சா
amchankalaaka	அம்சங்களாக	அம்சங்களாக
amchankalaka	அம்சங்களாக	அம்சங்களாக
amsangalaaga	அம்சங்களாக	அம்சங்களாக
amsangkalaaka	அம்சங்களாக	அம்சங்களாக
amachankalin	அம்சங்களின்	அமசங்களின்
amasankalin	அம்சங்களின்	அமசங்களின்
amsangalin	அம்சங்களின்	அம்சங்களின்
amsangkalin	அம்சங்களின்	அம்சங்களின்
amchankalai	அம்சங்களை	அம்சங்களை
amsangalai	அம்சங்களை	அம்சங்களை
amsankalai	அம்சங்களை	அம்சங்களை
amsangalaiyum	அம்சங்களையும்	அம்சங்களையும்
amsangazhaiyum	அம்சங்களையும்	அம்சங்களையும்
amsanggalaiyum	அம்சங்களையும்	அம்சங்களையும்
amsangal	அம்சங்கள்	அம்சங்கள்
amsangazh	அம்சங்கள்	அம்சங்கள்
amsanggal	அம்சங்கள்	அம்சங்கள்
amsamaaga	அம்சமாக	அம்சமாக
amcham	அம்சம்	அம்மாக்
amsam	அம்சம்	அம்மாக்
ammonium	அம்மோனியம்	அம்மோனியம்
ammoniumm	அம்மோனியம்	அம்மோனியம்
ammoniuum	அம்மோனியம்	அம்மோனியம்
ammoniuumm	அம்மோனியம்	அம்மோனியம்
ammoonium	அம்மோனியம்	அம்மோனியம்
ammooniumm	அம்மோனியம்	அம்மோனியம்
ammooniyam	அம்மோனியம்	அம்மோனியம்
amoniam	அம்மோனியம்	அமோனியம்
amoniamm	அம்மோனியம்	அமோனியம்
amonium	அம்மோனியம்	அமோனியம்
amoniuum	அம்மோனியம்	அமோனியம்
amonnium	அம்மோனியம்	அமோனியம்
amonniuum	அம்மோனியம்	அமோனியும்
amooniamm	அம்மோனியம்	அமோனியம்
amoonium	அம்மோனியம்	அமோனியம்
amoonnium	அம்மோனியம்	அமுனியம்
ammonia	அம்மோனியா	அம்மோனியா
ammoniaa	அம்மோனியா	அம்மோனியா
ammoniia	அம்மோனியா	அம்மோனியா
ammoonia	அம்மோனியா	அம்மோனியா
ammooniaa	அம்மோனியா	அம்மோனியா
ammooniia	அம்மோனியா	அம்மோனியா
ammooniya	அம்மோனியா	அம்மோனியா
amonia	அம்மோனியா	அமோனியா
amoniaa	அம்மோனியா	அமோனியா
amoniia	அம்மோனியா	அமோனியா
amoonia	அம்மோனியா	அமோனியா
arakkanai	அரக்கனை	அரக்கனை
arrakkanai	அரக்கனை	அறக்கன்்
aruga	அருக	அருக
aruka	அருக	அருக
arugaaga	அருகாக	அருகாக
arukaaka	அருகாக	அருகாக
arukaka	அருகாக	அருகக
aarun	அருண்	ஆருண்
aaruun	அருண்	ஆருண்
aroon	அருண்	அரோன்
arrun	அருண்	அறுன்
arruun	அருண்	அருண்
arun	அருண்	அருண்
arunn	அருண்	அருண்
aruun	அருண்	அருண்
aruunn	அருண்	அருண்
vijai	அருண்	விஜய்
vijay	அருண்	விஜய்
arundhi	அருந்தி	அருந்தி
arunthi	அருந்தி	அருந்தி
arppaniththaar	அர்ப்பணித்தார்	அற்ப்பினத்தார்
arppaniththu	அர்ப்பணித்து	அற்ப்பநித்து
arimuga	அறிமுகம	அறிமுக
arimugama	அறிமுகம	அறிமுகமா
arimuka	அறிமுகம	அறிமுக
mudikirathu	அறிய	முடிகிறது
mudiyaatha	அறிய	முடியாத
mutikiratu	அறிய	முடிகிறது
mutiyata	அறிய	முட்டிய
ariyak	அறியக்	அரியக்
ariyakkoodiya	அறியக்கூடிய	அறியக்கூடிய
ariyappadum	அறியப்படும்	அறியப்படும்
ariyappattavar	அறியப்பட்டவர்	அறியப்பட்டவர்
ariyappattaar	அறியப்பட்டார்	அறியப்பட்டார்
ariyappattaalum	அறியப்பட்டாலும்	அறியப்பட்டலாலும்
ariyappattulladhu	அறியப்பட்டுள்ளது	அறியப்பட்டுள்ளது
ariyappattullathu	அறியப்பட்டுள்ளது	அறியப்பட்டுள்ளது
ariyavillai	அறியவில்லை	அறியவில்லை
ariyavum	அறியவும்	அறியவும்
ariyaa	அறியா	அரியா
ariyaamal	அறியாமல்	அறியாமல்
arivadhil	அறிவதில்	அறிவதில்
arivathaal	அறிவதில்	அறிவதால்
arivathil	அறிவதில்	அறிவதில்
arivaar	அறிவார்	அறிவார்
arivaal	அறிவால்	அறிவால்
arivippu	அறிவிப்பு	அறிவிப்பு
arivippugal	அறிவிப்புகள்	அறிவிப்புகள்
arivippukal	அறிவிப்புகள்	அறிவிப்புகள்
arivippup	அறிவிப்புப்	அறிவிப்புப்
arivae	அறிவே	அறிவே
arupathu	அறுபது	அருபது
ali	அலி	அல்லி
alii	அலி	அல்லி
aligaar	அலிகார்	அலிகார்
aligar	அலிகார்	அலிகர்
aligarh	அலிகார்	அலிகர்
alikaar	அலிகார்	அலிகார்
aliyin	அலியின்	அலினி
aliyai	அலியை	அலியை
alboansaa	அல்போன்சா	ஆல்போனான்
alphonse	அல்போன்சா	ஆல்போன்ஸ்
alpoansaa	அல்போன்சா	அல்போனான்
alavu	அளவு	அளவு
alavugalail	அளவுகளில்	அலவுகளைல்
alavugalil	அளவுகளில்	அலவுகளில்
alavukalil	அளவுகளில்	அலவுகளில்
alavugalaik	அளவுகளைக்	அலவுகளைக்
alavukalaik	அளவுகளைக்	அலவுகளைக்
alavugalaiyum	அளவுகளையும்	அலவுகளையும்
alavukalaiyum	அளவுகளையும்	அலவுகளையும்
alavukkaana	அளவுக்கான	அளுவக்கான
alavukku	அளவுக்கு	அளவுக்கு
alavudan	அளவுடன்	அளவுடன்
alavum	அளவும்	அளவும்
azhiththa	அழித்த	அழித்த
azhiththal	அழித்தல்	அழித்தல்
alaippugalai	அழைப்புகளை	அழைப்புகளை
alaippukalai	அழைப்புகளை	அழைப்புகளை
azhaippukalai	அழைப்புகளை	அழைப்புகளை
alaippugal	அழைப்புகள்	அழைப்புகள்
alaippukal	அழைப்புகள்	அழைப்புகள்
azhaippukal	அழைப்புகள்	அழைப்புகள்
avadhaara	அவதார	அவதார
avathaara	அவதார	அவதார
avathaaranggalai	அவதாரங்களை	அவதாரங்களை
avathaarangkalai	அவதாரங்களை	அவதாரங்களை
avathaaramaaga	அவதாரமாக	அவதாராமாக
avathaaramaaka	அவதாரமாக	அவதாரமாக
avathaaramaana	அவதாரமான	அவதாராமான
avadhaaram	அவதாரம்	அவதாரம்
avathaaram	அவதாரம்	அவதாரம்
avaraagavae	அவராகவே	அவராகவே
avaraakavae	அவராகவே	அவராகவே
avaridamae	அவரிடமே	அவரிடமே
avaritamae	அவரிடமே	அவரிடம்
avatrtrul	அவற்றுள்	அவற்றுள்
avatrul	அவற்றுள்	அவற்றுள்
avattrul	அவற்றுள்	அவற்றுள்
avalum	அவளும்	அவலும்
avalai	அவளை	அவலை
astro	அஸ்ட்ரோ	ஆஸ்டோரி
astroa	அஸ்ட்ரோ	ஸ்டோரியா
aagindradhu	ஆகின்றது	ஆகின்றது
aagindrathu	ஆகின்றது	ஆகின்றது
aakinrathu	ஆகின்றது	ஆகின்றது
aakintrathu	ஆகின்றது	ஆகின்றது
aasirama	ஆசிரம	ஆசிரம்
aasiramaththin	ஆசிரமத்தின்	ஆசிரமதத்தின்
aachiramaththai	ஆசிரமத்தை	ஆசிரம்ததை
aasiramaththai	ஆசிரமத்தை	ஆசிரமத்தை
aachiriyaraaka	ஆசிரியராக	ஆசிரிராயாக
aasiriyaraaga	ஆசிரியராக	ஆசிரியராக
aasiriyaraaka	ஆசிரியராக	ஆசிரியாக
assiriyaraaga	ஆசிரியராக	ஆஸ்திரியாக
aasiriyaraakak	ஆசிரியராகக்	ஆசிரியாகர்க
assiriyaraagak	ஆசிரியராகக்	ஆசிரியாகரகக்
asar	ஆசேர்	ஆசர்
aseer	ஆசேர்	அசீர்
aser	ஆசேர்	அசர்
ashar	ஆசேர்	ஆஷார்
asher	ஆசேர்	ஆசர்
iser	ஆசேர்	ஐஸ்
ysar	ஆசேர்	யார்
yseer	ஆசேர்	சேரர்
yser	ஆசேர்	ஐஸ்
ysher	ஆசேர்	ஐசர்
aadi	ஆடி	ஆடி
aadii	ஆடி	ஆடி
adi	ஆடி	அடி
adii	ஆடி	அடி
aodi	ஆடி	ஆடி
aodii	ஆடி	அட்டி
audi	ஆடி	ஆடி
audii	ஆடி	ஆட்டி
auudi	ஆடி	ஆடி
avdi	ஆடி	ஆவிடி
awdi	ஆடி	அவ்டி
awdii	ஆடி	அவ்டி
maatham	ஆடி	மாதம்
matam	ஆடி	மடம்
aadu	ஆடு	ஆடு
aadukalin	ஆடுகளின்	ஆடுகளின்
aadugalukku	ஆடுகளுக்கு	ஆடுகளுக்கு
aadukalukku	ஆடுகளுக்கு	ஆடுகளுக்கு
aadugalai	ஆடுகளை	ஆடுகளை
aadukalai	ஆடுகளை	ஆடுகளை
aadugal	ஆடுகள்	ஆடுகள்
aadukal	ஆடுகள்	ஆடுகள்
aanaagap	ஆணாகப்	ஆணாகப்
aanaakap	ஆணாகப்	ஆனாகப்
kulantai	ஆண்	குழந்தை
kulanthai	ஆண்	குழந்தை
kuzhandhai	ஆண்	குழந்தை
aangalil	ஆண்களில்	ஆங்களில்
aankalil	ஆண்களில்	ஆங்களில்
aangalikku	ஆண்களுக்கு	ஆங்களிக்கு
aangalukku	ஆண்களுக்கு	ஆங்களுக்கு
aangalukkum	ஆண்களுக்கும்	ஆங்களுக்கும்
aankalukkum	ஆண்களுக்கும்	ஆங்களுக்கும்
aangaludan	ஆண்களுடன்	ஆங்களுடன்
aankaludan	ஆண்களுடன்	ஆங்களுடன்
aangalai	ஆண்களை	ஆங்களை
aankalai	ஆண்களை	ஆங்கலை
aangalaiyum	ஆண்களையும்	ஆங்களையும்
aankalaiyum	ஆண்களையும்	ஆங்களையும்
aankaliayum	ஆண்களையும்	ஆங்களியும்
aandaan	ஆண்டான்	ஆண்டான்
aantaan	ஆண்டான்	ஆண்டான்
aandaar	ஆண்டார்	ஆண்டார்
aantaar	ஆண்டார்	ஆண்டார்
aadhanaal	ஆதனால்	ஆதனால்
aathanaal	ஆதனால்	ஆதனால்
aatharavaliththa	ஆதரவளித்த	ஆதரவலித்த
aatharavaliththu	ஆதரவளித்து	ஆதரவல்த்து
aatharavaagap	ஆதரவாகப்	ஆதரவாகப்
aatharavaakap	ஆதரவாகப்	ஆதரவாகப்
aatharavaap	ஆதரவாகப்	ஆதரவாப்
aatharavaagavum	ஆதரவாகவும்	ஆதரவாகவும்
aatharavaakavum	ஆதரவாகவும்	ஆதரவாகவும்
aatharavin	ஆதரவின்	ஆதரவின்
aatharavil	ஆதரவில்	ஆதரவில்
aatharikka	ஆதரிக்க	ஆதரிக்க
aatharikkum	ஆதரிக்கும்	ஆதரிக்கும்
aathmaavum	ஆத்மாவும்	ஆத்மாவும்
aathmaavai	ஆத்மாவை	ஆத்மாவை
aanthaigal	ஆந்தைகள்	ஆண்தைகள்
aanthaikal	ஆந்தைகள்	ஆண்தைகள்
aanththaigal	ஆந்தைகள்	ஆந்தைகள்
aanththaikal	ஆந்தைகள்	ஆந்தைகள்
aanand	ஆனந்த்	ஆனந்த்
aananth	ஆனந்த்	ஆனந்த்
aananthdh	ஆனந்த்	ஆனந்தி
aananthth	ஆனந்த்	ஆனந்தி
anand	ஆனந்த்	அண்்ட்
anandd	ஆனந்த்	அணந்த்
anandh	ஆனந்த்	அணந்த்
anannd	ஆனந்த்	அணந்த்
annt	ஆனந்த்	அன்ட்
aanmaavin	ஆன்மாவின்	ஆன்மாவின்
aanmaavai	ஆன்மாவை	ஆன்மாவை
aabathaithk	ஆபத்தைக்	ஆபத்தைக்
aabaththaik	ஆபத்தைக்	ஆபத்தைக்
aapaththaik	ஆபத்தைக்	ஆபத்தைக்
aapgaaniya	ஆப்கானிய	ஆப்கானிய
aapkaaniya	ஆப்கானிய	ஆப்காணிய
afghaaniya	ஆப்கானிய	ஆப்கானிய
afghaniya	ஆப்கானிய	ஆப்கானிய
aappirikkaa	ஆப்பிரிக்கா	ஆப்பிரிக்கா
aaprikkaa	ஆப்பிரிக்கா	ஆப்ரிக்கா
affrica	ஆப்பிரிக்கா	ஆப்பிரிக்கா
afreca	ஆப்பிரிக்கா	ஆப்ரேக்
africa	ஆப்பிரிக்கா	ஆப்ரிக்கா
africaa	ஆப்பிரிக்கா	ஆப்ரிக்கா
afrika	ஆப்பிரிக்கா	ஆப்ரிக்கா
afriqa	ஆப்பிரிக்கா	ஆப்ரிக்கா
aphphrica	ஆப்பிரிக்கா	ஆப்பிரிக்க
aphreca	ஆப்பிரிக்கா	ஆப்ரேக்
aphrica	ஆப்பிரிக்கா	ஆப்ரிக்கா
aphricaa	ஆப்பிரிக்கா	ஆப்ரிகாசா
aphrika	ஆப்பிரிக்கா	ஆப்ரிக்க
appirikka	ஆப்பிரிக்கா	ஆப்பிரிக்க
appricaa	ஆப்பிரிக்கா	ஆப்பிராஜ்
efrica	ஆப்பிரிக்கா	எப்ரிக்கா
ephrica	ஆப்பிரிக்கா	எப்ரிக்கா
aappirikkaavin	ஆப்பிரிக்காவின்	ஆப்பிரிக்காவின்
africaavin	ஆப்பிரிக்காவின்	ஆப்ரிக்காவின்
aappirikkaavil	ஆப்பிரிக்காவில்	ஆப்பிரிக்காவில்
africaavil	ஆப்பிரிக்காவில்	ஆப்ரிக்காவில்
africavil	ஆப்பிரிக்காவில்	ஆப்ரிக்காவில்
ain	ஆயின்	ஐன்
ainn	ஆயின்	ஐய்ன்
ayin	ஆயின்	அயின்
ein	ஆயின்	ஐயின்
einn	ஆயின்	என்
en	ஆயின்	என்
enn	ஆயின்	என்
aayerak	ஆயிரக்	ஆயரரகக்
aayirak	ஆயிரக்	ஆயிரக்
aayeraththil	ஆயிரத்தில்	ஆயரரத்தில்
aayiraththil	ஆயிரத்தில்	ஆயிரத்தில்
aayut	ஆயுட்	ஆயுத்
out	ஆயுட்	ஆட்
aaivu	ஆய்வு	ஆய்வு
aayvu	ஆய்வு	ஆய்வு
aaivukalilum	ஆய்வுகளிலும்	ஆய்வுகளிலும்
aayvugalilum	ஆய்வுகளிலும்	ஆய்வுகளிலும்
aayvukalilum	ஆய்வுகளிலும்	ஆய்வுகளிலும்
aaivukalil	ஆய்வுகளில்	ஆய்வுகளில்
aayvugalil	ஆய்வுகளில்	ஆய்வுகளில்
aayvukalil	ஆய்வுகளில்	ஆய்வுகளில்
aaivukalum	ஆய்வுகளும்	ஆய்வுகளும்
aayvugalum	ஆய்வுகளும்	ஆய்வுகளும்
aayvukalum	ஆய்வுகளும்	ஆய்வுகளும்
aaivukalai	ஆய்வுகளை	ஆய்வுகளை
aayvugalai	ஆய்வுகளை	ஆய்வுகளை
aayvukalai	ஆய்வுகளை	ஆய்வுகளை
aaivukkum	ஆய்வுக்கும்	ஆய்வுக்கும்
aayvukkum	ஆய்வுக்கும்	ஆய்வுக்கும்
aaivuch	ஆய்வுச்	ஆய்வுச்
aayvuch	ஆய்வுச்	ஆய்வுச்
aaivup	ஆய்வுப்	ஆய்வுப்
aayvup	ஆய்வுப்	ஆய்வுப்
aaraathanaa	ஆராதனா	ஆராதனா
aradhana	ஆராதனா	அரதன
aaraayndha	ஆராய்ந்த	ஆராய்ந்த
aaraayntha	ஆராய்ந்த	ஆராய்ந்த
aaraaynththa	ஆராய்ந்த	ஆராய்ந்த
aaraayndhanar	ஆராய்ந்தனர்	ஆராந்தனர்
aaraaynthanar	ஆராய்ந்தனர்	ஆராயந்தனர்
aaraaynththanar	ஆராய்ந்தனர்	ஆராயந்தனர்
aaraainthaar	ஆராய்ந்தார்	ஆராய்ந்தார்
aaraaynthaar	ஆராய்ந்தார்	ஆராய்ந்தார்
aaraaynththaar	ஆராய்ந்தார்	ஆராய்ந்தார்
aaraainthu	ஆராய்ந்து	ஆராண்த்து
aaraaynthu	ஆராய்ந்து	ஆராய்ந்து
araaynththu	ஆராய்ந்து	அராய்ந்து
aariyargalaal	ஆரியர்களால்	ஆரியர்களால்
aariyarkalaal	ஆரியர்களால்	ஆரியர்களால்
aariyargal	ஆரியர்கள்	ஆரியர்கள்
aariyarkal	ஆரியர்கள்	ஆரியர்கள்
aardar	ஆர்டர்	ஆர்டர்
ardar	ஆர்டர்	ஆர்டர்
arder	ஆர்டர்	ஆர்டர்
ordar	ஆர்டர்	ஒர்டர்
order	ஆர்டர்	ஆர்டர்
aarppaattaththil	ஆர்ப்பாட்டத்தில்	ஆற்ப்பாட்டத்தில்
aarva	ஆர்வ	ஆர்வ
aarvaththaal	ஆர்வத்தால்	ஆர்வத்தால்
aarvaththin	ஆர்வத்தின்	ஆர்வத்தின்
aarvaththukku	ஆர்வத்துக்கு	ஆர்த்துக்கு
aarvaththudan	ஆர்வத்துடன்	ஆர்த்துடன்
aarvaththutan	ஆர்வத்துடன்	ஆர்த்துடன்
aarvaththaiyum	ஆர்வத்தையும்	ஆர்வத்தையும்
aarvamaaga	ஆர்வமாக	ஆர்மவாக
aarvamaaka	ஆர்வமாக	ஆர்மவாக
aarvam	ஆர்வம்	ஆர்வம்
aarvalarum	ஆர்வலரும்	ஆர்வலாரும்
aarvee	ஆர்வி	ஆர்வே
aarvi	ஆர்வி	ஆர்வி
harvey	ஆர்வி	ஹர்வே
aaraam	ஆறாம்	ஆராம்
aaruthal	ஆறுதல்	ஆருதல்
aatralaaka	ஆற்றலாக	ஆற்றலாக
aatrtralaaga	ஆற்றலாக	ஆற்றலாக
aatrtralaaka	ஆற்றலாக	ஆற்றலாக
aatrtralum	ஆற்றலும்	ஆற்றலும்
aattralum	ஆற்றலும்	ஆற்றலும்
aatrtralae	ஆற்றலே	ஆற்றலே
aatrtralilae	ஆற்றலே	ஆற்றலிலே
aattralae	ஆற்றலே	ஆற்றலே
aattrale	ஆற்றலே	ஆற்றல்
aatri	ஆற்றி	ஆற்றி
aatrtri	ஆற்றி	ஆற்றி
aattree	ஆற்றி	ஆற்டே
aattri	ஆற்றி	ஆற்றி
aatrtrinaar	ஆற்றினார்	ஆற்றினார்
aattrinaar	ஆற்றினார்	ஆற்றினார்
aatrtrin	ஆற்றின்	ஆற்றின்
aattrin	ஆற்றின்	ஆற்றின்
aatrtril	ஆற்றில்	ஆற்றில்
aattril	ஆற்றில்	ஆற்றில்
aatrtruppaduththum	ஆற்றுப்படுத்தும்	ஏற்றுப்படுத்தும்
aattruppaduththum	ஆற்றுப்படுத்தும்	ஏற்றுப்படுத்தும்
aattruppadutthum	ஆற்றுப்படுத்தும்	ஏற்றுப்படுத்தும்
aatrtrum	ஆற்றும்	ஆற்றும்
aattrum	ஆற்றும்	ஏற்றும்
aalaya	ஆலய	ஆலைய
aalayangalil	ஆலயங்களில்	ஆலயங்களில்
aalayanggalil	ஆலயங்களில்	ஆலயங்களில்
aalayangkalil	ஆலயங்களில்	ஆலயங்களில்
aalayankalil	ஆலயங்களில்	ஆலயங்களில்
aalayangal	ஆலயங்கள்	ஆலயங்கள்
aalayanggal	ஆலயங்கள்	ஆலயங்கள்
aalayangkal	ஆலயங்கள்	ஆலயங்கள்
aalayankal	ஆலயங்கள்	ஆலயங்கள்
aalayach	ஆலயச்	ஆலயச்
aalayaththin	ஆலயத்தின்	ஆலயத்தின்
aalayatthin	ஆலயத்தின்	ஆலயத்தின்
aalayaththil	ஆலயத்தில்	ஆயலத்தில்
aalayaththai	ஆலயத்தை	ஆலயத்தை
aalayamaaga	ஆலயமாக	ஆலையமாக
aalayamaaka	ஆலயமாக	ஆலையமாக
aalayam	ஆலயம்	ஆலையம்
aaloachanai	ஆலோசனை	ஆலோசனை
aaloasanai	ஆலோசனை	ஆலோசனை
aalosanai	ஆலோசனை	ஆலோசனை
aaloachanaikalai	ஆலோசனைகளை	ஆலோசனைகளை
aaloasanaigalai	ஆலோசனைகளை	ஆலோசனைகளை
aaloasanaikalai	ஆலோசனைகளை	ஆலோசனைகளை
aalosanaigalai	ஆலோசனைகளை	ஆலோசனைகளை
aalosanaikalai	ஆலோசனைகளை	ஆலோசனைகளை
aaloachanaik	ஆலோசனைக்	ஆலோசனைக்
aaloasanaik	ஆலோசனைக்	ஆலோசனைக்
aalosanaik	ஆலோசனைக்	ஆலோசனைக்
aaloasanaiyin	ஆலோசனையின்	ஆலோசனையின்
aalosanaiyin	ஆலோசனையின்	ஆலோசனியன்
aalosanaiyinpadi	ஆலோசனையின்	ஆலோசனிடைியை
aaloasanaiyai	ஆலோசனையை	ஆலோசனையை
aalosanaiyai	ஆலோசனையை	ஆலோசனையை
aashis	ஆஷிஷ்	ஆஷிஸ்
aashish	ஆஷிஷ்	ஆஷிஷ்
aasis	ஆஷிஷ்	ஆசிஸ்
asees	ஆஷிஷ்	அசிஸ்
asheesh	ஆஷிஷ்	அஷிஷ்
ashish	ஆஷிஷ்	அஷிஷ்
asiis	ஆஷிஷ்	அசிஸ்
asis	ஆஷிஷ்	அசிஸ்
aash	ஆஷ்	ஆஷ்
ash	ஆஷ்	ஷா்
engkae	இங்கே	எங்கே
ingae	இங்கே	இங்கே
ingkae	இங்கே	இங்கே
engkaeyae	இங்கேயே	எங்கேயே
ingaeyae	இங்கேயே	இங்கேயே
ingkaeyae	இங்கேயே	இங்கேயே
ichaikkaruvikalin	இசைக்கருவிகளின்	இசைக்கருவிகளின்
isaikkaruvigalin	இசைக்கருவிகளின்	இசைக்கருவிகளின்
ichaikkaruvikal	இசைக்கருவிகள்	இசைக்குறவில்
isaikkaruvigal	இசைக்கருவிகள்	இசைக்கருவிகள்
isaiyamaippaalar	இசையமைப்பாளர்	இசையமைப்பாளர்
isaiymaippaalar	இசையமைப்பாளர்	இசையம்பைப்ளார்
isaiyamaippaalargalin	இசையமைப்பாளர்களின்	இசையமைப்பாளர்களின்
isaiyamaippaalargalil	இசையமைப்பாளர்களில்	இசையமைப்பாளர்களில்
isaiyamaippaalargal	இசையமைப்பாளர்கள்	இசையமைப்பாளர்கள்
echchaalai	இச்சாலை	எச்சாளை
ichchaalai	இச்சாலை	இச்சாலை
echchaalaiyil	இச்சாலையில்	இச்சாலையில்
ichchaalaiyil	இச்சாலையில்	இச்சாலையில்
idaththilulla	இடத்திலுள்ள	இடத்திலுள்ள
idamaagavum	இடமாகவும்	இடமாகவும்
idamthaan	இடம்தான்	இடம்தான்
idampeyarum	இடம்பெயரும்	இடம்பெறும்
idugai	இடுகை	இடுகை
idugaigal	இடுகைகள்	இடுகைகள்
idaik	இடைக்	இடைக்
idaiyae	இடையே	இடையே
idaiyaeyum	இடையேயும்	இடையையும்
inaiyaana	இணையான	இணையான
idhanathu	இதனது	இதனது
ithanathu	இதனது	இதனது
idhanil	இதனில்	இதனில்
ithanil	இதனில்	இத்தனில்
idhanpoathu	இதன்போது	இதன்போது
ithanpoathu	இதன்போது	இதன்போது
idazhaalar	இதழாளர்	இதழாளர்
idhazhaalar	இதழாளர்	இதழாளர்
ithalaalar	இதழாளர்	இதலாலர்
ithazhaalar	இதழாளர்	இதழாளர்
iththiraippadaththil	இத்திரைப்படத்தில்	இத்திரைப்பட்டத்தில
iththiraippadam	இத்திரைப்படம்	இத்திரைப்படம்
iththirappadam	இத்திரைப்படம்	இத்திரப்படம்
iththeevin	இத்தீவின்	இத்தீவின்
iththaervil	இத்தேர்வில்	இத்தெர்வில்
iththervil	இத்தேர்வில்	இத்தெர்வில்
iththoguppil	இத்தொகுப்பில்	இத்தொகுப்பில்
iththokuppil	இத்தொகுப்பில்	இத்தொகுப்பில்
iththogaiyai	இத்தொகையை	இத்தொகையை
iththokaiyai	இத்தொகையை	இத்தோகையை
india	இந்தியா	இந்தியா
indiia	இந்தியா	இந்தியா
indiiaa	இந்தியா	இந்தியா
indiya	இந்தியா	இந்திய
indiyaa	இந்தியா	இந்தியா
inthiyaa	இந்தியா	இந்தியா
inththiyaa	இந்தியா	இந்தியா
intiya	இந்தியா	இந்திய
indiavin	இந்தியாவின்	இந்தியாவின்
inthiyaavin	இந்தியாவின்	இந்தியாவின்
inththiyaavin	இந்தியாவின்	இந்தியாவின்
indiavilum	இந்தியாவிலும்	இந்தியாவிலும்
inthiyaavilum	இந்தியாவிலும்	இந்தியாவிலும்
inththiyaavilum	இந்தியாவிலும்	இந்தியாவிலும்
indiavilulla	இந்தியாவிலுள்ள	இந்தியாவில்லு
inthiyaavilulla	இந்தியாவிலுள்ள	இந்தியாவிலுள்ள
inththiyaavilulla	இந்தியாவிலுள்ள	இந்தியாவிலுள்ள
indiavukkaana	இந்தியாவுக்கான	இந்தியாவுக்கான
inthiyaavukkaana	இந்தியாவுக்கான	இந்தியாவுக்கான
inththiyaavukkaana	இந்தியாவுக்கான	இந்தியாவுக்கான
indiavukku	இந்தியாவுக்கு	இந்தியாவுக்கு
inthiyaavukku	இந்தியாவுக்கு	இந்தியாவுக்கு
inththiyaavukku	இந்தியாவுக்கு	இந்தியாவுக்கு
indiavudan	இந்தியாவுடன்	இந்தியாவடடன்
inthiyaavudan	இந்தியாவுடன்	இந்தியாவுடன்
inththiyaavudan	இந்தியாவுடன்	இந்தியாவுடன்
indiavum	இந்தியாவும்	இந்தியாவும்
inthiyaavum	இந்தியாவும்	இந்தியாவும்
inththiyaavum	இந்தியாவும்	இந்தியாவும்
indhukkalaal	இந்துக்களால்	இந்துக்கலால்
indhukkalin	இந்துக்களின்	இந்துக்களின்
indhukkalil	இந்துக்களில்	இந்துக்களில்
indhukkalin	இந்துக்களில்	இந்துக்களின்
indhukkalum	இந்துக்களும்	இந்துகளும்
hindukkalaiyum	இந்துக்களையும்	ஹிந்துகளையும்
indhukkalaiyum	இந்துக்களையும்	இந்துக்களையும்
hindukkal	இந்துக்கள்	ஹிந்துக்கள்
indhukkal	இந்துக்கள்	இந்துக்கள்
inthoa	இந்தோ	இந்தோ
inththoa	இந்தோ	இந்தோ
innaattin	இந்நாட்டின்	இந்நாட்டின்
inthnaattin	இந்நாட்டின்	இந்நாட்டின்
innigazhvu	இந்நிகழ்வு	இந்நிகழு
inthnikalvu	இந்நிகழ்வு	இந்நிகழ்வு
inniruvanaththin	இந்நிறுவனத்தின்	இன்றுவினத்தின்
inthniruvanaththin	இந்நிறுவனத்தின்	இந்நிருவதினதன்
inniruvanaththil	இந்நிறுவனத்தில்	இன்னுறிவத்தில்
inthniruvanaththil	இந்நிறுவனத்தில்	இந்நிருவதினத்தில
inaththavargalin	இனத்தவர்களின்	இனத்தவர்களின்
inaththavarkalin	இனத்தவர்களின்	இனத்தவர்களின்
inaththavargal	இனத்தவர்கள்	இனத்தவர்கள்
inaththavarkal	இனத்தவர்கள்	இனத்தவர்கள்
inaam	இனாம்	இனாம்
inimai	இனிமை	இனிமை
inimaiyaaga	இனிமையாக	இனிமையாக
inimaiyaaka	இனிமையாக	இனிமையாக
inimaiyaana	இனிமையான	இன்மையான
innalgalukku	இன்னல்களுக்கு	இன்நல்களுக்கு
innelkalukku	இன்னல்களுக்கு	இந்நெலுக்களு
innalgalai	இன்னல்களை	இன்நல்களை
innalkalai	இன்னல்களை	இன்நல்களை
innelkalai	இன்னல்களை	இந்நெல்களை
indriyae	இன்றியே	இன்றியே
inriya	இன்றியே	இன்றிய
intriyae	இன்றியே	இன்றியே
ippayir	இப்பயிர்	இப்பையர்
ippalliyin	இப்பள்ளியின்	இப்பல்லியின்
ippoathellaam	இப்போதெல்லாம்	இப்போல்லாம்
ippothellaam	இப்போதெல்லாம்	இப்பொல்ல்லாம்
imayamalai	இமயமலை	இமையமாலை
imayamalaiyil	இமயமலையில்	இமைமாலயையில்
imchai	இம்சை	இம்சை
imsai	இம்சை	இம்சை
eemfal	இம்பால்	ஏம்பால்
eemphal	இம்பால்	ஏம்பல்
emfal	இம்பால்	எம்பால்
emphal	இம்பால்	எம்பால்
iimphal	இம்பால்	இம்பால்
imfal	இம்பால்	இம்பால்
impal	இம்பால்	இம்பால்
imphal	இம்பால்	இம்பால்
immaraththin	இம்மரத்தின்	இம்மாரத்தின்
eiyakkum	இயக்கும்	இயக்கும்
iyakkum	இயக்கும்	இயக்கும்
eiyanra	இயன்ற	இயன்ற
iyandra	இயன்ற	இயன்ற
iyantra	இயன்ற	இயற்ற
eiyanrathu	இயன்றது	இயன்றது
iyandradhu	இயன்றது	இயன்றது
iyantrathu	இயன்றது	இயற்றது
eiyalpai	இயல்பை	இயல்பை
iyalbai	இயல்பை	இயல்பை
iyalbhai	இயல்பை	இயல்பை
iyalpai	இயல்பை	இயல்பை
eiyalpaik	இயல்பைக்	இயல்பைக்
iyalbaik	இயல்பைக்	இயல்பைக்
iyalpaik	இயல்பைக்	இயல்பைக்
eraani	இராணி	இராணி
iraani	இராணி	இராணி
raani	இராணி	ரானி
irukkakkoodiya	இருக்கக்கூடிய	இருக்கக்கூடிய
irukkath	இருக்கத்	இருக்கத்
irukkavum	இருக்கவும்	இருக்கவும்
irukkavae	இருக்கவே	இருக்கவே
irukkavea	இருக்கவே	இருக்கவே
irunooru	இருநூறு	இருநூறு
irunoorukkum	இருநூறுக்கும்	இருந்துருக்கும்
irupaal	இருபால்	இருபால்
iruppu	இருப்பு	இருப்பு
irrupputh	இருப்புத்	இருப்புத்
irupputh	இருப்புத்	இருப்புத்
irruppup	இருப்புப்	இருப்புப்
iruppup	இருப்புப்	இருப்புப்
iruppaik	இருப்பைக்	இருப்பைக்
iruma	இரும	இரும
irumbu	இரும்பு	இரும்பு
irumpu	இரும்பு	இரும்பு
irumbuk	இரும்புக்	இரும்புக்
irumpuk	இரும்புக்	இரும்புக்
irumbuch	இரும்புச்	இரும்புச்
irumpuch	இரும்புச்	இரும்புச்
irul	இருள்	இருல்
erangku	இறங்கு	இறங்கு
irangku	இறங்கு	இறங்கு
irangu	இறங்கு	இறங்கு
erangkum	இறங்கும்	இறங்கும்
irangkum	இறங்கும்	இரங்கும்
irangum	இறங்கும்	இரங்கும்
erappai	இறப்பை	இரப்பை
irappai	இறப்பை	இரப்பை
iravaadha	இறவாத	இரவாத
iravaatha	இறவாத	இரவாத
iruga	இறுக	இருக
iruka	இறுக	இருக
irugiya	இறுகிய	இருகிய
irukiya	இறுகிய	இருகிய
irukkiya	இறுகிய	இருக்கிய
irugum	இறுகும்	இருகும்
irukum	இறுகும்	இருகும்
iraivan	இறைவன்	இறைவன்
ilakkangal	இலக்கங்கள்	இலக்கங்கள்
ilakkangkal	இலக்கங்கள்	இலக்கங்கள்
ilakkana	இலக்கண	இலக்கன
ilakkanangkalai	இலக்கணங்களை	இலக்கங்களை
ilakkanangkali	இலக்கணங்களை	இலக்கங்களின்
ilakkanankalai	இலக்கணங்களை	இலக்கங்களை
ilakkanangkal	இலக்கணங்கள்	இலக்கங்கள்
ilakkanankal	இலக்கணங்கள்	இலக்கங்கள்
ilakkanach	இலக்கணச்	இலக்கணச்
ilakkanaththil	இலக்கணத்தில்	இலக்கண்ததில்
ilakkanaththai	இலக்கணத்தை	இலக்கந்தைை
ilakkanap	இலக்கணப்	இலக்கணப்
ilakkanamum	இலக்கணமும்	இலக்கணமும்
ilakkanam	இலக்கணம்	இலக்கணம்
ilakkai	இலக்கை	இலக்கை
ilatcham	இலட்சம்	இலட்சம்
latcham	இலட்சம்	இல்டச்
ilaa	இலா	இலா
ilaechaana	இலேசான	இலேசான
ilaesaana	இலேசான	இலேசான
laesaana	இலேசான	லேசானா
leasaana	இலேசான	லேசானா
pengaludan	இளம்	பெண்களுடன்
penkalutan	இளம்	பெண்களுடன்
ilampen	இளம்பெண்	இலம்பெண்
ilampengalai	இளம்பெண்களை	இலம்பெங்களை
ilampengaludan	இளம்பெண்களை	இலம்பெங்களுடன
ilampenkalai	இளம்பெண்களை	இலம்பெங்களை
ilampengal	இளம்பெண்கள்	இலம்பெங்கள்
ilampenkal	இளம்பெண்கள்	இலம்பெங்கள்
ilavayadhu	இளவயது	இளவயது
ilavayath	இளவயது	இளவயத்
ilavayathu	இளவயது	இளவயது
izhaiya	இழைய	இழைய
ivanaal	இவனால்	இவனால்
evatrtrukku	இவற்றுக்கு	இவற்றுக்கு
ivatrtrukku	இவற்றுக்கு	இவற்றுக்கு
ivattrukku	இவற்றுக்கு	இவற்றுக்கு
evatrtrul	இவற்றுள்	இவற்றுள்
ivatrtrul	இவற்றுள்	இவற்றுள்
ivatrul	இவற்றுள்	இவற்றுள்
evaikalin	இவைகளின்	இவைகளின்
ivaigalin	இவைகளின்	இவைகளின்
evaikalilirunthu	இவைகளிலிருந்து	இவைகளிலிருந்து
ivaigalilirundhu	இவைகளிலிருந்து	இவைகளிலிருந்து
evaikalum	இவைகளும்	இவைகளும்
ivaigalum	இவைகளும்	இவைகளும்
evaikal	இவைகள்	இவைகள்
ivaigal	இவைகள்	இவைகள்
evaiyum	இவையும்	இவையும்
ivaiyum	இவையும்	இவையும்
ivvaiyum	இவையும்	இவ்வையும்
eekkal	ஈக்கள்	ஏக்கல்
eesanai	ஈசனை	ஈசனை
eeyam	ஈயம்	ஏயம்
iiyam	ஈயம்	இயாம்
iyam	ஈயம்	இயம்
eerppuch	ஈர்ப்புச்	ஏற்ப்புச்
ugandhadhu	உகந்தது	உகத்து
uganthathu	உகந்தது	உகத்தது
ukandhathu	உகந்தது	உகந்தது
hussain	உசேன்	ஹுசைன்
usaen	உசேன்	உசேன்
udanpaadu	உடன்பாடு	உடன்பாடு
udalin	உடலின்	உடலின்
udalaith	உடலைத்	உடலைத்
udalaip	உடலைப்	உடலைப்
udalaiyum	உடலையும்	உடலையும்
udalnala	உடல்நல	உடல்லா
udalnalathai	உடல்நலத்தை	உடல்லாந்தை
udalnalaththai	உடல்நலத்தை	உடல்லகத்தை
udalnalththai	உடல்நலத்தை	உடல்நல்பத்தை
udalnalan	உடல்நலன்	உடல்லனான்
udalnalap	உடல்நலப்	உடல்லாணப்
udaindha	உடைந்த	உடைந்த
udaintha	உடைந்த	உடைந்த
udaindhaal	உடைந்தால்	உடைந்தால்
udainthaal	உடைந்தால்	உடைந்தால்
udaindhu	உடைந்து	உடைந்து
udainththu	உடைந்து	உடைந்து
udainthu	உடைந்து	உடைந்து
vaendum	உட்கொள்ள	வேண்டும்
vendum	உட்கொள்ள	வெண்க்
ventum	உட்கொள்ள	வெட்டு
utkollaamal	உட்கொள்ளாமல்	உட்கொல்லாமல்
utkolluvathan	உட்கொள்வதன்	உட்கொள்வதுள்
utkolvathan	உட்கொள்வதன்	உட்கொள்வதன்
utkolvathaal	உட்கொள்வதால்	உட்கொள்வால்
udpura	உட்புற	உட்புற
utpura	உட்புற	உட்புர
udpurach	உட்புறச்	உட்புரச்
utpurach	உட்புறச்	உட்புரச்
udpuraththil	உட்புறத்தில்	உடுப்பத்தில்
utpuraththil	உட்புறத்தில்	உட்பத்திருதில்
udpuraththai	உட்புறத்தை	உடுப்பத்தை
utpuraththai	உட்புறத்தை	உட்புத்தை
udpuramulla	உட்புறமுள்ள	உட்புருமலு
utpuramulla	உட்புறமுள்ள	உட்புருமல்ல
unarvadhu	உணர்வது	உனர்வது
unarvathu	உணர்வது	உனர்வது
unavugalilum	உணவுகளிலும்	உணவுகளிலும்
unavukalilum	உணவுகளிலும்	உணவுகளிலும்
unavugalai	உணவுகளை	உணவுகளை
unavukalai	உணவுகளை	உணவுகளை
unavugal	உணவுகள்	உணவுகள்
unavukal	உணவுகள்	உணவுகள்
unavukkaaga	உணவுக்காக	உணவுக்காக
unavukkaaka	உணவுக்காக	உணவுக்காக
unavukku	உணவுக்கு	உணவுக்கு
thurai	உணவுத்	துரை
turai	உணவுத்	துரை
unavupporutkal	உணவுப்பொருட்கள்	உணவுப்பொருக்கள்
unavupporuttkal	உணவுப்பொருட்கள்	உணவுப்புற்றங்கள்
unavum	உணவும்	உணவும்
undadhaal	உண்டதால்	உண்டதால்
undathaal	உண்டதால்	உண்டதால்
untathaal	உண்டதால்	உண்டதால்
unadanar	உண்டனர்	உணனடர்
undanar	உண்டனர்	உண்டனர்
untanar	உண்டனர்	உண்டனர்
undaana	உண்டான	உண்டான
untaana	உண்டான	உண்டான
undi	உண்டி	உண்டி
uththiyoaga	உத்தியோக	உத்தியோக
uththiyoaka	உத்தியோக	உத்தியோக
ubachaara	உபசார	உபசார
ubasaara	உபசார	உபாரா
upasaara	உபசார	உபசார
ubanidatham	உபநிடதம்	உபனிடத்தம்
ubanitatham	உபநிடதம்	உபனிடத்தம்
upanidatham	உபநிடதம்	உபனிடத்தம்
upanitatham	உபநிடதம்	உபனிடத்தம்
uppin	உப்பின்	உப்பின்
uppugal	உப்புகள்	உப்புகள்
uppukal	உப்புகள்	உப்புகள்
uppuk	உப்புக்	உப்புக்
uppukkal	உப்புக்கள்	உப்புக்கள்
uppukku	உப்புக்கு	உப்புக்கு
ubbusam	உப்புசம்	உப்புசம்
uppusam	உப்புசம்	உப்புசம்
uppudan	உப்புடன்	உப்புடன்
umakku	உமக்கு	உமக்கு
umilum	உமிழும்	உமிழும்
umizhum	உமிழும்	உமிழும்
uyirina	உயிரின	உயிரின
uyirinaththin	உயிரினத்தின்	உயிரிநத்தின்
uyirinaththai	உயிரினத்தை	உயிரிந்தை
uyirinamaana	உயிரினமான	உயிரிணமான
urachiya	உரசிய	உரசிய
urasiya	உரசிய	உரசிய
urugiya	உருகிய	உறுகிய
urukiya	உருகிய	உருகிய
uruvappadangkalai	உருவப்படங்களை	உருப்படங்களைப்
uruvappadankalai	உருவப்படங்களை	உருப்படங்களைப்
uruvappatangkalai	உருவப்படங்களை	உருப்படங்களப்
uruvaaga	உருவாக	உருவாக
uruvaaka	உருவாக	உருவாக
uruvaagaamal	உருவாகாமல்	உருவாகமால்
uruvaagiyulladhaaga	உருவாகியுள்ளதாக	உருவாகியாலுக்கான
uruvaagiyullathaaga	உருவாகியுள்ளதாக	உருவாகியாலுகள்
uruvaagiyulladhu	உருவாகியுள்ளது	உருவாகியுள்ளது
uruvaagiyullathu	உருவாகியுள்ளது	உருவாயிகளுள்ளது
uruvaagiyullana	உருவாகியுள்ளன	உருவாகியுள்ளன
uruvaagum	உருவாகும்	உருவாகும்
uruvaagumboadhu	உருவாகும்போது	உருவாகும்போது
uruvaagumpoathu	உருவாகும்போது	உருவாகும்போது
urvaagumpoathu	உருவாகும்போது	உருவாக்குமது
uruvaaguvadhai	உருவாகுவதை	உருவாகவுதை
uruvaaguvathai	உருவாகுவதை	உருவாகவுதை
vaendum	உருவாக்க	வேண்டும்
veendum	உருவாக்க	வீண்டும்
veentum	உருவாக்க	வீண்டும்
vendum	உருவாக்க	வெண்க்
ventum	உருவாக்க	வெட்டு
uruvaakkak	உருவாக்கக்	உருவாக்கக்
uruvaakkakkoodiya	உருவாக்கக்கூடிய	உருவாக்கூடியக்
uruvaakkath	உருவாக்கத்	உருவாக்கத்
uruvaakkaththi	உருவாக்கத்தில்	உருவாக்கத்தி
uruvaakkaththil	உருவாக்கத்தில்	உருவாக்கத்தில்
uruvaakkaththai	உருவாக்கத்தை	உருவாக்கத்தை
uruvaakkam	உருவாக்கம்	உருவாக்கம்
uruvaakkavum	உருவாக்கவும்	உருவாக்கவும்
uruvaakkuthal	உருவாக்குதல்	உருவாக்குதல்
uruvaakkum	உருவாக்கும்	உருவாக்கும்
uruvaakkumpoathu	உருவாக்கும்போது	உருவாக்குமதுப்
uruvaakkuvathai	உருவாக்குவதை	உருவாக்குவதை
uraiyaadal	உரையாடல்	உரையாடல்
uraiyaatal	உரையாடல்	உரையாடல்
uraiyaadalgal	உரையாடல்கள்	உரையாடல்கள்
uraiyaadalkal	உரையாடல்கள்	உரையாடல்கள்
uraiyaatalkal	உரையாடல்கள்	உரையாடல்கள்
urangaatha	உறங்காத	உரங்காத
urangkaatha	உறங்காத	உரங்காத
urangku	உறங்கு	உரங்கு
urangu	உறங்கு	உரங்கு
urangkum	உறங்கும்	உரங்கும்
urangum	உறங்கும்	உரங்கும்
urangkumpoathu	உறங்கும்போது	உரங்கும்போது
urangumpoathu	உறங்கும்போது	உரங்கும்போது
uravaal	உறவால்	உரவால்
uruthunaiyaaga	உறுதுணையாக	உறுதுணையாக
uruthunaiyaaka	உறுதுணையாக	உறுதுணையாக
uruthunaiyaga	உறுதுணையாக	உறுதனுயைக
uruppugali	உறுப்புகளில்	உறுப்புகளி
uruppugalil	உறுப்புகளில்	உறுப்புகளில்
uruppugalum	உறுப்புகளும்	உறுப்புகளும்
uruppugalai	உறுப்புகளை	உறுப்புகளை
utrtru	உற்று	உற்று
uttru	உற்று	உற்று
ulagaich	உலகைச்	உலகைச்
ulunththu	உளுந்து	உழுந்து
ulunthu	உளுந்து	உழுந்து
ullaga	உள்ளக	உள்ளக
ullaka	உள்ளக	உள்ளக
ullagap	உள்ளகப்	உள்ளப்
ullakap	உள்ளகப்	உள்ளகப்
ulladakkangalai	உள்ளடக்கங்களை	உள்ளடங்களைக்
ulladakkangkalai	உள்ளடக்கங்களை	உள்ளடக்கங்களை
ullatakkangkali	உள்ளடக்கங்களை	உள்ளடக்கங்களி
ulladakkangal	உள்ளடக்கங்கள்	உள்ளடங்களைக்
ulladakkangkal	உள்ளடக்கங்கள்	உள்ளடங்கள்க்
ullatakkangkal	உள்ளடக்கங்கள்	உள்ளடங்கள்க்க
ulladakkaththai	உள்ளடக்கத்தை	உள்ளடக்கத்தை
ullatakkaththai	உள்ளடக்கத்தை	உள்ளடக்கத்தை
ulladakkam	உள்ளடக்கம்	உள்ளடக்கம்
ullatakkam	உள்ளடக்கம்	உள்ளடக்கம்
ulladakki	உள்ளடக்கி	உள்ளடக்கி
ullatakki	உள்ளடக்கி	உள்ளடக்கி
ullapadi	உள்ளபடி	உள்ளபடி
ullavaraaga	உள்ளவராக	உள்ளவராக
ullavaraaka	உள்ளவராக	உள்ளவராக
ulleedu	உள்ளீடு	உள்ளிடு
ulleedugalai	உள்ளீடுகளை	உள்ளிடுகளை
ulleedukalai	உள்ளீடுகளை	உள்ளிடுகளை
ulleedugal	உள்ளீடுகள்	உள்ளிடுகள்
ulleedukal	உள்ளீடுகள்	உள்ளிடுகள்
ulvaanggum	உள்வாங்கும்	உள்வாங்கும்
ulvaangkum	உள்வாங்கும்	உள்வாங்கும்
ulvaankum	உள்வாங்கும்	உள்வாங்கும்
ulaippil	உழைப்பில்	உலைப்பில்
uzhaippil	உழைப்பில்	உழைப்பில்
uavar	உவர்	உவர்
uvar	உவர்	உவர்
ookkuvippathu	ஊக்குவிப்பது	ஊக்குவிப்பது
uookkuvippathu	ஊக்குவிப்பது	ஊக்குவிப்பது
uukkuvippathu	ஊக்குவிப்பது	ஊக்குவிப்பது
ookkuvippu	ஊக்குவிப்பு	ஊக்குவிப்பு
uookkuvippu	ஊக்குவிப்பு	ஊக்குவிப்பு
uukkuvippu	ஊக்குவிப்பு	ஊக்குவிப்பு
oosal	ஊசல்	ஓசல்
uoosal	ஊசல்	ஊசல்
uusal	ஊசல்	உசல்
oonchal	ஊஞ்சல்	ஓச்சல்
oonchchal	ஊஞ்சல்	ஊன்சல்
unchal	ஊஞ்சல்	உஞ்சல்
uunchchal	ஊஞ்சல்	உஞ்சல்
uunjsal	ஊஞ்சல்	உஞ்சல்
oodagath	ஊடகத்	ஊடகத்
oodakath	ஊடகத்	ஊடகத்
udakath	ஊடகத்	உடகத்
uudakath	ஊடகத்	ஊடகத்
oodagaththin	ஊடகத்தின்	ஊடகத்தின்
oodakaththin	ஊடகத்தின்	ஊடகத்தின்
udagaththin	ஊடகத்தின்	உடகத்தின்
uudakaththin	ஊடகத்தின்	ஊடகத்தின்
oodagamaaga	ஊடகமாக	ஊடகமாக
oodakamaaka	ஊடகமாக	ஊடகமாக
udakamaaka	ஊடகமாக	உடகமாக
uudakamaaka	ஊடகமாக	ஊடகமாக
oodaadum	ஊடாடும்	ஊடாடும்
uoodaadum	ஊடாடும்	ஊடாடும்
uudaadum	ஊடாடும்	ஊடாடும்
oothaak	ஊதாக்	ஊதாக்
uuthaak	ஊதாக்	ஊதாக்
ooran	ஊரன்	ஓரான்
uooran	ஊரன்	ஊரான்
uuraan	ஊரன்	ஊரான்
uuran	ஊரன்	ஊரான்
ooraar	ஊரார்	ஊரார்
uuraar	ஊரார்	ஊரார்
oorilirunththu	ஊரிலிருந்து	ஒரிலிருந்து
oorilirunthu	ஊரிலிருந்து	ஊரிலிருந்து
uurilirunththu	ஊரிலிருந்து	உரிலிருந்து
uurilirunthu	ஊரிலிருந்து	ஊரிலிருந்து
oorilaeyae	ஊரிலேயே	ஓரிலேயே
urilaeyae	ஊரிலேயே	உரிலேயே
uurilaeyae	ஊரிலேயே	ஊரிலேயே
oorvalanggal	ஊர்வலங்கள்	ஒர்வலங்கள்
oorvalangkal	ஊர்வலங்கள்	ஒர்வலங்கள்
uurvalangkal	ஊர்வலங்கள்	உர்வலங்கள்
oorvalaththil	ஊர்வலத்தில்	ஒர்வலத்தில்
uurvalaththil	ஊர்வலத்தில்	உர்வலத்தில்
oorvalam	ஊர்வலம்	ஒர்வலம்
uurvalam	ஊர்வலம்	உர்வலம்
ootrtruvathu	ஊற்றுவது	ஊற்றுவது
ootruvathu	ஊற்றுவது	ஒற்றுவது
uutrtruvathu	ஊற்றுவது	ஊற்றுவது
accon	எகான்	அக்கன்
akkon	எகான்	அக்கோன்
akon	எகான்	அக்கன்
akonn	எகான்	அக்னன்
aqon	எகான்	அக்கன்
aqonn	எகான்	அக்னன்
aqqon	எகான்	அக்கன்
yekan	எகான்	எகன்
edisan	எடிசன்	எடிசன்
edison	எடிசன்	எடிசன்
idison	எடிசன்	எதிசன்
yedisan	எடிசன்	எடிசன்
edukkappada	எடுக்கப்பட	எடுக்கப்பட
yedukappatta	எடுக்கப்பட	எடுகப்பட்ட
etta	எட்ட	எட்ட
ettavillai	எட்டவில்லை	ஏட்டவில்லை
yettavillai	எட்டவில்லை	ஏட்டவில்லை
ettaatha	எட்டாத	எட்டாத
ettiya	எட்டிய	எட்டிய
yettiya	எட்டிய	எட்டிய
ennikkaigal	எண்ணிக்கைகள்	எண்ணிக்கைகள்
ennikkaikal	எண்ணிக்கைகள்	எண்ணிக்கைகள்
yennikkaigal	எண்ணிக்கைகள்	எண்ணிக்கைகள்
ennikkaikku	எண்ணிக்கைக்கு	எண்ணிக்கைக்கு
yennikkaikku	எண்ணிக்கைக்கு	எண்ணிக்கைக்கு
ennikkaiyin	எண்ணிக்கையின்	எண்ணிக்கையின்
ennikkaiyum	எண்ணிக்கையும்	எண்ணிக்கையும்
ennikkaiyai	எண்ணிக்கையை	எண்ணிக்கையை
ennikkaiyaiyum	எண்ணிக்கையையும்	எண்ணிக்கையையும்
ennima	எண்ணிம	என்னிம
ethirkatchiyaaga	எதிர்கட்சியாக	எதிர்க்கட்சியாக
ethirkatchiyaaka	எதிர்கட்சியாக	எதிர்க்கட்சியாக
yedhirkatchiyaaga	எதிர்கட்சியாக	எதிர்க்கட்சியாக
edhirpaarppugalai	எதிர்பார்ப்புகளை	எதிர்பார்ப்புகளை
ethirpaarppugalai	எதிர்பார்ப்புகளை	எதிர்பார்ப்புகளை
ethirpaarppukalai	எதிர்பார்ப்புகளை	எதிர்பார்ப்புகளை
eththanaiyo	எத்தனையோ	எத்தனைய
eththanaiyoa	எத்தனையோ	எத்தனையான
paeyar	எனப்	பேயர்
payar	எனப்	பயர்
peyar	எனப்	பேயர்
enil	எனில்	எனில்
endroa	என்றோ	என்றோ
entroa	என்றோ	என்றோ
em	எம்	எம்
yem	எம்	யேம்
emdan	எம்டன்	எம்டன்
emdon	எம்டன்	எம்டன்
emtan	எம்டன்	எம்டன்
emton	எம்டன்	எம்டன்
yemtan	எம்டன்	எம்டன்
eythinaar	எய்தினார்	எத்தினார்
yeithinaar	எய்தினார்	எத்தினார்
eythiya	எய்திய	எத்திய
yeithiya	எய்திய	எத்திய
eythu	எய்து	எத்து
yeithu	எய்து	எத்து
eru	எரு	ஏறு
yeru	எரு	ஏறு
eruvai	எருவை	இறுவை
yeruvai	எருவை	எறுவை
elaktraan	எலக்ட்ரான்	எலக்றான்
electron	எலக்ட்ரான்	எலெக்ட்ரான்
ilektraan	எலக்ட்ரான்	இலெக்டர்ன்
ilektron	எலக்ட்ரான்	இலெக்டர்ன்
ileqtraan	எலக்ட்ரான்	இலெக்டர்ன்
ileqtron	எலக்ட்ரான்	இலெக்டர்ன்
ilictron	எலக்ட்ரான்	இலிக்டர்ன்
iliktraan	எலக்ட்ரான்	இலிக்றான்
iliktron	எலக்ட்ரான்	இலிக்டோர்ன்
yelakdran	எலக்ட்ரான்	எலக்கர்ன்
yelaktraan	எலக்ட்ரான்	எல்க்்ார்
elaktraankalai	எலக்ட்ரான்களை	எல்க்்கான்றை
electronkalai	எலக்ட்ரான்களை	எலெக்ட்ர்ல்லை
yekaltraankalai	எலக்ட்ரான்களை	எலக்கல்லார்
ellaippura	எல்லைப்புற	எல்லைப்புற
yellaippura	எல்லைப்புற	எல்லைப்பூர்
elithaakkum	எளிதாக்கும்	எழிதாகும்
yelidhaakkum	எளிதாக்கும்	எலிதாகும்
yelithaakkum	எளிதாக்கும்	எலிதாக்கும்
elimaiyaakavum	எளிமையாகவும்	எலிமைகளாகும்
yelimaiyaagavum	எளிமையாகவும்	எலிமையாகவும்
yelimaiyaakavum	எளிமையாகவும்	எலிமையாகவும்
ezhuthiyullaar	எழுதியுள்ளார்	எழுதியுள்ளார்
yeluthiyullaar	எழுதியுள்ளார்	எழுதியுள்ளார்
evvakai	எவ்வகை	இவ்வகை
yavvakai	எவ்வகை	இவ்வகை
evvaaraana	எவ்வாறான	இவ்வாறான
yavvaaraana	எவ்வாறான	இவ்வாறான
aa	ஏ	ஆ
ae	ஏ	ஏ
e	ஏ	ஏ
ee	ஏ	ஏ
acre	ஏக்கர்	ஆக்ரே
aekkar	ஏக்கர்	ஏக்கர்
ekkar	ஏக்கர்	எக்கர்
aesiyaa	ஏசியா	ஏசியா
asia	ஏசியா	ஆசியா
esia	ஏசியா	எசியா
angeles	ஏஞ்சல்ஸ்	அங்கேல்ஸ்
angels	ஏஞ்சல்ஸ்	அங்கல்ஸ்
angilis	ஏஞ்சல்ஸ்	அங்கிலிஸ்
aden	ஏடன்	அடன்
adenn	ஏடன்	அடேன்
aidan	ஏடன்	அடன்
edan	ஏடன்	எடன்
eden	ஏடன்	எடின்
edenn	ஏடன்	எடின்
eedan	ஏடன்	ஈடன்
eton	ஏடன்	எட்டன்
iton	ஏடன்	எட்டன்
eetan	ஏதன்	ஈட்டன்
eithaan	ஏதன்	எத்தான்
eithan	ஏதன்	எத்தன்
ethan	ஏதன்	எத்தன்
ethann	ஏதன்	எத்தன்
eythan	ஏதன்	எத்தன்
iithaan	ஏதன்	இத்தான்
ithan	ஏதன்	இதன்
ithann	ஏதன்	இதன்
iythan	ஏதன்	இத்தன்
aerpada	ஏற்பட	ஏற்பட
yerpada	ஏற்பட	ஏற்பட
aerpadath	ஏற்படத்	ஏற்படத்
yerpadath	ஏற்படத்	ஏற்படத்
aerpadap	ஏற்படப்	ஏற்படப்
yerpadap	ஏற்படப்	ஏற்படப்
aerpadin	ஏற்படின்	ஏற்படின்
earpadin	ஏற்படின்	ஏற்படின்
yerpadin	ஏற்படின்	ஏற்படின்
aerpaduththina	ஏற்படுத்தின	ஏற்படுத்தின
yaerpaduththina	ஏற்படுத்தின	ஏற்படுத்தின
yerpaduththina	ஏற்படுத்தின	ஏற்படுத்தின
aerpadumpoathu	ஏற்படும்போது	ஏற்படும்போது
yaerpadumpoathu	ஏற்படும்போது	ஏற்படும்போது
yerpadumpoathu	ஏற்படும்போது	ஏற்படும்போது
aerpaduvathu	ஏற்படுவது	ஏற்படுவது
yaerpaduvathu	ஏற்படுவது	ஏற்படுவது
yerpaduvathu	ஏற்படுவது	ஏற்படுவது
aerpaduvathai	ஏற்படுவதை	ஏற்படுவதை
earpaduvathai	ஏற்படுவதை	ஏற்படுவதை
yerpaduvathai	ஏற்படுவதை	ஏற்படுவதை
aetrtrukkonda	ஏற்றுக்கொண்ட	ஏற்றுக்கொண்ட
eattrukkonda	ஏற்றுக்கொண்ட	ஏற்றுக்கொண்ட
aetrtrukkondaar	ஏற்றுக்கொண்டார்	ஏற்றுக்கொண்டார்
eattrukkondaar	ஏற்றுக்கொண்டார்	ஏற்றுக்கொண்டார்
aela	ஏல	ஏல
eala	ஏல	ஏலா
yaela	ஏல	ஏல
aelaththil	ஏலத்தில்	ஆழத்தில்
ealaththil	ஏலத்தில்	ஆழத்தில்
yaelaththil	ஏலத்தில்	ஏழத்தில்
aelam	ஏலம்	ஆலம்
ealam	ஏலம்	ஆலம்
yaelam	ஏலம்	ஏலம்
aelanam	ஏளனம்	ஏலனம்
ealanam	ஏளனம்	ஏலனம்
eelanam	ஏளனம்	ஈழனம்
yelanam	ஏளனம்	எலனம்
ainaavin	ஐநாவின்	ஐனான்வின்
aynaavin	ஐநாவின்	அய்நாவின்
inaavin	ஐநாவின்	இனாவின்
aippachi	ஐப்பசி	ஐப்பாசி
aippasi	ஐப்பசி	ஐப்பாசி
ippachi	ஐப்பசி	இப்பாசி
aivarum	ஐவரும்	எவரும்
ivarum	ஐவரும்	இவரும்
odunggi	ஒடுங்கி	ஒடுங்கி
odungi	ஒடுங்கி	ஒடுங்கி
odungki	ஒடுங்கி	ஒடுங்கி
odungiya	ஒடுங்கிய	ஒடுங்கிய
odungkiya	ஒடுங்கிய	ஒடுங்கிய
oppandhangalil	ஒப்பந்தங்களில்	ஒப்பங்கங்களில்
oppanthangalil	ஒப்பந்தங்களில்	ஒப்பந்தங்களில்
oppanthangkalil	ஒப்பந்தங்களில்	ஒப்பங்கங்களில்
oppandhangalai	ஒப்பந்தங்களை	ஒப்பங்கங்களை
oppanthangalai	ஒப்பந்தங்களை	ஒப்பங்கங்களை
oppanthangkalai	ஒப்பந்தங்களை	ஒப்பங்கங்களை
oppandhangal	ஒப்பந்தங்கள்	ஒப்பந்தங்கள்
oppandhangall	ஒப்பந்தங்கள்	ஒப்பந்தங்கள்
oppanthangall	ஒப்பந்தங்கள்	ஒப்பந்தங்கள்
oppanthangkal	ஒப்பந்தங்கள்	ஒப்பந்தங்கள்
oppandhathin	ஒப்பந்தத்தின்	ஒப்பந்தின்
oppandhaththin	ஒப்பந்தத்தின்	ஒப்பத்தின்தின்
oppanthaththin	ஒப்பந்தத்தின்	ஒப்பத்தின்தின்
oppandhaththai	ஒப்பந்தத்தை	ஒப்பந்தத்தை
oppanthathai	ஒப்பந்தத்தை	ஒப்பந்ததை
oppanthaththai	ஒப்பந்தத்தை	ஒப்பத்தந்தை
oppukkolgiraar	ஒப்புக்கொள்கிறார்	ஒப்புக்கொள்ளிரார்
oppukkolgirar	ஒப்புக்கொள்கிறார்	ஒப்புக்கொள்ளிர்
oppukkolkiraar	ஒப்புக்கொள்கிறார்	ஒப்புக்கொள்ளிரார்
oppukkolkirar	ஒப்புக்கொள்கிறார்	ஒப்புக்கொள்ளிர்
omeega	ஒமேகா	அமேகா
omeegaa	ஒமேகா	ஒமேகா
omeeka	ஒமேகா	ஒமேக
omega	ஒமேகா	அமேகா
omegaa	ஒமேகா	ஒமேகா
ommeega	ஒமேகா	மம்மாக
ommeegaa	ஒமேகா	மம்மாக
ommega	ஒமேகா	உம்மாக
ommegaa	ஒமேகா	உம்மாக
orisa	ஒரிசா	ஒரிஷா
orisaa	ஒரிசா	ஒரிஷா
orissa	ஒரிசா	ஒரிஷ்சா
orissaa	ஒரிசா	ஒரிஸ்சா
orrisa	ஒரிசா	ஒரிஷா
orichaavil	ஒரிசாவில்	ஒரிச்வாலில்
orisavil	ஒரிசாவில்	ஒரிசவில்
orissavil	ஒரிசாவில்	ஒரிச்சலில்
orunginaipai	ஒருங்கிணைப்பை	ஒருங்கிணைக்கைப்
orunginaippai	ஒருங்கிணைப்பை	ஒருங்கிணைக்கைப்
orunkinaippai	ஒருங்கிணைப்பை	ஒருங்கிணைக்கைப்
orupadi	ஒருபடி	ஒருபடி
orupati	ஒருபடி	ஒருப்படி
oruphadi	ஒருபடி	ஒருபதி
otrarkal	ஒற்றர்கள்	ஒற்றார்கள்
ottrargal	ஒற்றர்கள்	ஒற்றார்கள்
ottrarkal	ஒற்றர்கள்	ஒற்றார்கள்
ovvoar	ஒவ்வோர்	ஒவ்வோர்
ovvoor	ஒவ்வோர்	ஒவ்வூர்
ovvor	ஒவ்வோர்	ஒவ்வோர்
oangi	ஓங்கி	ஓங்கி
ongi	ஓங்கி	ஒங்கி
oongi	ஓங்கி	ஊங்கி
ozone	ஓசோன்	அஜோன்
oaiyaa	ஓயா	ஓய்யா
oayaa	ஓயா	ஓயா
ooyaa	ஓயா	ஓயா
oyaa	ஓயா	ஓய்யா
hora	ஓர	ஹோர்
oora	ஓர	ஓர
ora	ஓர	ஒரா
vora	ஓர	வரா
horangalil	ஓரங்களில்	ஹோரங்களில்
oorangalil	ஓரங்களில்	ஊரங்களில்
orangalil	ஓரங்களில்	ஒரங்களில்
vorangalil	ஓரங்களில்	வோரங்களில்
horathilum	ஓரத்திலும்	ஹாரதிலும்
oorathilum	ஓரத்திலும்	ஊரதிலும்
orathilum	ஓரத்திலும்	ஒரத்திலும்
oraththilum	ஓரத்திலும்	ஒரத்திலும்
vorathilum	ஓரத்திலும்	வரோதிலும்
horathil	ஓரத்தில்	ஹாரததில்
oorathil	ஓரத்தில்	ஊரதில்
orathil	ஓரத்தில்	ஒரததில்
oraththil	ஓரத்தில்	ஒரத்தில்
vorathil	ஓரத்தில்	வரரதத்
horamaaga	ஓரமாக	ஊராமக
ooramaaga	ஓரமாக	ஊரமாக
oramaaga	ஓரமாக	ஒராமக
voramaaga	ஓரமாக	வரமமாக
horam	ஓரம்	ஹோரம்
ooram	ஓரம்	ஊரம்
oram	ஓரம்	ஒரம்
voram	ஓரம்	வரம்
aolaichchuvadikal	ஓலைச்சுவடிகள்	அலைச்சுவிடகள்
oalaichchuvadikal	ஓலைச்சுவடிகள்	ஓலைச்சுவிகள்
oalaichuvadigal	ஓலைச்சுவடிகள்	ஓலோச்டுவைகள்
olaichchuvadigal	ஓலைச்சுவடிகள்	ஒலைச்சுவிகளை
oolaichuvadigal	ஓலைச்சுவடிகள்	ஓலைசுவதிகள்
oaldu	ஓல்டு	ஆல்டு
oldu	ஓல்டு	ஒல்டு
ooldu	ஓல்டு	ஆல்டு
kakkan	கக்கன்	காக்கன்
kakken	கக்கன்	காக்கின்
kaki	கக்கி	காகி
kakki	கக்கி	காக்கி
kakky	கக்கி	காக்கி
kachan	கசன்	கசன்
kajan	கசன்	கான்
kasan	கசன்	காசன்
kazan	கசன்	கான்
qazan	கசன்	கான்
kadaththal	கடத்தல்	கடத்தல்
kadaththalgalil	கடத்தல்களில்	கடத்தள்களில்
kadaththalkalil	கடத்தல்களில்	கடத்தல்களில்
kadandhaar	கடந்தார்	கடந்தார்
kadanthaar	கடந்தார்	கடந்தார்
katandhaar	கடந்தார்	கடந்தார்
katanthaar	கடந்தார்	கடந்தார்
kadanin	கடனின்	கடனின்
kadanil	கடனில்	கடனில்
kadanudhavi	கடனுதவி	கடனுதவி
kadanuthavi	கடனுதவி	கடனுதவி
katanuthavi	கடனுதவி	கடனுத்தவி
kadarkaraigalil	கடற்கரைகளில்	கடற்கரைகளில்
kadarkaraikalil	கடற்கரைகளில்	கடர்கரைகளில்
kadarkaraigal	கடற்கரைகள்	கடற்கரைகள்
kadarkaraikal	கடற்கரைகள்	கடர்கரைகள்
kadarkaraich	கடற்கரைச்	கடற்கரைச்
katarkaraichh	கடற்கரைச்	கடற்கரைச்
kadarkaraip	கடற்கரைப்	கடர்கரைப்
kadarkaraiyum	கடற்கரையும்	கடற்கறையும்
kadarkollaiyargal	கடற்கொள்ளையர்கள்	கடர்கொள்ளையர்கள்
kadarkollaiyarkal	கடற்கொள்ளையர்கள்	கடர்லொ்களையர்கள்
kadalin	கடலின்	கடலின்
katalin	கடலின்	கடலின்
kadavul	கடவுள்	கடவுல்
kadvul	கடவுள்	கட்வுல்
kadavulgalil	கடவுள்களில்	கடவுள்ளில்
kadavulkalil	கடவுள்களில்	கடவுள்ளில்
kadavulgalai	கடவுள்களை	கடவுள்ளை
kadavulkalai	கடவுள்களை	கடவுள்ளை
kadavulgal	கடவுள்கள்	கடவுள்ள
kadavulkal	கடவுள்கள்	கடவுள்கள்
kadidha	கடித	கடித
kadith	கடித	கடித்
kaditha	கடித	கடித்த
kadidhangalil	கடிதங்களில்	கடிதங்களில்
kadithangalil	கடிதங்களில்	கடித்தங்களில்
kadithangkalil	கடிதங்களில்	கடித்தங்களில்
kadidhangal	கடிதங்கள்	கடிதங்கள்
kadithangal	கடிதங்கள்	கடித்தங்கள்
kadithangkal	கடிதங்கள்	கடித்தங்கள்
kadidhu	கடிது	கடித்து
kadithu	கடிது	கடித்து
katithu	கடிது	கடித்து
kadugu	கடுகு	கடுகு
kadumaiyaana	கடுமையான	கடுமையான
kadaisith	கடைசித்	கடைசித்
kadaisip	கடைசிப்	கடைசிப்
kadaisiyil	கடைசியில்	கடைசியில்
kadaippidiththu	கடைப்பிடித்து	கடைப்பிடித்து
kadaippidithu	கடைப்பிடித்து	கடைப்பிடிடு
kadaippiditthu	கடைப்பிடித்து	கடைப்பிட்டிது
avut	கட்	அவுட்
cut	கட்	காட்
kat	கட்	கேட்
out	கட்	ஆட்
kattamaikkum	கட்டமைக்கும்	கட்டமைக்கும்
kattaayamaaga	கட்டாயமாக	கட்டாமையாக
kattumaanak	கட்டுமானக்	கட்டுமானக்
kattumaanath	கட்டுமானத்	கட்டுமானத்
kattumaanathin	கட்டுமானத்தின்	கட்டுமானத்தின்
kattumaanaththin	கட்டுமானத்தின்	கட்டுமானத்தின்
kattumaanathirku	கட்டுமானத்திற்கு	கட்டுமானத்திற்கு
kattumaanaththirku	கட்டுமானத்திற்கு	கட்டுமானத்திற்கு
katumaanaththirku	கட்டுமானத்திற்கு	கடுமானத்திற்கு
kattumaanathil	கட்டுமானத்தில்	கட்டுமானத்தில்
kattumaanaththil	கட்டுமானத்தில்	கட்டுமானத்தில்
katturaigal	கட்டுரைகள்	கட்டுரைகள்
kanangalin	கணங்களின்	கணங்களின்
kanangkalin	கணங்களின்	கணங்களின்
kanaththin	கணத்தின்	கனத்தின்
kanini	கணிணி	கணினி
kanippori	கணிப்பொறி	கனிப்பொரி
kanipporiyil	கணிப்பொறியில்	கனிப்பொரியில்
ganes	கணேஸ்	கான்ஸ்
ganesh	கணேஸ்	கணேஷ்
kandarindhavar	கண்டறிந்தவர்	கண்டறிந்தவர்
kandarindhdhavar	கண்டறிந்தவர்	கண்டிருந்தவர்
kandarinthavar	கண்டறிந்தவர்	கண்டறிந்தவர்
kandarinththavar	கண்டறிந்தவர்	கண்டிருந்தவர்
kandarindhaar	கண்டறிந்தார்	கண்டிர்ந்தார்
kandarindhdhaar	கண்டறிந்தார்	கண்டிருந்தார்
kandarinthaar	கண்டறிந்தார்	கண்டிரிந்தார்
kandarinththaar	கண்டறிந்தார்	கண்டிர்ந்தார்
kandarindhdhu	கண்டறிந்து	கண்டறிந்து
kandarindhu	கண்டறிந்து	கண்டரிந்து
kandarinthu	கண்டறிந்து	கண்டறிந்து
kandrinththu	கண்டறிந்து	கன்றிந்து
kandarindhulladhu	கண்டறிந்துள்ளது	கண்டறிலுத்துள்ள
kandarindhullathu	கண்டறிந்துள்ளது	கண்டறிலுத்துள்ள
kandarinthulladhu	கண்டறிந்துள்ளது	கண்டறிலுத்துள்ள
kandarinthullathu	கண்டறிந்துள்ளது	கண்டறிந்துள்ளது
athinaveena	கண்டுபிடிக்க	அதினேவனே
kandupidikka	கண்டுபிடிக்க	கண்டுபிடிக்க
kandupitikka	கண்டுபிடிக்க	கண்டுபிடிக்க
kanupidikka	கண்டுபிடிக்க	கனுபிடிக்க
kandupidikkak	கண்டுபிடிக்கக்	கண்டுபிடிக்கக்
kandupitikkak	கண்டுபிடிக்கக்	கண்டுபிடிக்கக்
kandupidikkavum	கண்டுபிடிக்கவும்	கண்டுபிடிக்கவும்
kandupidikkum	கண்டுபிடிக்கும்	கண்டுபிடிக்கும்
kannaottaththudan	கண்ணோட்டத்துடன்	கன்னடுத்தத்தன்
kannoottaththudan	கண்ணோட்டத்துடன்	கன்னொட்டதுடன்
kannottaththudan	கண்ணோட்டத்துடன்	கன்னத்துட்டன்
kanoottatthudan	கண்ணோட்டத்துடன்	கனுத்தடுடன்
kannoottathai	கண்ணோட்டத்தை	கன்னொட்டதை
kannoottaththai	கண்ணோட்டத்தை	கன்னூட்டத்தை
kannottaththai	கண்ணோட்டத்தை	கன்னொட்டத்தை
kannoattam	கண்ணோட்டம்	கன்னோட்டம்
kannoottam	கண்ணோட்டம்	கன்னூட்டம்
kannottam	கண்ணோட்டம்	கன்னோட்டம்
kanpaarvai	கண்பார்வை	கண்பார்வை
gana	கன	கானா
kana	கன	கானா
ganam	கனம்	கனம்
kanam	கனம்	கனம்
ganaraga	கனரக	கனராக
kanaraga	கனரக	கனராக
kanavai	கனவை	கணவை
canno	கனோ	கன்னோ
cannoo	கனோ	கன்னோ
cano	கனோ	சனோ
kanno	கனோ	கன்னோ
kannoo	கனோ	கன்னோ
kano	கனோ	கனு
kanoo	கனோ	கனு
kanu	கனோ	கனு
qanno	கனோ	கான்ணோ
qano	கனோ	கானோ
qanoo	கனோ	கனு
comiti	கமிட்டி	காமித்
comitie	கமிட்டி	காமிட்டி
comittee	கமிட்டி	காமிட்டி
comity	கமிட்டி	காமித்
commitee	கமிட்டி	காமிமிட்
committee	கமிட்டி	காமிமிட்
committii	கமிட்டி	கமம்தி
kamiddi	கமிட்டி	காமிட்டி
kamiti	கமிட்டி	காமித்
kamitte	கமிட்டி	காமிட்டே
kamitti	கமிட்டி	காமித்தி
qamiti	கமிட்டி	காமித்
kamees	கமீஸ்	கமேஷ்
kameez	கமீஸ்	காமீச்
kamis	கமீஸ்	காமிஸ்
cumbaththil	கம்பத்தில்	கம்பத்தில்
kambaththil	கம்பத்தில்	கம்பத்தில்
kambattil	கம்பத்தில்	கம்பட்டில்
kampattil	கம்பத்தில்	கம்பட்டில்
kambam	கம்பம்	கம்பம்
kampam	கம்பம்	கம்பம்
kambaramayanam	கம்பராமாயணம்	கம்பரமமானம்
kamparamayanam	கம்பராமாயணம்	கம்ப்பரமானம்
company	கம்பெனி	கம்பானி
kambeni	கம்பெனி	கம்பீனி
kampeni	கம்பெனி	கம்பானி
companykku	கம்பெனிக்கு	கம்பான்க்கு
kambenikku	கம்பெனிக்கு	கம்பீனிக்கு
kampenikku	கம்பெனிக்கு	கம்பீனிக்கு
companyil	கம்பெனியில்	கம்பானில்
kambeniyil	கம்பெனியில்	கம்பெய்னியில்
kampeniyil	கம்பெனியில்	கம்பெய்னியில்
gayaanaa	கயானா	காயான
gayana	கயானா	காயான
guana	கயானா	கானா
guiaana	கயானா	குயானா
guiana	கயானா	குயானா
guianaa	கயானா	குயானா
guiiana	கயானா	குயினா
guiyana	கயானா	குயியன
guuana	கயானா	குனா
guuiana	கயானா	குயான
guuiyana	கயானா	கூய்யன
guuvana	கயானா	குவான
guuwana	கயானா	குவான
guuyaana	கயானா	குயான
guuyana	கயானா	குயான
guuyanaa	கயானா	குயான
guvana	கயானா	குவான
guwana	கயானா	குவான
guyaana	கயானா	குயான
guyana	கயானா	குயான
guyanaa	கயானா	குயான
kayana	கயானா	கயயன
karagaatam	கரகாட்டம்	கராகத்
karagaattam	கரகாட்டம்	கராகத்டம்
karakaatam	கரகாட்டம்	காரகட்டம்
karakaattam	கரகாட்டம்	காரக்கட்
karachiyil	கராச்சியில்	கராச்சியில்
karung	கருங்	கருங்
karuththaa	கருத்தா	கருத்தா
karuththaakkangal	கருத்தாக்கங்கள்	கருத்தாக்கங்கள்
karuththaakkanggal	கருத்தாக்கங்கள்	கருத்துக்கங்கள்
karuththaakkangkal	கருத்தாக்கங்கள்	கருத்துக்கங்கள்
karuththaakkaththai	கருத்தாக்கத்தை	கருத்தக்கத்தை
karuththaal	கருத்தால்	கருத்தால்
karutthaal	கருத்தால்	கருத்தால்
karuththukalaal	கருத்துக்களால்	கருத்துகளால்
karuththukkalaal	கருத்துக்களால்	கருத்துக்களால்
karuthukkalaal	கருத்துக்களால்	கருத்துக்களால்
karuththukalil	கருத்துக்களில்	கருத்துகளில்
karuththukkalil	கருத்துக்களில்	கருத்துக்களில்
karuththukalukku	கருத்துக்களுக்கு	கருத்துகளுக்கு
karuththukkalukku	கருத்துக்களுக்கு	கருத்துக்களுக்கு
karuththukalum	கருத்துக்களும்	கருத்துகளும்
karuththukkalum	கருத்துக்களும்	கருத்துக்களும்
karuththulla	கருத்துள்ள	கருத்துள்ள
karuththae	கருத்தே	கருத்தே
karuththe	கருத்தே	கருத்தே
karuththey	கருத்தே	கருத்தி
karunira	கருநிற	கருந்திர
karum	கரும்	கரும்
karumpalagai	கரும்பலகை	கரும்பளகளை
karumpalakai	கரும்பலகை	கரும்பளக்
karmpuli	கரும்புலி	கர்ம்புழி
karumpuli	கரும்புலி	கரும்புழி
karumpuligal	கரும்புலிகள்	கரும்புழிகள்
karumpulikal	கரும்புலிகள்	கரும்புழிகள்
karumpulith	கரும்புலித்	கரும்புழித்
karumpulli	கரும்புள்ளி	கரும்புள்ளி
karna	கர்ண	கர்னா
karnanai	கர்ணனை	கர்னனை
karnnanai	கர்ணனை	கர்ஞன்ணை
karma	கர்ம	கர்மா
karpadhu	கற்பது	கற்பது
karpathu	கற்பது	கற்பது
karpatthu	கற்பது	கற்பத்து
karpam	கற்பம்	கற்பம்
padugira	கற்பிக்கப்	படுகிற
padugiradhu	கற்பிக்கப்	படுகிறது
padukira	கற்பிக்கப்	படுகி
padukirathu	கற்பிக்கப்	படுகிறது
patukiratu	கற்பிக்கப்	படுகிறது
karpikkappatta	கற்பிக்கப்பட்ட	கற்ப்பிக்கப்பட்
karpikkum	கற்பிக்கும்	கற்பிக்கும்
karpithanggal	கற்பிதங்கள்	கற்பிதங்கள்
karpithangkal	கற்பிதங்கள்	கற்பித்தங்கள்
karpin	கற்பின்	கற்பின்
kalasam	கலசம்	கலாசம்
kalandhaaivu	கலந்தாய்வு	கலந்தாவை
kalandhaayvu	கலந்தாய்வு	கலந்தாவு
kalanthaaivu	கலந்தாய்வு	கலந்தாவை
kalandhuk	கலந்துக்	கலந்துக்
kalanthuk	கலந்துக்	கலந்துக்
kalandhum	கலந்தும்	கலந்தும்
kalanthum	கலந்தும்	கலந்தும்
kalavi	கலவி	கலவி
kalaviyil	கலவியில்	கலவியில்
kalaanidhi	கலாநிதி	காலநிதி
kalaanithi	கலாநிதி	காலநிதி
kalanidhi	கலாநிதி	கலனிதி
kalaanidhip	கலாநிதிப்	காலினித்
kalaanithip	கலாநிதிப்	காலினித்திப்
kalanidhip	கலாநிதிப்	கலனிதிப்
kalinga	கலிங்க	கலிங்க
kalingam	கலிங்கம்	கலிங்கம்
kalinkam	கலிங்கம்	கலிங்கம்
ccalinga	கலிங்கா	காலிங்க
kaliina	கலிங்கா	கலீனா
kaliinga	கலிங்கா	கலிஞா
kalina	கலிங்கா	கலினா
kalinaa	கலிங்கா	கலினா
kalinga	கலிங்கா	கலிங்க
kalingaa	கலிங்கா	கலிங்கா
kalinka	கலிங்கா	கலிங்க
kallinaa	கலிங்கா	கல்லினா
kallingaa	கலிங்கா	கல்ளிங்கா
qaliinga	கலிங்கா	கலிஞா
qalinga	கலிங்கா	கலிங்க
qalingaa	கலிங்கா	கலிங்கா
qallingaa	கலிங்கா	கல்லிங்கா
kaliyan	கலியன்	கலியன்
kalaik	கலைக்	கலைக்
koavan	கலைக்	கோவன்
koovan	கலைக்	கோவன்
kovan	கலைக்	கோவன்
choargal	கலைச்	சோர்கள்
chortkal	கலைச்	சொற்றுகள்
corkal	கலைச்	கோர்கள்
sorkkal	கலைச்	சொற்க்கள்
sortkal	கலைச்	சொற்றுகள்
kalaichchorkalai	கலைச்சொற்களை	கலைச்சொள்களை
kalicchorkalai	கலைச்சொற்களை	கலிச்சொற்களை
kalladi	கல்லடி	கல்லடி
kalluppatti	கல்லுப்பட்டி	கல்லப்பட்டி
kalloorigalin	கல்லூரிகளின்	கல்லோரிகளின்
kallorikalin	கல்லூரிகளின்	கல்லோரிகளின்
kallurigalin	கல்லூரிகளின்	கல்லிருகளின்
kallurigazhin	கல்லூரிகளின்	கல்லிருகளின்
kallurikalin	கல்லூரிகளின்	கல்லிருகளின்
kallurikazhin	கல்லூரிகளின்	கல்லிருக்களின்
kalloorigalil	கல்லூரிகளில்	கல்லோரிகளில்
kalloorikalil	கல்லூரிகளில்	கல்லோரிகளில்
kallurigalil	கல்லூரிகளில்	கல்லிருகளில்
kallurigazhil	கல்லூரிகளில்	கல்லிருகளில்
kallurikalil	கல்லூரிகளில்	கல்லிருகளில்
kallurikazhil	கல்லூரிகளில்	கல்லிருக்களில்
kalloorigalukkaana	கல்லூரிகளுக்கான	கல்லோரிக்குகளான
kalloorikalukkaana	கல்லூரிகளுக்கான	கல்லோரிக்குகளான
kallurigalukkana	கல்லூரிகளுக்கான	கல்லுரிக்குகள்ள
kallurigazhukkana	கல்லூரிகளுக்கான	கல்லுரிக்குகள்ள
kallurikalukkana	கல்லூரிகளுக்கான	கல்லுரிக்குகள்ள
kallurikazhukkana	கல்லூரிகளுக்கான	கல்லுரிக்குகள்ள
kalloorigal	கல்லூரிகள்	கல்லூரிகள்
kalloorikal	கல்லூரிகள்	கல்லோரிகள்
kallurigal	கல்லூரிகள்	கல்லிருகள்
kallurikal	கல்லூரிகள்	கல்லிருகள்
kalloorigalukku	கல்லூரிக்கு	கல்லோரிக்களுக்கு
kalloorikku	கல்லூரிக்கு	கல்லோரிக்கு
kallurikku	கல்லூரிக்கு	கல்லிருக்கு
kalloorip	கல்லூரிப்	கல்லூரிப்
kallurip	கல்லூரிப்	கல்லிரிப்
kallooriyin	கல்லூரியின்	கல்லோரியின்
kalluriyin	கல்லூரியின்	கல்லிரியின்
kallooriyilirindhu	கல்லூரியிலிருந்து	கல்லோரிலிருந்து
kallooriyilirundhu	கல்லூரியிலிருந்து	கல்லோரியிருந்து
kalluriyilirundhu	கல்லூரியிலிருந்து	கல்லியிருழிந்து
kalluriyilirunthu	கல்லூரியிலிருந்து	கல்லியிருழிந்து
kallooriyil	கல்லூரியில்	கல்லோரியில்
kalluriyil	கல்லூரியில்	கல்லிரியில்
kallooriyum	கல்லூரியும்	கல்லோரியும்
kalluriyum	கல்லூரியும்	கள்ளுறியும்
kallooriei	கல்லூரியை	கல்லூரி
kallooriyai	கல்லூரியை	கல்லோரியை
kalluriyai	கல்லூரியை	கல்லுறைய
kalvikku	கல்விக்கு	கல்விக்கு
kalvikkum	கல்விக்கும்	கல்விக்கும்
kalvich	கல்விச்	கல்விச்
kalviththittam	கல்வித்திட்டம்	கல்வித்திடம்
kalvip	கல்விப்	கல்விப்
kalviyaaga	கல்வியாக	கல்வியாக
kalviyin	கல்வியின்	கல்வியின்
kalviyil	கல்வியில்	கல்வியில்
kalvieiyum	கல்வியையும்	கல்வியையும்
kalviyaiyum	கல்வியையும்	கல்வியையும்
kaliman	களிமண்	கலிமன்
kalimun	களிமண்	கலிமனு
kazhiman	களிமண்	களிமன்
kalaiyum	களையும்	கலையும்
kazhaiyum	களையும்	கழையும்
kazhayum	களையும்	கழையும்
kalutaikal	கழுதைகள்	கலுடைகள்
kaluthaikal	கழுதைகள்	கலுதைகள்
kazhudhaigal	கழுதைகள்	கழுதைகள்
gavanippu	கவனிப்பு	கவனிப்பு
kavanippu	கவனிப்பு	கவனிப்பு
kavalaigalai	கவலைகளை	கவலைகளை
kavalaikalai	கவலைகளை	கவலைகளை
kavaligalai	கவலைகளை	கவலிலை
kavalaigal	கவலைகள்	கவலைகள்
kavalaikal	கவலைகள்	கவலைகள்
kavaligal	கவலைகள்	கவலிலகள்
kaviyarachu	கவியரசு	கவியராகு
kaviyaracu	கவியரசு	கவிவாயர்
kaviyarasu	கவியரசு	கவிவராசு
counti	கவுண்டி	கவுண்டி
countii	கவுண்டி	கௌந்தி
county	கவுண்டி	கவுண்டி
couunti	கவுண்டி	கௌவின்
couunty	கவுண்டி	கவுண்டி
kaunti	கவுண்டி	காண்டி
kaunty	கவுண்டி	காண்டி
kauunty	கவுண்டி	காண்டி
kavunti	கவுண்டி	கவுண்டி
kavuntii	கவுண்டி	கவுண்டி
kavuunti	கவுண்டி	கவுண்டி
kawunti	கவுண்டி	கவுண்டி
kounti	கவுண்டி	கவுண்டி
kountii	கவுண்டி	கௌவின்
kounty	கவுண்டி	கவுண்டி
kouunti	கவுண்டி	கவுண்டி
kouunty	கவுண்டி	கௌத்தி
qaunty	கவுண்டி	காண்டி
qavunti	கவுண்டி	கவுண்டி
qounti	கவுண்டி	கவுண்டி
qounty	கவுண்டி	கவுண்டி
conggo	காங்கோ	காங்கோ
congo	காங்கோ	காங்கோ
congoo	காங்கோ	கொங்கோ
congu	காங்கோ	கொங்கு
conngo	காங்கோ	காங்கோ
coonggoo	காங்கோ	காங்கோ
coongoo	காங்கோ	காங்கோ
coonngoo	காங்கோ	காங்கோ
kaango	காங்கோ	காங்கோ
kaanko	காங்கோ	காங்கோ
kankoo	காங்கோ	கன்கோ
kongo	காங்கோ	கொங்கோ
koongoo	காங்கோ	கோங்கோ
qongo	காங்கோ	கொங்கோ
kaattuvadhaagavum	காட்டுவதாகவும்	காட்டுவதாகவும்
kaattuvathaagavum	காட்டுவதாகவும்	காட்டுவதாகவும்
kaattuvadhai	காட்டுவதை	காட்டுவதை
kaattuvathai	காட்டுவதை	காட்டுவதை
kaangindranar	காண்கின்றனர்	காங்கின்றனர்
kaangintranar	காண்கின்றனர்	காங்கின்றனர்
kaankinranar	காண்கின்றனர்	காங்கின்றனர்
kaanbithththu	காண்பித்து	கான்பித்து
kaanbiththu	காண்பித்து	கான்பித்து
kaanpiththu	காண்பித்து	காண்பித்து
kaathi	காதி	காதி
kathi	காதி	கதி
kaadhirundhanar	காத்திருந்தனர்	காதிருந்தனர்
kaathirundhanar	காத்திருந்தனர்	காதிருந்தனர்
kaaththirunthanar	காத்திருந்தனர்	காத்திருந்தனர்
kaatthirunthanar	காத்திருந்தனர்	காத்திருந்தனர்
kaathirunthu	காத்திருந்து	காதிருந்து
kaaththirundhu	காத்திருந்து	காத்திருந்து
kaaththirunththu	காத்திருந்து	காத்திருந்து
kaaththirunthu	காத்திருந்து	காத்திருந்து
kaatthirunthu	காத்திருந்து	காத்திருந்து
kaanagaththin	கானகத்தின்	காணகத்தின்
kanakaththin	கானகத்தின்	கணக்கத்தின்
kaanagam	கானகம்	காணகம்
kanagam	கானகம்	கணகம்
kaabul	காபூல்	காபுல்
kabul	காபூல்	காபல்
kabuul	காபூல்	காபல்
kapuul	காபூல்	காபல்
qabul	காபூல்	காபலல்
kaapaatri	காப்பாற்றி	காப்பாற்றி
kaapaattri	காப்பாற்றி	காப்பட்டி
kaappaatri	காப்பாற்றி	காப்பாற்றி
kaappaatrti	காப்பாற்றி	காப்பாற்றி
kaappatrtri	காப்பாற்றி	காப்பற்றி
kaapaatrinaar	காப்பாற்றினார்	காப்பாற்றினார்
kaappaatrinaar	காப்பாற்றினார்	காப்பாற்றினார்
kaappaatrtrinaar	காப்பாற்றினார்	காப்பாற்றினார்
kaappu	காப்பு	காப்பு
kappu	காப்பு	கப்பு
kaappuch	காப்புச்	காப்புச்
kappuch	காப்புச்	கப்புச்
kaaranangalukkaagavum	காரணங்களுக்காகவும்	காரணங்களாக்குகும்
kaaranangalukkaakavum	காரணங்களுக்காகவும்	காரணங்களாக்குகும்
karananggalukkaakavum	காரணங்களுக்காகவும்	காரணங்களுக்கவும்கு
kaaranaththai	காரணத்தை	காரணத்தை
kaaranattai	காரணத்தை	காரணத்தை
kaaranatthai	காரணத்தை	காரணத்தை
karanaththai	காரணத்தை	காரணத்தை
kaaranaththaip	காரணத்தைப்	காரணத்தைப்
kaaranattaip	காரணத்தைப்	காரணத்தைப்
kaaranatthaip	காரணத்தைப்	காரணத்தைப்
karanaththaip	காரணத்தைப்	காரணத்தைப்
kaaranamaaga	காரணமாக	காரணமாக
kaaranamaaka	காரணமாக	காரணமாக
karanamaaka	காரணமாக	காரணமாக
kaaranamaakak	காரணமாகக்	காரணமாகக்
karanamaakach	காரணமாகக்	காரணமாகச்
kaaranamaagath	காரணமாகத்	காரணமாகத்
kaaranamaakat	காரணமாகத்	காரணமாகத்
kaaranamaakath	காரணமாகத்	காரணமாகத்
karanamaakath	காரணமாகத்	காரணமாகத்
kaaranamaakavo	காரணமாகவோ	காரணமாகவோ
karanamaakavo	காரணமாகவோ	காரணமாகவோ
kaaram	காரம்	காரம்
carin	காரின்	கரின்
kaarin	காரின்	காரின்
caril	காரில்	கேரில்
kaaril	காரில்	காரில்
carai	காரை	கேரி
kaarai	காரை	காரை
caar	கார்	சார்
car	கார்	கேர்
kar	கார்	கேர்
cargalai	கார்களை	கர்கலை
kaargalai	கார்களை	கார்களை
kaarkalai	கார்களை	கார்களை
carbon	கார்பன்	கார்பன்
kaarban	கார்பன்	கார்பன்
kaarpan	கார்பன்	கார்பன்
karban	கார்பன்	கர்பன்
karbon	கார்பன்	கார்பன்
karbonn	கார்பன்	கார்பன்
karpan	கார்பன்	கற்பன்
qarban	கார்பன்	கர்பன்
qarbon	கார்பன்	கார்பன்
qarbonn	கார்பன்	கார்பன்
caarl	கார்ல்	சார்
carl	கார்ல்	சார்ல்
carll	கார்ல்	சார்ல்
karl	கார்ல்	கேர்
karll	கார்ல்	கற்றல்
qarl	கார்ல்	கேர்
qarll	கார்ல்	கேர்ல்
kaatraal	காற்றால்	காற்றால்
katraal	காற்றால்	கற்றால்
kaatrinaal	காற்றினால்	காற்றினால்
katrinaal	காற்றினால்	கற்றினால்
kaatrilirundhu	காற்றிலிருந்து	காற்றிலிருந்து
kaatrilirunthu	காற்றிலிருந்து	காற்றிலிருந்து
katrilirunthu	காற்றிலிருந்து	கற்றிலிருந்து
kaalakatta	காலகட்ட	காலகத்த
kalakatta	காலகட்ட	கலகத்த
kaalakattaththin	காலகட்டத்தின்	காலகட்தத்தின்
kalakattaththin	காலகட்டத்தின்	கலகக்தத்தின்
kaalakattam	காலகட்டம்	காலகட்டம்
kalakattam	காலகட்டம்	கழகத்தம்
kattangal	காலக்	கட்டங்கள்
kattangkal	காலக்	கட்டங்கள்
kattankal	காலக்	கட்டங்கள்
kattaththai	காலக்	கட்டத்தை
kattattai	காலக்	கட்டட்டை
keduvukkul	காலக்	கேடுவுக்குள்
ketuvukkul	காலக்	கேடுவுக்குள்
colony	காலணி	காலனி
kaalani	காலணி	காலனி
kaalaththaik	காலத்தைக்	காலத்தைக்
kaalattaik	காலத்தைக்	காலத்தைக்
kaalatthaik	காலத்தைக்	காலத்தைக்
kaalaththaip	காலத்தைப்	காலத்தைப்
kaalattaip	காலத்தைப்	காலத்தைப்
kaalatthaip	காலத்தைப்	காலத்தைப்
kaavalthurai	காவல்துறை	கால்த்துறை
kaavalturai	காவல்துறை	கால்ுறு
kaavthurai	காவல்துறை	காத்துறை
kaavalthuraiyin	காவல்துறையின்	கால்துறையின்
kaavalturaiyin	காவல்துறையின்	கால்ுத்தையின்
kaavalthuraiyil	காவல்துறையில்	கால்ுத்தையில்
kaavalturaiyil	காவல்துறையில்	கால்ுறையில்
kaavalthuraiyum	காவல்துறையும்	கால்துறையும்
kaavalturaiyum	காவல்துறையும்	கால்ுறுகையும்
kaavalthuraiyai	காவல்துறையை	கால்த்துறையை
kaavalturaiyai	காவல்துறையை	கால்்துறையை
kidangkugal	கிடங்குகள்	கிடங்குகள்
kidangugal	கிடங்குகள்	கிடங்குகள்
kidangukal	கிடங்குகள்	கிடங்குகள்
kidankukal	கிடங்குகள்	கிடங்குகள்
kitankukal	கிடங்குகள்	கிட்டங்குகள்
kidandhadhu	கிடந்தது	கிடைந்தது
kidandhathu	கிடந்தது	கிடைந்தது
kidanthathu	கிடந்தது	கிடைந்தது
kitantatu	கிடந்தது	கிட்டாண்டு
kitanthathu	கிடந்தது	கிடைந்தது
kidandhana	கிடந்தன	கிடுந்தன
kidantana	கிடந்தன	கிடுந்தன
kidanthana	கிடந்தன	கிடுந்தன
kitantana	கிடந்தன	கிட்டந்தன
kidandhan	கிடந்தான்	கிடுந்தன்
kidanthaan	கிடந்தான்	கிடுந்தான்
kidanthan	கிடந்தான்	கிடுந்தன்
kitantaan	கிடந்தான்	கிட்டான்
kidandhar	கிடந்தார்	கிட்ந்தரர்
kidanthaar	கிடந்தார்	கிடைந்தார்
kidanthar	கிடந்தார்	கிடைந்தர்
kitantaar	கிடந்தார்	கிட்டாந்தார்
kidandhu	கிடந்து	கிட்ந்து
kidanthu	கிடந்து	கிடைந்து
kidantu	கிடந்து	கிடாண்டு
kitanthu	கிடந்து	கிட்டந்து
kitantu	கிடந்து	கிட்ட்டு
kidai	கிடை	கிடை
kidaikkach	கிடைக்கச்	கிடைக்கச்
kidaikkap	கிடைக்கப்	கிடைக்கப்
kidaikkaadha	கிடைக்காத	கிடைக்காத
kidaikkaatha	கிடைக்காத	கிடைக்காத
kidaikkaamal	கிடைக்காமல்	கிடைக்காமல்
kitaikkaamal	கிடைக்காமல்	கிடைக்காமல்
kidaikkum	கிடைக்கும்	கிடைக்கும்
kitaikkum	கிடைக்கும்	கிடைக்கும்
kidaikkumbodhu	கிடைக்கும்போது	கிடைக்கும்போது
kidaikkumboodhu	கிடைக்கும்போது	கிடைக்கும்போது
kidaikkumbothu	கிடைக்கும்போது	கிடைக்கும்போது
kidaikkumpodhu	கிடைக்கும்போது	கிடைக்கும்போது
kidaikkumpoodhu	கிடைக்கும்போது	கிடைக்கும்போது
kidaikkumpootu	கிடைக்கும்போது	கிடைக்கும்போது
kidaikkumpothu	கிடைக்கும்போது	கிடைக்கும்போது
kitaikkumpootu	கிடைக்கும்போது	கிடைக்கும்போது
ginnas	கின்னஸ்	கின்ஷன்
ginnes	கின்னஸ்	கின்ஸிஸ்
guines	கின்னஸ்	குயின்ஸ்
guinness	கின்னஸ்	குயின்ஸ்ஸ்
guuinness	கின்னஸ்	குயின்ஸ்ஸ்
kinnas	கின்னஸ்	கின்ணஸ்
kinnes	கின்னஸ்	கின்னிஸ்
kinns	கின்னஸ்	கின்ஸ்
cubavin	கியூபாவின்	குபாவின்
kiyoobaavin	கியூபாவின்	கியோபோவின்
kiyoopaavin	கியூபாவின்	கியோபோவின்
grantha	கிரந்த	கிராந்த
kirantha	கிரந்த	கிராந்த
krantha	கிரந்த	கிராந்த
graham	கிரஹாம்	கிராம்
kirubakaran	கிருபாகரன்	கிருப்பரன்
kirubhaagaran	கிருபாகரன்	கிருப்பாரன்
kirubhaakaran	கிருபாகரன்	கிருப்பாரன்
kirupakaran	கிருபாகரன்	கிருப்பரன்
kiristhavar	கிறித்தவர்	கிறிஸ்தவர்
kiriththavar	கிறித்தவர்	கிரித்தவர்
kiritthavar	கிறித்தவர்	கிறித்தவர்
kiriththuvam	கிறித்துவம்	கிரித்துவம்
keelo	கிலோ	கிலோ
keeloo	கிலோ	கிலோ
kiilo	கிலோ	கிலோ
kilo	கிலோ	கிலோ
kiloo	கிலோ	கிலோ
kylo	கிலோ	கிலோ
kyloo	கிலோ	கிலோ
qeelo	கிலோ	கிலோ
qilo	கிலோ	கிலோ
qylo	கிலோ	கிலோ
keevi	கிவி	கீவி
keewi	கிவி	கீவி
keewii	கிவி	கீவி
kiivi	கிவி	கிவி
kiiwi	கிவி	கிவி
kiiwii	கிவி	கிவி
kivi	கிவி	கிவி
kivii	கிவி	கிவி
kiwi	கிவி	கிவி
kiwii	கிவி	கிவி
qeewi	கிவி	கிவி
qiiwi	கிவி	கிவி
qiwi	கிவி	கிவி
qiwii	கிவி	கிவி
geethaiyin	கீதையின்	கீதையின்
geethayin	கீதையின்	கீதாயின்
green	கீரன்	கிரின்
keeran	கீரன்	கீரான்
kunggumappoo	குங்குமப்பூ	குங்கும்போபு
kungkumappoo	குங்குமப்பூ	குங்கும்போபு
kungumapoo	குங்குமப்பூ	குங்குமாபோ
kungumappoo	குங்குமப்பூ	குங்கும்போபு
kuchaylar	குசேலர்	குச்சல்
kuchelar	குசேலர்	குச்சல்
kusaylar	குசேலர்	குசையல்
kuselar	குசேலர்	குசூல்
kuch	குச்	குக்
kuchh	குச்	குச்
kuuch	குச்	காச்
kuuchh	குச்	குச்
quch	குச்	குக்
quchh	குச்	குச்
quuch	குச்	காச்
gunamaagum	குணமாகும்	குணமாகும்
gunamagum	குணமாகும்	குணமாகும்
kunamaakum	குணமாகும்	குணமாகும்
gunavardhana	குணவர்தன	குணர்வந்த
gunavarththana	குணவர்தன	குணர்ந்தவ
gunaathisayanggalai	குணாதிசயங்களை	குணாத்திச்களை
gunadhisayangalai	குணாதிசயங்களை	குணத்திகளையால
gunathisayankalai	குணாதிசயங்களை	குணத்திகளையால
gunaathisanggal	குணாதிசயங்கள்	குணாத்திகளக்
gunaathisayanggal	குணாதிசயங்கள்	குணாத்சிக்களை
gunadhisayangal	குணாதிசயங்கள்	குணத்திகாலல்
kuththappattu	குத்தப்பட்டு	குத்தப்பட்டு
kuthdhudhal	குத்துதல்	குத்துதல்
kuththudhal	குத்துதல்	குத்துதல்
kuththuthal	குத்துதல்	குத்துதல்
kutthuthal	குத்துதல்	குத்துதல்
guptha	குப்த	குப்த
kuptha	குப்த	குப்த
kumili	குமிழி	குமிலி
kumizhi	குமிழி	குமிழி
kumilikal	குமிழிகள்	குமிலில்கள்
kumizhgal	குமிழிகள்	குமிழ்கள்
kumizhigal	குமிழிகள்	குமிழிகள்
kumizhikal	குமிழிகள்	குமிழிகள்
gummi	கும்மி	கம்மி
kummi	கும்மி	கும்மி
kurudi	குருதி	குறுடி
kuruthi	குருதி	குறுதி
kurudich	குருதிச்	குருடிச்
kuruthich	குருதிச்	குறுத்தி
kurudhip	குருதிப்	குறுதிப்
kuruthip	குருதிப்	குறுதிப்
kurudiyin	குருதியின்	குறுதியின்
kuruthiyin	குருதியின்	குறுதியின்
kurudiyil	குருதியில்	குறுதியில்
kuruthiyil	குருதியில்	குறுதியில்
kurudhiyai	குருதியை	குறுதியை
kuruthiyai	குருதியை	குறுதியை
guruvikal	குருவிகள்	குருவிகள்
kuruvigal	குருவிகள்	குறுவிகள்
guraikkum	குரைக்கும்	குறைக்கும்
kuraikkum	குரைக்கும்	குறைக்கும்
kuraikum	குரைக்கும்	குறைக்கும்
kuravanjchi	குறவஞ்சி	குரவஞ்சி
kuravanji	குறவஞ்சி	குரவஞ்சி
kuripil	குறிப்பில்	குறிப்பில்
kurippil	குறிப்பில்	குறிப்பில்
kurippaedu	குறிப்பேடு	குறிப்பேடு
kurippedu	குறிப்பேடு	குறிப்பேடு
kurugalaana	குறுகலான	குருகலான
kurukku	குறுக்கு	குறுக்கு
kurukkuk	குறுக்குக்	குறுக்குக்
kuraindha	குறைந்த	குறைந்த
kuraindhdha	குறைந்த	குறைந்த
kuraintha	குறைந்த	குறைந்த
kuraindhadhaaga	குறைந்ததாக	குறைந்ததாக
kuraindhdhadhaaga	குறைந்ததாக	குறைந்ததாக
kurainthathaaka	குறைந்ததாக	குறைந்ததாக
kuraindadhaal	குறைந்ததால்	குறைந்தாலல்
kuraindhdhadhaal	குறைந்ததால்	குறைந்ததால்
kurainthathaal	குறைந்ததால்	குறைந்ததால்
kuraindhadhu	குறைந்தது	குறைந்தது
kuraindhdhadhu	குறைந்தது	குறைந்தது
kurainthathu	குறைந்தது	குறைந்தது
kuraindhana	குறைந்தன	குறைந்தன
kuraindhdhana	குறைந்தன	குறைந்தன
kurainthana	குறைந்தன	குறைந்தன
kuraindhaalum	குறைந்தாலும்	குறைந்தாலும்
kuraindhdhaalum	குறைந்தாலும்	குறைந்தாலும்
kurainthaalum	குறைந்தாலும்	குறைந்தாலும்
kuraindhdhullathu	குறைந்துள்ளது	குறைந்துள்ளது
kuraindhulladhu	குறைந்துள்ளது	குறைந்துள்ளது
kurainthulladhu	குறைந்துள்ளது	குறைந்துள்ளது
kulanggalil	குளங்களில்	குழங்களில்
kulangkalil	குளங்களில்	குழங்களில்
kulanggalukku	குளங்களுக்கு	குழங்களுக்கு
kulangkalukku	குளங்களுக்கு	குழங்களுக்கு
kulirchchiyaana	குளிர்ச்சியான	குளிர்ச்சியான
kulai	குழை	குழை
kuzai	குழை	குழை
kuzhai	குழை	குழை
gooam	குவாம்	கோம்
guam	குவாம்	காம்
guama	குவாம்	காமா
guuam	குவாம்	காம்
guuama	குவாம்	காம
kuvam	குவாம்	குவம்
kuvindha	குவிந்த	குவிந்த
kuvinta	குவிந்த	குவிந்த
kuvintha	குவிந்த	குவிந்த
kuvindhulladhu	குவிந்துள்ளது	குணிந்துள்ளது
kuvindhullathu	குவிந்துள்ளது	குணிந்துள்ளது
kuvinthullathu	குவிந்துள்ளது	குவிந்துள்ளது
kuvintullathu	குவிந்துள்ளது	குணிந்துள்ளது
kuvintullatu	குவிந்துள்ளது	குணிந்துள்ள
koodam	கூடம்	கோடம்
koodi	கூடி	கோடி
koodith	கூடித்	கோடித்
koodinar	கூடினர்	கூடினர்
koodip	கூடிப்	கோடிப்
koodu	கூடு	கோடு
kuudu	கூடு	கூடு
kuutu	கூடு	கூட்டு
koodugalai	கூடுகளை	கூடுகளை
koodukalai	கூடுகளை	கூடுகளை
kuudukalai	கூடுகளை	கூடுகளை
kuutukalai	கூடுகளை	கூடுகளை
koodugal	கூடுகள்	கூடுகள்
koodukal	கூடுகள்	கூடுகள்
kuudugal	கூடுகள்	கூடுகள்
kuudukal	கூடுகள்	கூடுகள்
kuutukal	கூடுகள்	கூடுகள்
kootta	கூட்ட	கூட்ட
kuuta	கூட்ட	கூட்ட
kuutta	கூட்ட	கூட்ட
koottangalil	கூட்டங்களில்	கூட்டங்களில்
kuuttangalil	கூட்டங்களில்	கூட்டங்களில்
kuuttankalil	கூட்டங்களில்	கூட்டங்களில்
koottangalum	கூட்டங்களும்	கூட்டங்களும்
kuuttangalum	கூட்டங்களும்	கூட்டங்களும்
kuuttankalum	கூட்டங்களும்	கூட்டங்களும்
koottaththirku	கூட்டத்திற்கு	கூட்டத்திற்கு
kuuttatthirku	கூட்டத்திற்கு	கூட்டத்திற்கு
kuuttattirku	கூட்டத்திற்கு	கூட்டிட்டுக்கு
koottaththil	கூட்டத்தில்	கூட்டத்தில்
koottatthil	கூட்டத்தில்	கூட்டத்தில்
kuuttatil	கூட்டத்தில்	கூட்டத்தில்
kuuttatthil	கூட்டத்தில்	கூட்டத்தில்
kuuttattil	கூட்டத்தில்	கூட்டத்தில்
koottaththudan	கூட்டத்துடன்	கூட்டத்துடன்
koottatthudan	கூட்டத்துடன்	கூட்டத்துடன்
kuutattudan	கூட்டத்துடன்	கூட்டடுடன்
kuutattutan	கூட்டத்துடன்	கூட்டடுந்தன்
koottaththaik	கூட்டத்தைக்	கூட்டத்தைக்
koottatthaik	கூட்டத்தைக்	கூட்டத்தைக்
kuuttattaik	கூட்டத்தைக்	கூட்டத்தைக்
kuuttatthaik	கூட்டத்தைக்	கூட்டத்தைக்
koottaththaip	கூட்டத்தைப்	கூட்டத்தைப்
koottatthaip	கூட்டத்தைப்	கூட்டத்தைப்
kuuttataip	கூட்டத்தைப்	கூட்டடைப்
kuuttattaip	கூட்டத்தைப்	கூட்டட்டைப்
koottal	கூட்டல்	கோட்டல்
koottavo	கூட்டவோ	கூட்டோ
kuutavoo	கூட்டவோ	கூட்டோ
kuuttavoo	கூட்டவோ	கூட்டோவோ
koottagach	கூட்டாகச்	கூட்டகச்
koottakach	கூட்டாகச்	கூட்டகச்
kuuttaakac	கூட்டாகச்	கூட்டாகச்
kuuttaakach	கூட்டாகச்	கூட்டாகச்
kootinaal	கூட்டினால்	கோட்டினால்
koottinaal	கூட்டினால்	கூட்டினால்
koottinal	கூட்டினால்	கோட்டினால்
koottuvadharkku	கூட்டுவதற்கு	கூட்டுவதற்கு
koottuvadharku	கூட்டுவதற்கு	கூட்டுவதற்கு
koottuvatharku	கூட்டுவதற்கு	கூட்டுவதற்கு
koottai	கூட்டை	கோட்டை
koorai	கூரை	கோரை
kooraigal	கூரைகள்	கூறைகள்
kooraikal	கூரைகள்	கூறைகள்
kooreigal	கூரைகள்	கூரிகள்
kooraiyin	கூரையின்	கூறையின்
kooraiyilirundhu	கூரையிலிருந்து	கூறையிலிருந்து
kooraiyilirunthu	கூரையிலிருந்து	கூறையிலிருந்து
koorayilirindhu	கூரையிலிருந்து	கூரையிலிருந்து
mudiyuma	கூற	முடிய
mudiyumaa	கூற	முடியுமா
mutiyuma	கூற	முடிய
mutiyumaa	கூற	முடியாக
koorappattadhu	கூறப்பட்டது	கூறப்பட்டது
koorappattathu	கூறப்பட்டது	கூறப்பட்டது
kuurapattatu	கூறப்பட்டது	கூறப்பட்டது
kuurappattatu	கூறப்பட்டது	கூறப்பட்டது
koorappattana	கூறப்பட்டன	கூறப்பட்டன
kuurapattana	கூறப்பட்டன	கூறப்பட்டன
kuurappattana	கூறப்பட்டன	கூறப்பட்டன
koorappattaalum	கூறப்பட்டாலும்	கூறப்பட்டாலும்
kuurappataalum	கூறப்பட்டாலும்	கூறப்படாலும்
kuurappattaalum	கூறப்பட்டாலும்	கூறப்பட்டாலும்
koorappattaal	கூறப்பட்டால்	கூறப்பட்டால்
kuurapattaal	கூறப்பட்டால்	கூறப்பட்டால்
kuurappattaal	கூறப்பட்டால்	கூறப்பட்டால்
koorappattulla	கூறப்பட்டுள்ள	கூறப்பட்டுள்ள
kuurapattulla	கூறப்பட்டுள்ள	கூறப்பட்டுள்ள
kuurappattulla	கூறப்பட்டுள்ள	கூறப்பட்டுள்ள
kooravillai	கூறவில்லை	கூறவில்லை
kuuravillai	கூறவில்லை	கூறவில்லை
kooravae	கூறவே	கோரவே
koorave	கூறவே	கோரவே
kuravee	கூறவே	குரவே
koorinaal	கூறினால்	கூறினால்
kuurinaal	கூறினால்	கூறினால்
koorudhal	கூறுதல்	கூறுதல்
kooruthal	கூறுதல்	கூறுதல்
koorumpoadhu	கூறும்போது	கூறும்போது
koorumpodhu	கூறும்போது	கூறும்போது
koorumpothu	கூறும்போது	கூறும்போது
kedu	கெடு	கேடு
kaeplar	கெப்லர்	கேப்பர்
keeplar	கெப்லர்	கீப்பர்
keplar	கெப்லர்	கெப்பர்
kepler	கெப்லர்	கெப்ளர்
kiiplar	கெப்லர்	கிப்பர்
qeeplar	கெப்லர்	கீப்பர்
qeplar	கெப்லர்	கெப்ளர்
qepler	கெப்லர்	கெப்ளர்
kaellar	கெல்லர்	கேல்லர்
keler	கெல்லர்	கேலர்
kellar	கெல்லர்	கேல்லர்
keller	கெல்லர்	கேல்லர்
qeller	கெல்லர்	கேல்லர்
ccelli	கெல்லி	செல்லி
ccelly	கெல்லி	கெல்லி
ccely	கெல்லி	கெல்லி
celli	கெல்லி	செல்லி
celly	கெல்லி	செல்லி
cely	கெல்லி	செல்லி
kaelli	கெல்லி	கேலி
keley	கெல்லி	கேலி
keli	கெல்லி	கேலி
kellei	கெல்லி	கெல்லி
kelley	கெல்லி	கெல்லி
kelli	கெல்லி	கெல்லி
kelly	கெல்லி	கெல்லி
kely	கெல்லி	கெல்லி
qelley	கெல்லி	கெல்லி
qelli	கெல்லி	கெல்லி
qelly	கெல்லி	கெல்லி
gautham	கெளதம்	கௌதம்
goutham	கெளதம்	கௌதம்
kaudham	கெளதம்	கௌதம்
kovtham	கெளதம்	கௌத்தம்
catalina	கேடலினா	கடலின
cetalina	கேடலினா	சொட்லானி
keedalina	கேடலினா	கீடலினான
kaetta	கேட்ட	கேட்ட
ketta	கேட்ட	கேட்ட
kaettadhai	கேட்டதை	கேட்டதை
kaettathai	கேட்டதை	கேட்டதை
ketadhai	கேட்டதை	கேட்தை
ketathai	கேட்டதை	கேட்ததை
kaettal	கேட்டல்	கேட்டல்
kettal	கேட்டல்	கேட்டல்
kaettavar	கேட்டவர்	கேட்டவர்
kettavar	கேட்டவர்	கேட்டவர்
kaettaan	கேட்டான்	கேட்டான்
kettan	கேட்டான்	கேட்டன்
catie	கேட்டி	கேட்
catiee	கேட்டி	கேடி
cetie	கேட்டி	செட்டி
kaetti	கேட்டி	கேட்டி
kati	கேட்டி	கேடி
katie	கேட்டி	கேடி
katiee	கேட்டி	கதி
katii	கேட்டி	காடி
katiie	கேட்டி	கேடி
katiiee	கேட்டி	கதி
kattie	கேட்டி	கட்டி
kattiee	கேட்டி	கட்டி
katy	கேட்டி	கதி
katyi	கேட்டி	கத்தி
ketie	கேட்டி	கேட்டி
ketiee	கேட்டி	கேடி
ketiie	கேட்டி	கேட்டி
ketti	கேட்டி	கேட்டி
kettie	கேட்டி	கேட்டி
kety	கேட்டி	கெட்டி
ketyi	கேட்டி	கெட்டி
qatie	கேட்டி	கேடி
qatiee	கேட்டி	கதி
qatiie	கேட்டி	கேடி
qattie	கேட்டி	கட்டி
qaty	கேட்டி	கத்தி
qatyi	கேட்டி	கட்டி
kaettum	கேட்டும்	கேட்டும்
kettum	கேட்டும்	கேட்டும்
kaendhira	கேந்திர	கேந்திர
kaenthira	கேந்திர	கேந்திர
kendhira	கேந்திர	கேந்திர
kendra	கேந்திர	கென்ற
kaikoarkka	கைகோர்க்க	கைகோர்க்க
kaikoorkka	கைகோர்க்க	கைகோர்க்க
kaikorkka	கைகோர்க்க	கைகோர்க்க
kaik	கைக்	கைக்
kaidhi	கைதி	கைி
kaithi	கைதி	கைதி
kaydhi	கைதி	காதி
kaythi	கைதி	கயித்
kaidhigaludan	கைதிகளுடன்	கைதிலகுடன்
kaidhigalutan	கைதிகளுடன்	கைதிலக்கடன்
kaidhikaludan	கைதிகளுடன்	கைதிக்கடுள்ளன
kaithigaludan	கைதிகளுடன்	கைதிதுகளுடன்
kaithigalutan	கைதிகளுடன்	கைதித்களுடன்
kaidhigalaiyum	கைதிகளையும்	கைதிலகையும்
kaidhikalaiyum	கைதிகளையும்	கைதிலகையும்
kaithigalaiyum	கைதிகளையும்	கைதிலகளையும்
kaiyin	கையின்	கையின்
kaiyoppamitta	கையொப்பமிட்ட	கையோம்ப்போத
kaiyoppamittaar	கையொப்பமிட்டார்	கையோம்ப்போத்டார்
kaiyoppamittar	கையொப்பமிட்டார்	கையோம்ப்போத்டர்
kaivittanar	கைவிட்டனர்	கைவிட்டனர்
kaiviral	கைவிரல்	கைவிறல்
kodukkiradhu	கொடுக்கிறது	கொடுக்கிறது
kodukkirathu	கொடுக்கிறது	கொடுக்கிறது
kodukkiraan	கொடுக்கிறான்	கொடுக்கிறான்
kodukkiraar	கொடுக்கிறார்	கொடுக்கிறார்
kottagai	கொட்டகை	கோட்டகை
kottagaikku	கொட்டகைக்கு	கொட்டககைக்கு
vidugirathu	கொட்டி	விடுகிறது
vidukirathu	கொட்டி	விடுகிறது
vitukiratu	கொட்டி	விடுகிறது
kottik	கொட்டிக்	கோட்டிக்
konara	கொணர	கொன்ற
kondaa	கொண்டா	கொண்டா
kondirukkaamal	கொண்டிருக்காமல்	கொண்டிருக்காலம்
kondirukkamal	கொண்டிருக்காமல்	கொண்டிருக்காலம்
kontirukkamal	கொண்டிருக்காமல்	கொண்டிருக்காலம்
kodhi	கொதி	கொதி
kothi	கொதி	கோதி
kodhikka	கொதிக்க	கொதிக்க
kothikka	கொதிக்க	கொதிக்க
gorilla	கொரில்லாப்	கோரில்ல
gorillaap	கொரில்லாப்	கோரில்லப்
gorillap	கொரில்லாப்	கோரில்ப்
korillaap	கொரில்லாப்	கோரில்லப்
kolusu	கொலுசு	கொழுுு
kolgiraar	கொள்கிறார்	கொல்கிறார்
kolkiraar	கொள்கிறார்	கொல்கிறார்
kolgiraen	கொள்கிறேன்	கொல்கிறேன்
kolkirayn	கொள்கிறேன்	கொல்கிறான்
kollvadhan	கொள்வதன்	கொள்வதன்
kolvadhan	கொள்வதன்	கொள்வதன்
kolvathan	கொள்வதன்	கொள்வதன்
kolvadharkaaga	கொள்வதற்காக	கொள்வதற்காக
kolvatharkaaka	கொள்வதற்காக	கொள்வதற்காக
kollvadharkaagavum	கொள்வதற்காகவும்	கொள்வதற்கவும்கும
kolvadharkaagavum	கொள்வதற்காகவும்	கொள்வதற்கவும்கும
kolvatharkkakavum	கொள்வதற்காகவும்	கொள்வதற்காுக்கம்
kollvadhaaga	கொள்வதாக	கொள்வதாக
kolvadhaaga	கொள்வதாக	கொள்வதாக
kolvathaaka	கொள்வதாக	கொள்வதாக
kollvathaagum	கொள்வதாகும்	கொள்வதாகும்
kolvadhaagum	கொள்வதாகும்	கொள்வதாகும்
kolvathaakum	கொள்வதாகும்	கொள்வதாகும்
kolu	கொழு	கொழு
kozhu	கொழு	கொழு
koadaari	கோடாரி	கோடாரி
koodaari	கோடாரி	கூடாரி
kootaari	கோடாரி	கோட்டாரி
kaalangalil	கோடைக்	காலங்களில்
kaalangazhil	கோடைக்	காலங்களில்
kaalangkalil	கோடைக்	காலங்களில்
kalankalil	கோடைக்	கலங்களில்
koatpaatukalil	கோட்பாடுகளில்	கோட்பாட்டுகளில்
kootpaadugalil	கோட்பாடுகளில்	கோட்பாட்டுகளில்
kootpaadukalil	கோட்பாடுகளில்	கோட்பாட்டுகளில்
kootpaatukalil	கோட்பாடுகளில்	கோட்பாட்டுகளில்
koatpaatugalukku	கோட்பாடுகளுக்கு	கோட்பாட்டுகளுக்க
kootpaadugalukku	கோட்பாடுகளுக்கு	கோட்பாட்டுகளுக்க
kootpaadukalukku	கோட்பாடுகளுக்கு	கோட்பாட்டுகளுக்க
kootpaatugalukku	கோட்பாடுகளுக்கு	கோட்பாட்டுகளுக்க
kootpaatukalukku	கோட்பாடுகளுக்கு	கோட்பாட்டுகளுக்க
koatpaatukalaip	கோட்பாடுகளைப்	கோட்பாட்டுகளை
kootpaadugalaip	கோட்பாடுகளைப்	கோட்பாட்டுகளை
kootpaadukalaip	கோட்பாடுகளைப்	கோட்பாட்டுகளை
kootpaatugalaip	கோட்பாடுகளைப்	கோட்பாட்டுகளை
kootpaatukalaip	கோட்பாடுகளைப்	கோட்பாட்டுகளை
koatpaatukalaiyum	கோட்பாடுகளையும்	கோட்பாட்டையுக்கு
kootpaadukalaiyum	கோட்பாடுகளையும்	கோட்பாட்டுகளையும்
koatpaatukal	கோட்பாடுகள்	கோட்பாட்டுகள்
kootpaadugal	கோட்பாடுகள்	கோட்பாட்டுகள்
kootpaadukal	கோட்பாடுகள்	கோட்பாட்டுகள்
kootpaatukal	கோட்பாடுகள்	கோட்பாட்டுகள்
godhra	கோத்ரா	கோத்ர
koathraa	கோத்ரா	கோத்தாரா
koothraa	கோத்ரா	கூத்தாரா
kootraa	கோத்ரா	கோற்றா
conan	கோனன்	கோனன்
conann	கோனன்	கோனன்
connan	கோனன்	கான்னன்
coonan	கோனன்	கோனன்
coonann	கோனன்	கோனன்
coonnan	கோனன்	கோனன்
coounan	கோனன்	கோனன்
coownan	கோனன்	குவன்
counan	கோனன்	கோனன்
couunan	கோனன்	கௌனன்
covnan	கோனன்	கோனன்
cownan	கோனன்	குவன்
koonn	கோனன்	கோன்
koapiththukkondu	கோபித்துக்கொண்டு	கோபித்துக்கொண்டு
kobiththukkondu	கோபித்துக்கொண்டு	கொகித்துக்கொண்டு
kobithukondu	கோபித்துக்கொண்டு	கோபித்துகொண்டு
koopitthukkontu	கோபித்துக்கொண்டு	கோபித்துக்கொண்டு
koopittukkondu	கோபித்துக்கொண்டு	கோபிட்டுக்கொண்டு
koopittukkontu	கோபித்துக்கொண்டு	கோபிட்டுக்கொண்டு
kopiththukkondu	கோபித்துக்கொண்டு	கோபித்துக்கொண்டு
kopithukondu	கோபித்துக்கொண்டு	கோபித்துக்கொண்டு
koamagan	கோமகன்	கோமகன்
komagan	கோமகன்	கோமகன்
koomagan	கோமகன்	கோமகன்
koomakan	கோமகன்	கோமகன்
caul	கோல்	கால்
cauul	கோல்	கால்
col	கோல்	கால்
coll	கோல்	கொல்
cool	கோல்	கோல்
cooll	கோல்	கோல்
goal	கோல்	கோல்
goall	கோல்	கோல்
gol	கோல்	கோல்
gooal	கோல்	கோல்
gooall	கோல்	கோல்
gool	கோல்	கோல்
gooul	கோல்	கோல்
goul	கோல்	கால்
gouul	கோல்	கால்
kaul	கோல்	கால்
kauul	கோல்	கால்
kol	கோல்	கொல்
kole	கோல்	கோல்
kool	கோல்	கோல்
qaul	கோல்	கால்
qol	கோல்	கோல்
goalgal	கோல்கள்	கோல்கள்
goalkal	கோல்கள்	கோல்கள்
kolgal	கோல்கள்	கொள்கள்
koolkal	கோல்கள்	கோல்கள்
golconda	கோல்கொண்டா	கால்கிண்டா
golkonda	கோல்கொண்டா	கோல்கொண்ட
koolkondaa	கோல்கொண்டா	கோல்கொண்டா
koolkontaa	கோல்கொண்டா	கோல்கொண்டா
kolil	கோளில்	கொழில்
koolil	கோளில்	கோலில்
koovalar	கோவலர்	கோவலர்
kovalar	கோவலர்	கோவலர்
gouravaththai	கௌரவத்தை	கௌரவத்தை
gowravathai	கௌரவத்தை	கௌரவத்தை
gowrawaththay	கௌரவத்தை	கௌரவத்தை
kouravaththay	கௌரவத்தை	கௌரவத்தை
gouravamana	கௌரவமான	கௌருவமான
gowravamaana	கௌரவமான	கௌரவமமான
gowrawamaana	கௌரவமான	கௌரவமான
kouravamaana	கௌரவமான	கௌரவமமான
gauravam	கௌரவம்	கௌரவம்
gowravam	கௌரவம்	கௌரவம்
kauravam	கௌரவம்	கௌரவம்
kouravam	கௌரவம்	கௌரவம்
gouravippu	கௌரவிப்பு	கௌரவிப்பு
gowravippu	கௌரவிப்பு	கௌரவிப்பு
gowrawippu	கௌரவிப்பு	கௌரவிப்பு
kouravippu	கௌரவிப்பு	கௌரவிப்பு
saga	சக	சகா
saka	சக	சகா
cagaaya	சகாய	காசாய
cakaaya	சகாய	காசாய
chagaaya	சகாய	சகாய்
chakaaya	சகாய	சகக்ய
sagaaya	சகாய	சகாய
sagaya	சகாய	சகைய
cagaayam	சகாயம்	காசையம்
cakaayam	சகாயம்	சேகாயம்
chagaayam	சகாயம்	சாகையம்
chakaayam	சகாயம்	சாகையம்
sagaayam	சகாயம்	சகாயம்
sagayam	சகாயம்	சகையம்
cakkara	சக்கர	சக்கர
chakkara	சக்கர	சக்கர
sakkara	சக்கர	சக்கர
cakkarangal	சக்கரங்கள்	சக்கரங்கள்
cakkarankal	சக்கரங்கள்	சக்கரங்கள்
chakkarangal	சக்கரங்கள்	சக்கரங்கள்
chakkarankal	சக்கரங்கள்	சக்கர்கள்
sakkarangal	சக்கரங்கள்	சக்கரங்கள்
sakkaranggal	சக்கரங்கள்	சக்கரங்கள்
chakkaraththil	சக்கரத்தில்	சக்கரத்தில்
sakkaraththil	சக்கரத்தில்	சக்கரத்தில்
cakkaram	சக்கரம்	சக்கரம்
chakkaram	சக்கரம்	சக்கரம்
sakkaram	சக்கரம்	சக்கரம்
cakkarai	சக்கரை	சக்கரை
chakkarai	சக்கரை	சக்கரை
sakkarai	சக்கரை	சக்கரை
changka	சங்க	சங்க
sanga	சங்க	சங்க
sangga	சங்க	சங்க
sangh	சங்க	ஷங்
sangha	சங்க	ஷங்க
sangka	சங்க	சங்க
sangangalin	சங்கங்களின்	சங்கங்களின்
sanggangkalin	சங்கங்களின்	சங்கங்கின்
sangkangkalin	சங்கங்களின்	சங்கங்கின்
sangangalil	சங்கங்களில்	சங்கங்களில்
sanggangkalil	சங்கங்களில்	சங்கங்களில்
sangkangkalil	சங்கங்களில்	சங்கங்களில்
cankangalum	சங்கங்களும்	சங்கங்களும்
cankankalum	சங்கங்களும்	சங்கங்களும்
chankangalum	சங்கங்களும்	சங்கங்களும்
chankankalum	சங்கங்களும்	சங்கங்களும்
sangankalum	சங்கங்களும்	சங்கங்களும்
sanggangkalum	சங்கங்களும்	சங்கங்களும்
changkaththaal	சங்கத்தால்	சங்கத்தால்
sangaththal	சங்கத்தால்	சங்கத்தல்
sanggaththaal	சங்கத்தால்	சங்கத்தால்
sangkaththaal	சங்கத்தால்	சங்கத்தால்
cankatthin	சங்கத்தின்	சங்கத்தின்
cankattin	சங்கத்தின்	சங்கத்தின்
chankattin	சங்கத்தின்	சங்கத்தின்
sangaththin	சங்கத்தின்	சங்கத்தின்
sanggaththin	சங்கத்தின்	சங்கத்தின்
sangaththilirundhdhu	சங்கத்திலிருந்து	சங்கத்திலிருந்து
sangaththilirundhu	சங்கத்திலிருந்து	சங்கத்திலிருந்து
sangaththilirunthu	சங்கத்திலிருந்து	சங்கத்திலிருந்து
sanggaththilirunthu	சங்கத்திலிருந்து	சங்க்கத்திலிருந்து
sangaththilum	சங்கத்திலும்	சங்கத்திலும்
sanggaththilum	சங்கத்திலும்	சங்கத்திலும்
sangap	சங்கப்	சங்கப்
sanggap	சங்கப்	சங்கப்
sankap	சங்கப்	சங்கப்
sangama	சங்கம	சங்கம
sanggama	சங்கம	சங்கமம
sankama	சங்கம	சங்கம
sankarin	சங்கரின்	சங்கரின்
shankarin	சங்கரின்	சங்கரின்
sanggin	சங்கின்	சங்கின்
sangin	சங்கின்	சங்கின்
sanggiliyin	சங்கிலியின்	சங்கிலியின்
sangiliyin	சங்கிலியின்	சங்கிலியின்
sangilyyin	சங்கிலியின்	சங்கிலியின்
sanggiliyil	சங்கிலியில்	சங்கிலியில்
sangiliyil	சங்கிலியில்	சங்கிலியில்
sangilyyil	சங்கிலியில்	சங்கிலியில்
sattaikku	சட்டைக்கு	சட்டைக்கு
sadhaveedha	சதவீத	சதீவத
sathaveetha	சதவீத	சத்தீவ
sadhaveedhaththai	சதவீதத்தை	சதததிதத்தை
sathaveedhaththai	சதவீதத்தை	சதத்திதத்தை
sathaveethaththai	சதவீதத்தை	சதுதவத்தைத்
santharppa	சந்தர்ப்ப	சந்தர்ப்பா
santharppaththai	சந்தர்ப்பத்தை	சந்தர்ப்பத்தை
sandhaa	சந்தா	சந்தா
santha	சந்தா	சந்த
santhaa	சந்தா	சந்தா
sandhaippaduththudhal	சந்தைப்படுத்துதல்	சந்தைப்படுத்துள்ள
sandhaippaduththuthal	சந்தைப்படுத்துதல்	சந்தைப்படுத்துள்ள
santhaippaduththuthal	சந்தைப்படுத்துதல்	சந்தைப்படுத்துடல்
sandhaippaduththum	சந்தைப்படுத்தும்	சந்தைப்படுத்தும்
santhaippaduththum	சந்தைப்படுத்தும்	சந்தைப்படுத்தும்
chaand	சந்த்	சாண்ட்
chand	சந்த்	சாண்ட்
chanda	சந்த்	சந்த
jaen	சன	ஜின்
jain	சன	ஜெய்
jan	சன	ஜான்
jann	சன	ஜான்
jayn	சன	ஜெய்
zaen	சன	ஜின்
zan	சன	ஜான்
zann	சன	ஜின்
zayn	சன	ஜெய்
san	சன்	சன்
sann	சன்	சன்
son	சன்	சோன்
sun	சன்	சுன்
sunn	சன்	சுன்
suun	சன்	சுன்
suunn	சன்	சன்
tivi	சன்	திவி
sabadham	சபதம்	சபதம்
sabatham	சபதம்	சபதம்
sabaiyinar	சபையினர்	சபையினர்
sab	சப்	சப்
sabb	சப்	சப்
sub	சப்	சுப்
subb	சப்	சப்ப்
suub	சப்	சூப்
suubb	சப்	சூப்
samagaalaththil	சமகாலத்தில்	சமகாலத்தில்
samakaalaththil	சமகாலத்தில்	சமகாலத்தில்
samacheeraana	சமச்சீரான	சமச்சீரான
samachieerana	சமச்சீரான	சமச்சீரன
samachierana	சமச்சீரான	சமச்சீரான
samamaagavae	சமமாகவே	சமமகாவே
samamagave	சமமாகவே	சமமகவே
samamakave	சமமாகவே	சமமகவே
samamaagum	சமமாகும்	சமமாகும்
samamagum	சமமாகும்	சமமமுகும்
samamakum	சமமாகும்	சமமகும்
samayaththavar	சமயத்தவர்	சமயத்தவர்
samarppiththa	சமர்ப்பித்த	சமர்ப்பித்த
samavaaippu	சமவாய்ப்பு	சமாவப்பு
samavaayppu	சமவாய்ப்பு	சமாவப்பு
samavaippu	சமவாய்ப்பு	சமமைப்பு
sameera	சமீரா	சமீரா
samsaara	சம்சார	சம்சா
sumsaara	சம்சார	சும்பார
sambirathaayathil	சம்பிரதாயத்தில்	சம்ப்பிரதாயத்தில
sambradhaayathil	சம்பிரதாயத்தில்	சம்ப்பதராயத்
sambrathaayathil	சம்பிரதாயத்தில்	சம்ப்பதராயத்
sampirathaayatthil	சம்பிரதாயத்தில்	சம்ப்பிரதாதத்தில
sampirathayathil	சம்பிரதாயத்தில்	சம்பிரத்தியல்
sampirathayaththil	சம்பிரதாயத்தில்	சம்பிராத்ததில்
sambiradhayathai	சம்பிரதாயத்தை	சம்பிரதததை
sambradhayathai	சம்பிரதாயத்தை	சம்ப்ரததாய
sambrathayaththai	சம்பிரதாயத்தை	சம்ப்பதரதத்தை
sampiradhayathai	சம்பிரதாயத்தை	சம்பிராததைய
sampirathaayatthai	சம்பிரதாயத்தை	சம்ப்பிரதாதத்தை
sampirathayaththai	சம்பிரதாயத்தை	சம்பிராத்தையத
sambandhappatta	சம்மந்தப்பட்ட	சம்பந்தப்பட்ட
sammanthappatta	சம்மந்தப்பட்ட	சம்மந்தப்பட்ட
sammandhdhamaana	சம்மந்தமான	சம்ம்நமமான
sammanthamaana	சம்மந்தமான	சம்ம்மநாதன
cargo	சரக்கு	கரர்கோ
kargo	சரக்கு	கர்கோ
kargoo	சரக்கு	கர்கோ
kargou	சரக்கு	கர்கோ
kargouu	சரக்கு	கர்கோ
kargu	சரக்கு	கர்கு
karrgo	சரக்கு	கற்கோ
qargoo	சரக்கு	கர்கோ
qargou	சரக்கு	கர்கோ
qarrgo	சரக்கு	கற்க்கோ
sarakku	சரக்கு	சரக்கு
sarakkukalai	சரக்குகளை	சரக்குகளை
sarasu	சரசு	சரசு
saranadainthanar	சரணடைந்தனர்	சரனட்டனந்தனர்
saranadaiyach	சரணடையச்	சரரணாயைச்
soorai	சர்ரே	சூரை
sooray	சர்ரே	சூரை
soorey	சர்ரே	சூர்ய்
soorreey	சர்ரே	சூர்ரே
soorrei	சர்ரே	சூர்ரை
soorrey	சர்ரே	சூர்ரே
suray	சர்ரே	சுரே
surey	சர்ரே	சுரே
surrai	சர்ரே	சுற்றை
surray	சர்ரே	சுர்ரே
surreey	சர்ரே	சுர்ரே
surrei	சர்ரே	சுர்ரே
surrey	சர்ரே	சுர்ரே
suurray	சர்ரே	சுர்ரே
suurrey	சர்ரே	சுர்ரே
sarvaadhigaara	சர்வாதிகார	சர்வாதிகார
sarvaathikaara	சர்வாதிகார	சர்வாதிகார
sarvaadhigaaraththai	சர்வாதிகாரத்தை	சர்வாதிகாதத்தை
sarvaathikaaraththai	சர்வாதிகாரத்தை	சர்வாத்தாகத்தை
sarvaathikaaratthai	சர்வாதிகாரத்தை	சர்வாத்திகாாதை
sarvaadhigaaram	சர்வாதிகாரம்	சர்வததாகிறம்
sarvaathikaaram	சர்வாதிகாரம்	சர்வாதிகாரம்
sarvaadigaari	சர்வாதிகாரி	சர்வாதாகிறி
sarvaathikaari	சர்வாதிகாரி	சர்வாதிகாரி
satru	சற்று	சற்று
sattru	சற்று	சற்று
saakkadai	சாக்கடை	சாக்கடை
sakkadai	சாக்கடை	சக்கடை
saakkadaigal	சாக்கடைகள்	சாக்கடைகள்
sakkadaikal	சாக்கடைகள்	சக்கடைகள்
saakkiya	சாக்கிய	சாக்கிய
sakkiya	சாக்கிய	சக்கிய
saasanam	சாசனம்	சாசனம்
sasanam	சாசனம்	சானன்
saattai	சாட்டை	சாட்டை
saattay	சாட்டை	சாட்டை
sattai	சாட்டை	சட்டை
saadhagamaaga	சாதகமாக	சாதகமாக
saathakamaaka	சாதகமாக	சாதகமாக
sathakamaka	சாதகமாக	சாதகமக
saathanangal	சாதனங்கள்	சாதனங்கள்
saathanangkal	சாதனங்கள்	சாதனங்கள்
saadhaarana	சாதாரண	சாதாரான
saathaarana	சாதாரண	சாதாரான
saadhaaranamaaga	சாதாரணமாக	சாதாரணமாக
saathaaranamaaga	சாதாரணமாக	சாதாராணமாக
saathaaranamaaka	சாதாரணமாக	சாதாராமணாக
saadhaaranamaanathu	சாதாரணமானது	சாதாரணமானது
saathaaranamaanathu	சாதாரணமானது	சாதாராணமானது
saaththiyamaaga	சாத்தியமாக	சாத்தியமாக
saaththiyamaaka	சாத்தியமாக	சாத்தியமாக
saaththiyamaagum	சாத்தியமாகும்	சாத்தியமாகும்
saaththiyamaakum	சாத்தியமாகும்	சாத்தியமாகும்
saayam	சாயம்	சாயம்
saaradhi	சாரதி	சாரதி
saarathi	சாரதி	சாரதி
saarathy	சாரதி	சாரத்தி
sarathi	சாரதி	சராத்தி
caarnthoo	சார்ந்தோ	சார்ந்தோ
chaarntho	சார்ந்தோ	சார்ந்தோ
saarndhoa	சார்ந்தோ	சார்ந்தோ
saarnthoo	சார்ந்தோ	சார்ந்தோ
caarpatta	சார்பற்ற	சார்ப்ட
chaarpatta	சார்பற்ற	சார்ப்டட்ட
saarpatta	சார்பற்ற	சார்ப்ட
saarpattra	சார்பற்ற	சார்ப்ற
saarpattrra	சார்பற்ற	சாற்றப்பற்ற
chaalukkiya	சாளுக்கிய	சாலுக்கிய
chalukya	சாளுக்கிய	சலல்கிய
saalukkiya	சாளுக்கிய	சாலுக்கிய
salukkiya	சாளுக்கிய	சலுக்கிய
java	சாவா	சாவா
saava	சாவா	சாவா
saavaa	சாவா	சாவா
saavilirundhu	சாவிலிருந்து	சாவிலிருந்து
saavilirunthu	சாவிலிருந்து	சாவிலிருந்து
saashthaa	சாஸ்தா	சாஸ்தா
saasthaa	சாஸ்தா	சாஸ்தா
sastha	சாஸ்தா	சாஸ்தா
saashthiriyin	சாஸ்திரியின்	சாஸ்திரியின்
saasthiriyin	சாஸ்திரியின்	சாஸ்திரியின்
sastriyin	சாஸ்திரியின்	சாஸ்டிரியின்
shastriyin	சாஸ்திரியின்	சாஸ்டிரியின்
chikkanam	சிக்கனம்	சிக்கன்ம்
sikanam	சிக்கனம்	சிக்கம்
sikkanam	சிக்கனம்	சிக்கன்ம்
caitric	சிட்ரிக்	கிற்றிச்
cetric	சிட்ரிக்	கிற்றிக்
citric	சிட்ரிக்	சிற்றிக்
citrick	சிட்ரிக்	சிற்றிக்
citricq	சிட்ரிக்	சிற்றிக்கி
citrik	சிட்ரிக்	சிற்றிக்
citriq	சிட்ரிக்	சிற்றிக்
shidhi	சிதி	சிதி
sidhi	சிதி	சிதி
sidi	சிதி	சிடி
siidhii	சிதி	சிதி
siidii	சிதி	சிடி
sydhi	சிதி	சிதி
sydhii	சிதி	சிதி
chithiraith	சித்திரைத்	சிறித்தை
sithiraith	சித்திரைத்	சிறித்தை
siththiraith	சித்திரைத்	சித்திரைத்
sitthiraith	சித்திரைத்	சிற்றிதைத்
chithiraiyil	சித்திரையில்	சித்திரையில்
sithiraiyil	சித்திரையில்	சித்திரையில்
siththiraiyil	சித்திரையில்	சித்திரையில்
sitthiraiyil	சித்திரையில்	சித்திரையில்
chintha	சிந்தா	சிந்த
chinthaa	சிந்தா	சிந்தா
sindhaa	சிந்தா	சிந்தா
sintha	சிந்தா	சிந்த
sinthaa	சிந்தா	சிந்தா
chinthitthu	சிந்தித்து	சிந்தித்து
sinthiththu	சிந்தித்து	சிந்தித்து
sinthithu	சிந்தித்து	சிந்தித்து
sinthitthu	சிந்தித்து	சிந்தித்து
sindhu	சிந்து	சிந்து
sinthu	சிந்து	சிந்து
sindhum	சிந்தும்	சிந்தும்
sindhuvin	சிந்துவின்	சிந்துவின்
cbse	சிபிஎஸ்இ	பிஸ்
seempson	சிம்ப்சன்	சிம்போன்ஸ்
siimpson	சிம்ப்சன்	சிம்போன்
simpsan	சிம்ப்சன்	சிம்பிசன்
simpson	சிம்ப்சன்	சிம்போன்
simpsonn	சிம்ப்சன்	சிம்போன்
sympson	சிம்ப்சன்	சிம்பான்
shimma	சிம்ம	சிம்மா
simma	சிம்ம	சிம்மா
chiyol	சியோல்	சியோல்
chiyool	சியோல்	சியோல்
seooul	சியோல்	சோயோல்
seoul	சியோல்	சியோல்
seouul	சியோல்	சியூல்
siyoal	சியோல்	சியோல்
siyool	சியோல்	சியோல்
sirikka	சிரிக்க	சிறிக்க
siria	சிரிய	சிறியா
siriya	சிரிய	சிறியா
syria	சிரிய	சிரியா
siridhalavum	சிறிதளவும்	சிறித்தாவும்
sirithalavum	சிறிதளவும்	சிறித்தவாலும்
koodam	சிறைக்	கோடம்
kutam	சிறைக்	குடம்
siraik	சிறைக்	சிறைக்
siraikh	சிறைக்	சிறைக்
sivanadhu	சிவனது	சிவனது
sivanathu	சிவனது	சிவனது
sivanaal	சிவனால்	சிவானல்
sivanal	சிவனால்	சிவனல்
sivapragasham	சிவப்பிரகாசம்	சிவப்ரகராம்
sivaprakasam	சிவப்பிரகாசம்	சிவப்ரகரசம்
sivasivappiragasam	சிவப்பிரகாசம்	சிவவிசப்பிரமாக
sivappirakaashar	சிவப்பிரகாசர்	சிவப்பிரக்சாரர
sivappirakasar	சிவப்பிரகாசர்	சிவப்பிரக்சிகர
sivaprakasar	சிவப்பிரகாசர்	சிவப்பரரகர்ச்
sivaprakashar	சிவப்பிரகாசர்	சிவப்பரரகஷ்
cevil	சிவில்	செவில்
cewil	சிவில்	சிவில்
civiil	சிவில்	சிவில்
civil	சிவில்	சிவில்
ciwiil	சிவில்	சிவில்
ciwil	சிவில்	சிவில்
sivil	சிவில்	சிவில்
siwil	சிவில்	சிவில்
season	சீசன்	சேசன்
sesan	சீசன்	சேசன்
seson	சீசன்	செசன்
siijan	சீசன்	சீஜான்
siizan	சீசன்	சீசன்
sijan	சீசன்	சிஜான்
sizan	சீசன்	சிசன்
caesarin	சீசரின்	சீசரின்
cesarin	சீசரின்	சீசரின்
seesarin	சீசரின்	சீசரின்
caesar	சீசர்	சேசர்
cesar	சீசர்	சேசர்
ciisar	சீசர்	சிசார்
cisar	சீசர்	சிசார்
seesar	சீசர்	சீசர்
siijor	சீசர்	சிஜோர்
sijor	சீசர்	சிஜோர்
sizor	சீசர்	சிசோர்
seenivasan	சீனிவாசன்	சீனிவானன்
srinivasan	சீனிவாசன்	ஸ்ரீனிவாசன்
seeriya	சீரிய	சீரிய
sarial	சீரியல்	சரியல்
serial	சீரியல்	சேரியல்
seriial	சீரியல்	சீரியல்
chiirutaikalai	சீருடைகளை	சீருட்டைகளை
chirutaikalai	சீருடைகளை	சிறுத்தைகளை
seerudaigalai	சீருடைகளை	சீருடைகளை
seerudaikalai	சீருடைகளை	சீருடைகளை
serutaikalai	சீருடைகளை	செறுடைகளை
siirutaikalai	சீருடைகளை	சிறுடையுகளை
seeri	சீறி	சீரி
sugandhan	சுகந்தன்	சுகந்தன்
suganthan	சுகந்தன்	சுகந்தன்
sukanthan	சுகந்தன்	சுகந்தன்
chukumaaran	சுகுமாரன்	சுகுமாரன்
sugumaaran	சுகுமாரன்	சுகுமாரன்
sugumaran	சுகுமாரன்	சுகுமாரன்
sukumaaran	சுகுமாரன்	சுகுமாருன்
sukumaran	சுகுமாரன்	சுகுமாரன்
chuththa	சுத்த	சுத்த
chuttha	சுத்த	சுத்த
suththa	சுத்த	சுத்த
suttha	சுத்த	சுத்த
chuththap	சுத்தப்	சுத்தப்
chutthap	சுத்தப்	சுத்தப்
suththap	சுத்தப்	சுத்தப்
sutthap	சுத்தப்	சுத்தப்
chuttham	சுத்தம்	சுத்தம்
sutham	சுத்தம்	சுதம்
suththam	சுத்தம்	சுத்தம்
suttham	சுத்தம்	சுத்தம்
sudhthikarikkappatta	சுத்திகரிக்கப்பட்ட	சுத்திரக்கப்பட்ட
suththikarikkappatta	சுத்திகரிக்கப்பட்ட	சுத்திரக்கப்பட்ட
suththikarippu	சுத்திகரிப்பு	சுத்திரப்பிடு
chunithaa	சுனிதா	சுனித்தா
sunita	சுனிதா	சுனிட்ட
sunitha	சுனிதா	சுனித்த
sunithaa	சுனிதா	சுனித்தா
suunita	சுனிதா	சுனிட்ட
chuyeecchai	சுயேச்சை	சுயிசைச்
suyaechchai	சுயேச்சை	சுயைச்சை
suyechai	சுயேச்சை	சுயைசை
suyechchai	சுயேச்சை	சுயிச்சை
suyeecchai	சுயேச்சை	சுயிசைச்
shruthi	சுருதி	ஸ்ருதி
surudhi	சுருதி	சுருதி
suruthi	சுருதி	சுருத்தி
surusuruppaaga	சுறுசுறுப்பாக	சுறுசுறுப்பாக
surrullaath	சுற்றுலாத்	சுற்றுளால்
sutrullaath	சுற்றுலாத்	சுற்றுளால்
suttrulaath	சுற்றுலாத்	சுற்றுளாத்
surrulaavin	சுற்றுலாவின்	சுற்றுவாலின்
sutrulaavin	சுற்றுலாவின்	சுற்றுவாலின்
suttrulaavin	சுற்றுலாவின்	சுற்றுவாலின்
surrulaavai	சுற்றுலாவை	சுற்றுளாவை
sutrulaavai	சுற்றுலாவை	சுற்றுளாவை
suttrulaavai	சுற்றுலாவை	சுற்றுளாவை
sulalil	சுழலில்	சுலலில்
suzhalil	சுழலில்	சுழலில்
suvaasikkath	சுவாசிக்கத்	சுவாசிக்தத்
suvachikkath	சுவாசிக்கத்	சுவசிக்கத்
suvasikkath	சுவாசிக்கத்	சுவசிக்கத்
chootti	சூட்டி	சூட்டி
chutti	சூட்டி	சுட்டி
shootti	சூட்டி	சூட்டி
sootti	சூட்டி	சூட்டி
choottinaar	சூட்டினார்	சூட்டினார்
chuttinaar	சூட்டினார்	சுட்டினார்
shoottinaar	சூட்டினார்	சூட்டினார்
soottinaar	சூட்டினார்	சூட்டினார்
choottinai	சூட்டினை	சூட்டினை
chuttinai	சூட்டினை	சுட்டினை
shootinai	சூட்டினை	சூட்டினை
soottinai	சூட்டினை	சூட்டினை
suittinai	சூட்டினை	சுட்டினை
choottil	சூட்டில்	சூட்டில்
soottil	சூட்டில்	சூட்டில்
suittil	சூட்டில்	சுட்டில்
choothaatta	சூதாட்ட	சூதாட்ட
soodhaatta	சூதாட்ட	சூதாட்ட
soothaatta	சூதாட்ட	சூதாட்ட
choothaattathil	சூதாட்டத்தில்	சூதாத்தத்தில்
soodhattaththil	சூதாட்டத்தில்	சூடத்தத்தில்
soothaattaththil	சூதாட்டத்தில்	சூதாத்தத்தில்
sooyas	சூயஸ்	சோயாஸ்
suez	சூயஸ்	சூச்
suyas	சூயஸ்	சுயாஸ்
sooraavali	சூறாவளி	சூராவலி
sooravazhi	சூறாவளி	சூறவாளி
sooraavaliyaaga	சூறாவளியாக	சூராவலியாக
sooraavaliyaaka	சூறாவளியாக	சூராவலாயக
sooravazhiyaga	சூறாவளியாக	சூறவாளிய
soolappatta	சூழப்பட்ட	சூழல்பட்ட
soozhappatta	சூழப்பட்ட	சூழப்பட்ட
soolappattu	சூழப்பட்டு	சூழப்பட்டு
soozhappattu	சூழப்பட்டு	சூழப்பட்டு
chengkam	செங்கம்	செங்கம்
sengam	செங்கம்	செங்கம்
sengkam	செங்கம்	சேங்கம்
senkam	செங்கம்	செங்கம்
seyarpaadugalinaal	செயற்பாடுகளினால்	செயற்பாடுகளிலால்
seyarpaadugal	செயற்பாடுகள்	செயற்பாடுகள்
seyarpadugal	செயற்பாடுகள்	செயற்படுகள்
seyarpaadum	செயற்பாடும்	செயற்பாடும்
seyarpadum	செயற்பாடும்	செயற்படும்
seyalaatri	செயலாற்றி	செயலாற்றி
seyalaattri	செயலாற்றி	செயலாற்றி
seyalattri	செயலாற்றி	செயலற்றி
seyalaatrum	செயலாற்றும்	செயலாற்றும்
seyalaattrum	செயலாற்றும்	செயலாற்றும்
seyalattrum	செயலாற்றும்	செயலற்றும்
seyalaatruvathu	செயலாற்றுவது	செயல்பாறுவது
seyalaattruvathu	செயலாற்றுவது	செயல்டாுவது
seyalattruvadhu	செயலாற்றுவது	செயல்டுுவது
seyalattruvathu	செயலாற்றுவது	செயல்டுுவது
seyalilakka	செயலிழக்க	செயலிகள்க
seyalizhakka	செயலிழக்க	செயலிலக்க
seyalukku	செயலுக்கு	செயலுக்கு
seyalum	செயலும்	செயலும்
seyalpada	செயல்பட	செயல்பட
seyalpadakkoodiya	செயல்படக்கூடிய	செயல்படக்கூடிய
seyalpadakkudiya	செயல்படக்கூடிய	செயல்படடுகிய
seyalpadath	செயல்படத்	செயல்படத்
seyalpadavillai	செயல்படவில்லை	செயல்படவில்லை
seyalpadavum	செயல்படவும்	செயல்படுும்
seyalpaduvum	செயல்படவும்	செயல்படுும்
seyalpadaamal	செயல்படாமல்	செயல்பாடலாம்
seyalpadamal	செயல்படாமல்	செயல்படமல்
cheyalpaduvatharku	செயல்படுவதற்கு	செயல்படுவதற்கு
cheyalpatuvatharku	செயல்படுவதற்கு	செயல்படுவதற்கு
seyalpaduvadharku	செயல்படுவதற்கு	செயல்படுவதற்கு
seyalpaduvatharku	செயல்படுவதற்கு	செயல்படுவதற்கு
seyalpatuvatharku	செயல்படுவதற்கு	செயல்படுவதற்கு
cheyalmurai	செயல்முறை	செய்லுமை
seyalmurai	செயல்முறை	செயல்முறை
seidhadhan	செய்ததன்	செய்ததனத்
seithathan	செய்ததன்	செய்ததான்
cheythavan	செய்தவன்	செய்தவன்
seidhavan	செய்தவன்	செய்தவன்
seithavan	செய்தவன்	செய்தவன்
seythavan	செய்தவன்	செய்தவன்
seidhulladhu	செய்துள்ளது	செய்துள்ளது
seithullathu	செய்துள்ளது	செய்துள்ளது
seidhullaar	செய்துள்ளார்	செய்துள்ளார்
seithullaar	செய்துள்ளார்	செய்துள்ளார்
seibavargalin	செய்பவர்களின்	செய்பவர்களின்
seibavarkalin	செய்பவர்களின்	செய்பவர்களின்
seibavargalukku	செய்பவர்களுக்கு	செய்பவர்களுக்கு
seibavarkalukku	செய்பவர்களுக்கு	செய்பவர்களுக்கு
seibavargalai	செய்பவர்களை	செய்பவர்களை
seibavarkalai	செய்பவர்களை	செய்பவர்களை
seiyappattathaal	செய்யப்பட்டதால்	செய்யப்பட்டதால்
seiyyappattadhaal	செய்யப்பட்டதால்	செய்யப்பட்டதால்
seiyyappattathaal	செய்யப்பட்டதால்	செய்யப்பட்டதால்
seiyappattathai	செய்யப்பட்டதை	செய்யப்பட்டதை
seiyyappattadhai	செய்யப்பட்டதை	செய்யப்பட்டதை
seiyyappattathai	செய்யப்பட்டதை	செய்யப்பட்டதை
seiyappattana	செய்யப்பட்டன	செய்யப்பட்டன
seiyyappattana	செய்யப்பட்டன	செய்யப்பட்டன
seiyappattavar	செய்யப்பட்டவர்	செய்யப்பட்டவர்
seiyyappattavar	செய்யப்பட்டவர்	செய்யப்பட்டவர்
seiyappattaal	செய்யப்பட்டால்	செய்யப்பட்டால்
seiyappattal	செய்யப்பட்டால்	செய்யப்பட்டல்
seyyappattal	செய்யப்பட்டால்	செய்யப்பட்டல்
seiyappattirukkum	செய்யப்பட்டிருக்கும்	செய்யப்பட்டிருக்கும்
seyyappattirukkum	செய்யப்பட்டிருக்கும்	செய்யப்பட்டிருக்கும்
seiyappattum	செய்யப்பட்டும்	செய்யப்பட்டும்
seyyappattum	செய்யப்பட்டும்	செய்யப்பட்டும்
seiyappattulla	செய்யப்பட்டுள்ள	செய்யப்பட்டுள்ள
seyyappattulla	செய்யப்பட்டுள்ள	செய்யப்பட்டுள்ள
seiyappattulladhu	செய்யப்பட்டுள்ளது	செய்யப்பட்டுள்ளது
seiyappattullathu	செய்யப்பட்டுள்ளது	செய்யப்பட்டுள்ளது
seyyappattullathu	செய்யப்பட்டுள்ளது	செய்யப்பட்டுள்ளது
seiyulil	செய்யுளில்	செய்யுலில்
seyyulil	செய்யுளில்	செய்யில்ல்
cherbiya	செர்பிய	செர்பியா
serbia	செர்பிய	செர்பியா
serbiya	செர்பிய	செர்பியா
chelavita	செலவிட	செலவிட
selavida	செலவிட	செலவிட
selavita	செலவிட	செலவிட
chelavitapadum	செலவிடப்படும்	செலவிடபடபடும்
chelavitappadum	செலவிடப்படும்	செலவிடப்படும்
selavidappadum	செலவிடப்படும்	செலவிடப்படும்
selavitappatum	செலவிடப்படும்	செலவிடப்படும்
cheluthi	செலுத்தி	செலுத்தி
chelutthi	செலுத்தி	செலுத்தி
seluthi	செலுத்தி	செலுத்தி
seluththi	செலுத்தி	செலுத்தி
selutthi	செலுத்தி	செலுத்தி
cheluthik	செலுத்திக்	செலுத்திக்
chelutthik	செலுத்திக்	செலுத்திக்
seluthik	செலுத்திக்	செலுத்திக்
seluththik	செலுத்திக்	செலுத்திக்
selutthik	செலுத்திக்	செலுத்திக்
cheluthina	செலுத்தின	செலுத்தின
chelutthina	செலுத்தின	செலுத்தின
seluthina	செலுத்தின	செலுத்தின
seluththina	செலுத்தின	செலுத்தின
selutthina	செலுத்தின	செலுத்தின
cheluthinar	செலுத்தினார்	செலுத்தினர்
chelutthinaar	செலுத்தினார்	செலுத்தினார்
seluthinaar	செலுத்தினார்	செலுத்தினார்
seluththinaar	செலுத்தினார்	செலுத்தினார்
selutthinaar	செலுத்தினார்	செலுத்தினார்
segarippil	சேகரிப்பில்	சேகரிப்பில்
sekarippil	சேகரிப்பில்	சேகர்பிப்பில்
chaethamadainththu	சேதமடைந்து	சேதமைந்தது
saethamadainththu	சேதமடைந்து	சேதம்டைந்து
sedhamadaindhu	சேதமடைந்து	சேதமடைந்து
sethamadaindhu	சேதமடைந்து	சேதமடைந்து
saeiyon	சேயோன்	செய்யன்
saeyaon	சேயோன்	சேயான்
saeyon	சேயோன்	செயோன்
seiyon	சேயோன்	செய்யன்
seyon	சேயோன்	செயோன்
cheri	சேரி	செர்ரி
saeri	சேரி	சேரி
saerkkaikkaana	சேர்க்கைக்கான	சேர்க்கைக்கான
serkkaikkaana	சேர்க்கைக்கான	சேர்க்கைக்கான
saerkkaikku	சேர்க்கைக்கு	சேர்க்கைக்கு
serkkaikku	சேர்க்கைக்கு	சேர்க்கைக்கு
saerkkaiyil	சேர்க்கையில்	சேர்க்கையில்
serkkaiil	சேர்க்கையில்	சேர்க்கையில்
serkkaiyil	சேர்க்கையில்	சேர்க்கையில்
saerkkaiyum	சேர்க்கையும்	சேர்க்கையும்
serkkaium	சேர்க்கையும்	சேர்க்கையும்
serkkaiyum	சேர்க்கையும்	சேர்க்கையும்
saerththu	சேர்த்து	சேர்த்து
serththu	சேர்த்து	சேர்த்து
saerththuk	சேர்த்துக்	சேர்த்துக்
serththuk	சேர்த்துக்	சேர்த்துக்
saerththukkondaar	சேர்த்துக்கொண்டார்	சேர்த்துக்கொண்டார்
serththukkondaar	சேர்த்துக்கொண்டார்	சேர்த்துக்கொண்டார்
saerththukkolvathan	சேர்த்துக்கொள்வதன்	சேர்த்துக்கொள்வனா்
serththukkolvathan	சேர்த்துக்கொள்வதன்	சேர்த்துக்கொவில்்
saerththuth	சேர்த்துத்	சேர்த்துத்
serththuth	சேர்த்துத்	சேர்த்துத்
saerththup	சேர்த்துப்	சேர்த்துப்
serththup	சேர்த்துப்	சேர்த்துப்
chervai	சேர்வை	செர்வை
saervai	சேர்வை	சேர்வை
servai	சேர்வை	சேர்வை
saigaigalai	சைகைகளை	சைகைகளை
saigaikalai	சைகைகளை	சைகைகளை
saikaigalai	சைகைகளை	சைக்கைகளை
saikaikalai	சைகைகளை	சைக்கைகளை
cibar	சைபர்	சிபீர்
cibarr	சைபர்	சிப்பர்
ciber	சைபர்	சிப்பர்
ciberr	சைபர்	சிப்பர்
cipher	சைபர்	சைப்பர்
cybar	சைபர்	சிபார்
cyber	சைபர்	சைபர்
cyfer	சைபர்	சைப்பர்
cyphar	சைபர்	சிப்பர்
cypher	சைபர்	சைபர்
saibar	சைபர்	சைப்பர்
sibar	சைபர்	சிபார்
siber	சைபர்	சிபீர்
syber	சைபர்	சைப்பர்
saivaththin	சைவத்தின்	சைவத்தின்
saivar	சைவர்	சைவர்
sombu	சொம்பு	சோம்பு
sompu	சொம்பு	சோம்பு
chori	சொறி	கோரி
sori	சொறி	சோரி
chorpolivu	சொற்பொழிவு	சொற்பொழிவு
sorpolivu	சொற்பொழிவு	சொற்பொளிவு
sorpozhivu	சொற்பொழிவு	சொற்பொழிவு
chorpolivukalai	சொற்பொழிவுகளை	சொற்பொழிவிளைகள
sorpolivugalai	சொற்பொழிவுகளை	சொற்பொழிவிளையா
sorpolivukalai	சொற்பொழிவுகளை	சொற்பொழிவிளையா
sorpolzhivugalai	சொற்பொழிவுகளை	சொற்பொழில்வுளை
chorpolivukal	சொற்பொழிவுகள்	சொற்பொழிவுள்ள
sorpolivugal	சொற்பொழிவுகள்	சொற்பொழிவுள்ள
sorpolivukal	சொற்பொழிவுகள்	சொற்பொழிவுள்ள
sorpozhivugal	சொற்பொழிவுகள்	சொற்பொழிவாளுக்
cholana	சொல்லான	சொலனன
chollaana	சொல்லான	சொல்லான
sollaana	சொல்லான	சொல்லான
chollu	சொல்லு	சொல்லு
sollu	சொல்லு	சொல்லு
chollukkup	சொல்லுக்குப்	சொல்லுக்குப்
cholukup	சொல்லுக்குப்	சொலுக்குப்
sollukkup	சொல்லுக்குப்	சொல்லுக்குப்
solluvar	சொல்லுவர்	சொல்லவர்
cholvar	சொல்வர்	சொல்வர்
solvar	சொல்வர்	சொல்வர்
cholvaar	சொல்வார்	சொல்வார்
cholvar	சொல்வார்	சொல்வர்
solvaar	சொல்வார்	சொல்வார்
solvar	சொல்வார்	சொல்வர்
soasalisap	சோசலிசப்	சோசலிசவ்
socialisap	சோசலிசப்	சொசிசாலியப்
sosalisap	சோசலிசப்	சோசலிசவ்
shocialishm	சோசலிசம்	சோசிலியம்
soasalisam	சோசலிசம்	சோசலிமம்
socialeesm	சோசலிசம்	சொசைலியம்
socialiism	சோசலிசம்	சோசியாலிம்
socialism	சோசலிசம்	சொசிலாயில்
soocialeesm	சோசலிசம்	சூசியலலிம்
soocialism	சோசலிசம்	சூசியாலிம்
sosalisam	சோசலிசம்	சசசலலிம்
soadi	சோடி	சோடி
sodi	சோடி	சோடி
choathikka	சோதிக்க	சோதிக்க
soathikka	சோதிக்க	சோதிக்க
sothikka	சோதிக்க	சொதிக்க
chooppup	சோப்புப்	சோப்புப்
soappup	சோப்புப்	சோப்புப்
sooppup	சோப்புப்	சூப்புப்
soppup	சோப்புப்	சோப்புப்
sopup	சோப்புப்	சோப்பு
choayaa	சோயா	சோயா
soayaa	சோயா	சோயா
soi	சோயா	சோய்
soia	சோயா	சோய்
sooy	சோயா	சோய்
sooya	சோயா	சோயா
soy	சோயா	சாய்
soya	சோயா	சோயா
soyaa	சோயா	சோயா
choazharkalaal	சோழர்களால்	சோழர்களால்
cholargalal	சோழர்களால்	சொற்றல்கள்
chozharkalaal	சோழர்களால்	சொழற்களால்
soazhargalaal	சோழர்களால்	சோழர்களால்
soazharkalaal	சோழர்களால்	சோழர்களால்
solargalal	சோழர்களால்	சொறல்களால்
sozharkalaal	சோழர்களால்	சொழற்களால்
choazharkalai	சோழர்களை	சோழர்களை
cholargalai	சோழர்களை	சொற்றலைகளை
chozhargalai	சோழர்களை	சொழற்களை
soazhargalai	சோழர்களை	சோழர்களை
soazharkalai	சோழர்களை	சோழர்களை
sozharkalai	சோழர்களை	சொழற்களை
jajeera	ஜசீரா	ஜேஜீரா
jazeara	ஜசீரா	ஜெசர்ரா
jazeera	ஜசீரா	ஜேசீரா
jaziira	ஜசீரா	ஜெரீரா
zazeera	ஜசீரா	ஜேசீர
janadha	ஜனதா	சனந்த
janadhaa	ஜனதா	சனந்தா
janata	ஜனதா	ஜனட்டா
janataa	ஜனதா	ஜனட்டா
janatha	ஜனதா	சனந்த
janeta	ஜனதா	ஜென்ட்டா
janetaa	ஜனதா	ஜெனிடா
janta	ஜனதா	ஜெண்டா
zanata	ஜனதா	ஜனட்ட
zanataa	ஜனதா	ஜனடாடா
japaniya	ஜப்பானிய	ஜபானிய
jappaaniya	ஜப்பானிய	ஜாப்பானிய
japaniyak	ஜப்பானியக்	ஜபானியம்
jappaaniyak	ஜப்பானியக்	ஜாப்பானியக்
japaniyarkal	ஜப்பானியர்கள்	ஜபப்ணியல்கர்
jappaaniyargal	ஜப்பானியர்கள்	ஜெப்பானியர்கள்
jappaaniyarkal	ஜப்பானியர்கள்	ஜெப்பானியர்கள்
japanukku	ஜப்பானுக்கு	ஜபபனுக்கு
jappaanukku	ஜப்பானுக்கு	ஜெப்பானுக்கு
jameen	ஜமீன்	ஜமமீன்
jamuna	ஜமுனா	ஜமமுனா
jamunaa	ஜமுனா	ஜமுனா
jamp	ஜம்ப்	ஜம்ப்
jump	ஜம்ப்	ஜம்ப்
juump	ஜம்ப்	ஜம்ப்
zump	ஜம்ப்	ஜம்ப்
jaansan	ஜான்சன்	ஜான்சன்
jaanson	ஜான்சன்	ஜான்சன்
jhonsan	ஜான்சன்	ஜான்சன்
jhonson	ஜான்சன்	ஜான்சன்
johnson	ஜான்சன்	ஜான்சன்
jecas	ஜீசஸ்	ஜேக்ஸ்
jesus	ஜீசஸ்	ஜேஸ்
jesuus	ஜீசஸ்	ஜேசஸ்
jiicas	ஜீசஸ்	ஜேக்ஸ்
zesus	ஜீசஸ்	ஜேஸ்
jeeroa	ஜீரோ	ஜீரோ
zeero	ஜீரோ	ஜீரோ
zero	ஜீரோ	ஜெரோ
jeevan	ஜீவன்	ஜீவன்
joori	ஜூரி	ஜூரி
joory	ஜூரி	ஜூரி
juri	ஜூரி	ஜூரி
jurii	ஜூரி	ஜூரி
jury	ஜூரி	ஜூரி
juuri	ஜூரி	ஜூரி
juury	ஜூரி	ஜூரி
zoory	ஜூரி	ஜூரி
zuri	ஜூரி	ஜூரி
zury	ஜூரி	ஜூரி
jaenna	ஜென்னா	ஜென்னா
jeina	ஜென்னா	ஜெய்னா
jena	ஜென்னா	ஜெனா
jenaa	ஜென்னா	ஜெனா
jenna	ஜென்னா	ஜென்
jennaa	ஜென்னா	ஜென்னா
jeyna	ஜென்னா	ஜெய்னா
zena	ஜென்னா	ஜெனா
zenna	ஜென்னா	ஜென்னா
zennaa	ஜென்னா	ஜென்னா
zeyna	ஜென்னா	ஜெய்னா
jaenni	ஜென்னி	ஜென்னி
jannine	ஜென்னி	ஜனினி
jeanie	ஜென்னி	ஜெனி
jeannie	ஜென்னி	ஜெய்னி
jenni	ஜென்னி	ஜெனி
jennie	ஜென்னி	ஜெனி
jennii	ஜென்னி	ஜென்னி
jenny	ஜென்னி	ஜெனி
jianine	ஜென்னி	ஜியானி
jiannine	ஜென்னி	ஜியினின்
jyanine	ஜென்னி	ஜெய்னி
jyannine	ஜென்னி	ஜெய்னின்
zeannie	ஜென்னி	ஜிய்னி
zenni	ஜென்னி	ஜெனி
zenny	ஜென்னி	ஜெனி
ziannine	ஜென்னி	ஜியினின்
zyannine	ஜென்னி	ஜெய்னின்
jaens	ஜென்ஸ்	ஜென்ஸ்
jains	ஜென்ஸ்	ஜெய்ஸ்
jens	ஜென்ஸ்	ஜென்ஸ்
zains	ஜென்ஸ்	ஜெய்ஸ்
zens	ஜென்ஸ்	ஜென்ஸ்
jebam	ஜெபம்	ஜெபம்
jepam	ஜெபம்	ஜெபம்
jefersaun	ஜெபர்சன்	ஜெபர்சன்
jeferson	ஜெபர்சன்	ஜெபர்சன்
jeffarsaun	ஜெபர்சன்	ஜெப்பரஸ்
jeffarson	ஜெபர்சன்	ஜெப்பர்சன்
jeffersaun	ஜெபர்சன்	ஜெப்பர்சன்
jeffersauun	ஜெபர்சன்	ஜெப்பரரன்
jefferson	ஜெபர்சன்	ஜெப்பர்சன்
jefpharson	ஜெபர்சன்	ஜெப்பரசன்
jefpherson	ஜெபர்சன்	ஜெப்பர்சன்
jephpharson	ஜெபர்சன்	ஜெப்பர்சன்
jephphersaun	ஜெபர்சன்	ஜெப்பரர்ஸ்
jephpherson	ஜெபர்சன்	ஜெப்பர்சன்
zeffersaun	ஜெபர்சன்	ஜெப்பர்ஸ்
zefferson	ஜெபர்சன்	ஜெப்பர்ஸ்
zefpherson	ஜெபர்சன்	ஜெப்பர்சன்
zephpharson	ஜெபர்சன்	ஜெப்பர்சன்
germaaniya	ஜெர்மானிய	ஜெர்மானிய
germania	ஜெர்மானிய	ஜெர்மீனியா
germaaniyap	ஜெர்மானியப்	ஜெர்மானியை
germaniyap	ஜெர்மானியப்	ஜெர்மனியா்
germaaniyarkal	ஜெர்மானியர்கள்	ஜெர்மானியர்கள்
germaniyargal	ஜெர்மானியர்கள்	ஜெர்மனியார்கள்
jami	ஜேமி	ஜாமி
jamie	ஜேமி	ஜாமி
jamiee	ஜேமி	ஜம்மீ
jamii	ஜேமி	ஜாமி
jamiie	ஜேமி	ஜமமீ
jamy	ஜேமி	ஜாம்
jeemi	ஜேமி	ஜிமி
jeemiee	ஜேமி	ஜீமி
jemie	ஜேமி	ஜெமி
jemiie	ஜேமி	ஜெமீ
zami	ஜேமி	ஜாமி
zamie	ஜேமி	ஜமமீ
zamii	ஜேமி	ஜாமி
zamy	ஜேமி	ஜாம்
zemie	ஜேமி	ஜெமி
jioti	ஜோதி	ஜியோட்டி
jooti	ஜோதி	ஜோடி
jothi	ஜோதி	ஜோதி
jyooti	ஜோதி	ஜியோடி
jyoti	ஜோதி	ஜியோடி
jyotii	ஜோதி	ஜியோதி
zyoti	ஜோதி	ஜியோடி
gnanashnaanam	ஞானஸ்நானம்	ஞானான்சனம்
gnanasnaanam	ஞானஸ்நானம்	ஞானஞ்சனம்
gnanasnanam	ஞானஸ்நானம்	ஞானந்ணா்்
taakshi	டாக்ஸி	தாக்கி
taxi	டாக்ஸி	தேசி
daan	டான்	டான்
dain	டான்	டென்
dan	டான்	டன்
dann	டான்	டன்
dayn	டான்	டென்
den	டான்	டென்
don	டான்	டான்
donn	டான்	டான்
taan	டான்	டா்
design	டிசைன்	டெசிங்
disain	டிசைன்	டிசன்
dear	டியர்	டீர்
der	டியர்	டேர்
diyar	டியர்	டியர்
diram	டிராம்	டிரம்
tiraam	டிராம்	திராம்
tirom	டிராம்	டிரோம்
traam	டிராம்	திராம்
tram	டிராம்	டிராம்
trama	டிராம்	திர
tirailar	டிரெய்லர்	திரையர்
trailer	டிரெய்லர்	திரைல்
daepiyan	டெபியன்	தேபியன்
deban	டெபியன்	டீபன்
debann	டெபியன்	டீபான்
debeean	டெபியன்	டீபியன்
debeen	டெபியன்	டீபின்
debian	டெபியன்	டெபியன்
debiann	டெபியன்	டெபியன்
debiian	டெபியன்	டெபியான்
debiyan	டெபியன்	டெபியன்
delivery	டெலிவரி	டெல்விரி
telivari	டெலிவரி	தெல்விரா
devil	டெவில்	தேவில்
daeni	டேனி	டெனி
danni	டேனி	டன்னி
danny	டேனி	டன்னி
dany	டேனி	டானி
deeni	டேனி	டீனி
dison	டைசன்	டிஸோன்
tisan	டைசன்	திசன்
tison	டைசன்	டிஸோன்
tyson	டைசன்	டிஷன்
daiveng	டைவிங்	டெய்வங்
daivengg	டைவிங்	டெய்வங்
daiving	டைவிங்	டெய்விங்
daiwengg	டைவிங்	டெய்வங்
daiwing	டைவிங்	டெய்விங்
devengg	டைவிங்	டெவங்க்
deving	டைவிங்	டெவிங்
diving	டைவிங்	டிவிங்
divingg	டைவிங்	டிவிங்
diwing	டைவிங்	டிவிங்
diwingg	டைவிங்	டிவிங்
druuman	ட்ரூமன்	டிரமமன்
trooman	ட்ரூமன்	டுராமன்
trueman	ட்ரூமன்	டிருமான்
truman	ட்ரூமன்	டுராமன்
trumann	ட்ரூமன்	டுராமன்
truueman	ட்ரூமன்	துருமேன்
truuman	ட்ரூமன்	டுரமமன்
truumann	ட்ரூமன்	டுராமன்
driver	ட்ரைவர்	டிர்வ்ர்
tarran	த	தரரான்
teran	த	தேரான்
terran	த	தேரான்
thagadugal	தகடுகள்	தகடுகள்
thagadukal	தகடுகள்	தகடுகள்
thakadukal	தகடுகள்	தடகுகள்
thakatukal	தகடுகள்	தகடுகள்
thanggi	தங்கி	தங்கி
thangi	தங்கி	தங்கி
thangki	தங்கி	தங்கி
thanki	தங்கி	தங்கி
thanginar	தங்கினர்	தங்கினர்
thangkinar	தங்கினர்	தங்கினர்
thankinar	தங்கினர்	தங்கின்ற
thanginaar	தங்கினார்	தங்கினார்
thangkinaar	தங்கினார்	தங்கினார்
thankinaar	தங்கினார்	தங்கினார்
thangirukka	தங்கியிருக்க	தங்கிருக்க
thangiyirukka	தங்கியிருக்க	தங்கியிருக்க
thangkiirukka	தங்கியிருக்க	தங்கிகிறுக்க
thangkiyirrukka	தங்கியிருக்க	தங்கியிருக்கிற
thankiyirkka	தங்கியிருக்க	தங்கியிர்க்க
thangiirukkum	தங்கியிருக்கும்	தங்கிறுக்கும்
thangiyirukkum	தங்கியிருக்கும்	தங்கியிருக்கும்
thankiyirukkum	தங்கியிருக்கும்	தங்கியிருக்கும்
thangiulla	தங்கியுள்ள	தங்கிலுள்ள
thangiyulla	தங்கியுள்ள	தங்கியுள்ள
thankiyulla	தங்கியுள்ள	தங்கியுள்ள
dasaapdhangalaaga	தசாப்தங்களாக	தஸ்கா்பங்களாக
dasaapthangalaaga	தசாப்தங்களாக	தஸ்கா்பங்களாக
dasapthanggalaahga	தசாப்தங்களாக	தச்சங்கள்களா
thasaapthangalaaga	தசாப்தங்களாக	தசப்ப்்கங்களாக
dasaapdhangalil	தசாப்தங்களில்	தசஸ்பா்்களில்
dasaapthangalil	தசாப்தங்களில்	தசஸ்பா்திலங்
dasapthanggalil	தசாப்தங்களில்	தச்சங்களில்
thasaapdhangalil	தசாப்தங்களில்	தச்பா்்களின்
dasapthanggalukku	தசாப்தங்களுக்கு	தச்சங்களுக்கு
thasaapdhangalukku	தசாப்தங்களுக்கு	தசப்பாங்களுக்கு
thasaapthankkalukku	தசாப்தங்களுக்கு	தச்பங்கங்களுக்கு
thadangalai	தடங்களை	தடங்களை
thadanggalai	தடங்களை	தடங்களை
thadangkalai	தடங்களை	தடங்களை
thadangal	தடங்கள்	தடங்கள்
thadanggal	தடங்கள்	தடங்கள்
thadangkal	தடங்கள்	தடங்கள்
thaduththadhu	தடுத்தது	தடுத்தது
thaduththathu	தடுத்தது	தடுத்தது
thaduththanar	தடுத்தனர்	தடுத்தனர்
thaduththal	தடுத்தல்	தடுத்தல்
thadaigalaiyum	தடைகளையும்	தடைகளையும்
thadaikalaiyum	தடைகளையும்	தடைகளையும்
thadaikkalaiyum	தடைகளையும்	தடைக்களையும்
thadaykalayyum	தடைகளையும்	தடைகளையும்
thadaigal	தடைகள்	தடைகள்
thadaikal	தடைகள்	தடைகள்
thadaikkal	தடைகள்	தடைக்கள்
thadaygal	தடைகள்	தடைகள்
thadaykal	தடைகள்	தடைகள்
thadaich	தடைச்	தடைச்
thadaippattu	தடைப்பட்டு	தடைப்பட்டு
thadaiyatrtra	தடையற்ற	தடையற்ற
thadaiyattra	தடையற்ற	தடையேற்ற
thadaiyaaga	தடையாக	தடையாக
thadaiyaaka	தடையாக	தடையாக
thadaiyaanadhu	தடையானது	தடையானது
thadaiyaanathu	தடையானது	தடையானது
thadaiyin	தடையின்	தடையின்
thadaiyaiyum	தடையையும்	தடையையும்
dhandanaigalaiyum	தண்டனைகளையும்	தண்டணைகளையும்
thandanaigalaium	தண்டனைகளையும்	தண்டணைகளையும்
thandanaigalaiyum	தண்டனைகளையும்	தண்டணைகளையும்
thandanaikalaiyum	தண்டனைகளையும்	தண்டணைகளையும்
thandanaik	தண்டனைக்	தண்டனைக்
dhandanaikku	தண்டனைக்கு	தண்டனைக்கு
thandanaikku	தண்டனைக்கு	தண்டைன்களு
dhandanaich	தண்டனைச்	தண்டைசன்
thandanaich	தண்டனைச்	தண்டைஞச்
dhandanaiyaaga	தண்டனையாக	தண்டனையாக
thandanaiyaaga	தண்டனையாக	தண்டனையாக
thandanaiyaaka	தண்டனையாக	தண்டனையாக
dhandanaiyum	தண்டனையும்	தண்டனையும்
thandanaiyum	தண்டனையும்	தண்டனையும்
dhandanaiyai	தண்டனையை	தண்டனையை
thandanaiyai	தண்டனையை	தண்டணையை
dhandi	தண்டி	தாண்டி
thandi	தண்டி	தண்டி
thandil	தண்டில்	தண்டில்
thandhiramaaga	தந்திரமாக	தந்திரமாக
thanthiramaaga	தந்திரமாக	தந்திரமாக
thanthiramaaka	தந்திரமாக	தந்திரமாக
thandhiram	தந்திரம்	தந்திரம்
thanthiram	தந்திரம்	தந்திரம்
thanakkulla	தனக்குள்ள	தனக்குள்ள
thanakkae	தனக்கே	தனக்கே
thankkae	தனக்கே	தங்கே
thanithanip	தனித்தனிப்	தனிநதிதிப்
thaniththani	தனித்தனிப்	தனித்தனி
thaniththanip	தனித்தனிப்	தனித்தனிப்
thanithaniye	தனித்தனியே	தனிநததிய
thaniththaniyae	தனித்தனியே	தனிந்தியான
thaniththaniye	தனித்தனியே	தனிந்ததியின்
thanithanmai	தனித்தன்மை	தனிந்தனைம்
thaniththanmai	தனித்தன்மை	தனிந்தன்மை
thanithanmaiyai	தனித்தன்மையை	தனிந்தமையை
thaniththanmaiyai	தனித்தன்மையை	தனிந்துமையை
thanima	தனிம	தனிம
thanimangal	தனிமங்கள்	தனிமங்கள்
thanimankal	தனிமங்கள்	தனினங்கள்
thanimam	தனிமம்	தனிமம்
thanatchi	தன்னாட்சி	தனட்சி
thannaatchi	தன்னாட்சி	தன்னாச்சி
thanmaana	தன்மான	தன்மான
tamilaga	தமிழக	தமிழாக
thamilaga	தமிழக	தமிழாக
thamilaka	தமிழக	தமிழாக
thamizhaka	தமிழக	தமிழாக
tamilagach	தமிழகச்	தமிழாகச்
thamizhakach	தமிழகச்	தமிழகச்ச்
tamilagath	தமிழகத்	தமிழாகத்
thamizhakath	தமிழகத்	தமிழாகத்
tamilagaththin	தமிழகத்தின்	தமிழாகத்தின்
thamizhakaththin	தமிழகத்தின்	தமிழாதத்தின்
tamilagaththirku	தமிழகத்திற்கு	தமிழாகத்திற்கு
thamizhakaththirkku	தமிழகத்திற்கு	தமிழாத்திற்குக
thamizhakaththirku	தமிழகத்திற்கு	தமிழாத்திற்கு
tamilagaththil	தமிழகத்தில்	தமிழாகத்தில்
tamilagatthil	தமிழகத்தில்	தமிழாகத்தில்
tamilakatthil	தமிழகத்தில்	தமிழாகத்தில்
tamizhagatthil	தமிழகத்தில்	தமிழாதத்தில்
tamizhakatthil	தமிழகத்தில்	தமிழாகத்தில்
thamilagatthil	தமிழகத்தில்	தமிழாகத்தில்
thamilakatthil	தமிழகத்தில்	தமிழாகத்தில்
thamizhagatthil	தமிழகத்தில்	தமிழாதத்தில்
thamizhakaththil	தமிழகத்தில்	தமிழாதத்தில்
thamizhakatthil	தமிழகத்தில்	தமிழாதத்தில்
tamilagaththudan	தமிழகத்துடன்	தமிழாத்தகுடன்
tamilagatthudan	தமிழகத்துடன்	தமிழாகத்துடன்
tamilakatthudan	தமிழகத்துடன்	தமிழாகத்துடன்
tamizhagatthudan	தமிழகத்துடன்	தமிழாத்தக்டன்
tamizhakatthudan	தமிழகத்துடன்	தமிழாத்தக்டன்
thamilagatthudan	தமிழகத்துடன்	தமிழாகத்துடன்
thamilakatthudan	தமிழகத்துடன்	தமிழமத்தக்டன்
thamizhagatthudan	தமிழகத்துடன்	தமிழாத்தடுக்கன
thamizhakaththudan	தமிழகத்துடன்	தமிழக்தத்துடன்
thamizhakaththutan	தமிழகத்துடன்	தமிழக்தத்துடன்
thamizhakatthudan	தமிழகத்துடன்	தமிழக்தத்துடன்
tamilarinargal	தமிழறிஞர்கள்	தமிழரிநார்கள்
tamilaringargal	தமிழறிஞர்கள்	தமிழர்கி்களரர்
thamizharingargal	தமிழறிஞர்கள்	தமிழரிங்களரர்க
thamizharingyargal	தமிழறிஞர்கள்	தமிழர்கினர்கள்
thamizharingyarkal	தமிழறிஞர்கள்	தமிழர்கி்கிறார
tamilai	தமிழை	தமிழை
tamizhai	தமிழை	தமிழை
thamilai	தமிழை	தமிழை
thamizhai	தமிழை	தமிழை
tamilaip	தமிழைப்	தமிழைப்
tamizhaip	தமிழைப்	தமிழைப்
thamilaip	தமிழைப்	தமிழைப்
thamizhaip	தமிழைப்	தமிழைப்
tamilnadu	தமிழ்நாடு	தமிழ்நாட்டு
tamilnatu	தமிழ்நாடு	தமிழ்நாட்டு
thamilnaatu	தமிழ்நாடு	தமிழ்நாட்டு
thamilnatu	தமிழ்நாடு	தமிழ்நாட்டு
thamizhnaadu	தமிழ்நாடு	தமிழ்நாட்டு
tamilnadum	தமிழ்நாடும்	தமிழ்நாட்டும்
thamilnaadum	தமிழ்நாடும்	தமிழ்நாட்டும்
thamilnadum	தமிழ்நாடும்	தமிழ்நாட்டும்
thamizhnaadum	தமிழ்நாடும்	தமிழ்நாடும்
thambadhigalin	தம்பதிகளின்	தம்பதிகளின்
thambathigalin	தம்பதிகளின்	தம்பத்திகளின்
thambathikalin	தம்பதிகளின்	தம்பத்திகளின்
thampathikalin	தம்பதிகளின்	தம்பத்திகளின்
thambadhiyinarin	தம்பதியினரின்	தம்பதியினரின்
thambathiyinarin	தம்பதியினரின்	தம்பத்தியானின்
thambadhiyin	தம்பதியின்	தம்பதியின்
thambathiyin	தம்பதியின்	தம்பத்தியின்
tayaaraana	தயாரான	தயாரான
thayaaraana	தயாரான	தயாரான
thayarana	தயாரான	தயரரன
thayaarippaana	தயாரிப்பான	தயாரிப்பான
thayaarippaalarum	தயாரிப்பாளரும்	தயாரிப்பாளரும்
thayaarippaazharum	தயாரிப்பாளரும்	தயாரிப்பாளரும்
dhayaazh	தயாள்	தயாள்
thayaal	தயாள்	தயால்
thayal	தயாள்	தயல்
mudiyumaa	தர	முடியுமா
mutiyuma	தர	முடிய
tarathai	தரத்தை	தரத்தை
tharathai	தரத்தை	தரத்தை
tharaththai	தரத்தை	தரத்தை
tharatthai	தரத்தை	தரத்தை
taratthaiyum	தரத்தையும்	தரத்தையும்
tharathaiyum	தரத்தையும்	தரத்தையும்
tharaththaiyum	தரத்தையும்	தரத்தையும்
tharatthaiyum	தரத்தையும்	தரத்தையும்
tarappil	தரப்பில்	தரப்பில்
tharapil	தரப்பில்	தரப்பில்
tharappil	தரப்பில்	தரப்பில்
tharavarisai	தரவரிசை	தரவரிசை
tharavalladhu	தரவல்லது	தரவல்லது
tharavallathu	தரவல்லது	தரவல்லது
tharavugalaich	தரவுகளைச்	தரவுகளைச்
tharavukalaich	தரவுகளைச்	தரவுகளைச்
tharavugalaip	தரவுகளைப்	தரவுகளைப்
tarunatthil	தருணத்தில்	தருநத்தில்
tharunathil	தருணத்தில்	தருநத்தில்
tharunaththil	தருணத்தில்	தருநத்தில்
tharunatthil	தருணத்தில்	தருநத்தில்
dharun	தருண்	தரரன்
tarun	தருண்	தரர்
tharun	தருண்	தரர்
dharumi	தருமி	தருமி
tharumi	தருமி	தருமி
tharum	தரும்	தரும்
dharmapuriyil	தர்மபுரியில்	தர்முறையிலி
thalaimaiyaetru	தலைமையேற்று	தலைமையறறு
thalaimaiyetru	தலைமையேற்று	தலைமையிற்று
thalaimaiyettru	தலைமையேற்று	தலைமையற்று
talaivanin	தலைவனின்	தலைவனின்
thalaivanin	தலைவனின்	தலைவனின்
talaivaraavaar	தலைவராவார்	தலைவராவர்
thalaivaraavaar	தலைவராவார்	தலைவராவரர்
thalaivaravaar	தலைவராவார்	தலைவரவரர்
talaivarukku	தலைவருக்கு	தலைவருக்கு
thalaivarukku	தலைவருக்கு	தலைவருக்கு
thalaivali	தலைவலி	தலைவழி
thalaththirku	தளத்திற்கு	தலத்திற்கு
thalatthirku	தளத்திற்கு	தலத்திற்கு
thalaththilirunthu	தளத்திலிருந்து	தலத்திலிருந்து
thalatthilirunthu	தளத்திலிருந்து	தலத்திலிருந்து
thalaththilum	தளத்திலும்	தலத்திலும்
thalatthilum	தளத்திலும்	தலத்திலும்
thalap	தளப்	தலப்
thalamaana	தளமான	தலமான
thalavaadangalai	தளவாடங்களை	தலவடாங்களை
thalavaadangalay	தளவாடங்களை	தலவாடங்களை
thalavaadangkalai	தளவாடங்களை	தலவடாங்களை
thalavaadankalai	தளவாடங்களை	தலவடாங்களை
thalavaatankalay	தளவாடங்களை	தலவாட்டங்கள்
thaviththa	தவித்த	தவித்த
thavittha	தவித்த	தவித்த
thaakku	தாக்கு	தாக்கு
thaadhukkal	தாதுக்கள்	தாதுக்கள்
thaathukkal	தாதுக்கள்	தாதுக்கள்
thaadhuvai	தாதுவை	தாதுவை
thaathuvai	தாதுவை	தாதுவை
thaano	தானோ	தானோ
thaamira	தாமிர	தாமிர
thamira	தாமிர	தமிரா
thaamae	தாமே	தாமே
thaame	தாமே	தாமே
thaamey	தாமே	தாமை
dam	தாம்	டாம்
dhaam	தாம்	தாம்
thaam	தாம்	தாம்
tambaram	தாம்பரம்	தம்பரம்
thaambaram	தாம்பரம்	தாம்பரம்
thaayaga	தாயக	தாயக
thayaga	தாயக	தயக
thaayagathil	தாயகத்தில்	தாயகத்தில்
thaayagaththil	தாயகத்தில்	தாயகத்தில்
thaayagap	தாயகப்	தாயக்கப்
thaayagam	தாயகம்	தாயகம்
thaayumaanavar	தாயுமானவர்	தாயுமானவர்
thayumanavar	தாயுமானவர்	தயுமனவவர்
taali	தாலி	தாலி
taalii	தாலி	தாலி
tali	தாலி	தலி
talii	தாலி	தல்லி
thaali	தாலி	தாளி
thaaliyai	தாலியை	தாழியை
thaal	தாழ்	தால்
thaazh	தாழ்	தாழ்
thikaar	திகார்	திகார்
tihar	திகார்	தியார்
thittamidaludan	திட்டமிடலுடன்	திட்டம்பட்டுள்
thittamiduthal	திட்டமிடுதல்	திட்டமிட்டலலல்
thinnanaar	திண்ணனார்	தின்னநார்
deen	தின்	டீன்
dhin	தின்	தின்
diin	தின்	டீன்
din	தின்	டின்
dyn	தின்	டின்
thin	தின்	தின்
tin	தின்	தின்
thinnum	தின்னும்	தின்ணும்
dmkvil	திமுகவில்	டிம்விக்
thimukavil	திமுகவில்	திமுகவில்
temoorr	திமோர்	டிமூரர்
temor	திமோர்	டிமோரர்
temorr	திமோர்	டிமாரர்
timoor	திமோர்	டிமூர்
timoorr	திமோர்	டிமூர்
timor	திமோர்	டிமோர்
timorr	திமோர்	டிமார்
tymoor	திமோர்	டைமூர்
tymor	திமோர்	டிம்மூர்
thiyaagaraajarin	தியாகராஜரின்	தியாகராரின்
thiyaakaraajarin	தியாகராஜரின்	தியாகராரின்
thiyagarajarin	தியாகராஜரின்	தியாகரரரின்
thyaagarajarin	தியாகராஜரின்	தியாகரரசினி
thiyaagaraajaa	தியாகராஜா	தியாகராஜ
thiyaakaraaja	தியாகராஜா	தியாகராஜ
thiyaakaraajaa	தியாகராஜா	தியாகராஜ
thiyakaraja	தியாகராஜா	தியகராஜ
tiyaakaraaja	தியாகராஜா	தியாகராஜ
thirumulukkup	திருமுழுக்குப்	திருமுழுக்குப்
thirumulukup	திருமுழுக்குப்	திருமுழுக்குப்
tirumulukkup	திருமுழுக்குப்	திருமுழுக்குப்
thirumoorthi	திருமூர்த்தி	திருமூர்த்தி
thirumoorththi	திருமூர்த்தி	திருமொர்த்தி
thirumuurtthi	திருமூர்த்தி	திருமுத்தி
tiruumrthi	திருமூர்த்தி	திரும்தி
thiruvadi	திருவடி	திருவாடி
thiruvati	திருவடி	திருவாதி
thiruvadikalai	திருவடிகளை	திருவாடகிகளை
thiruvatikalai	திருவடிகளை	திருவாதிகளை
tiruvatikalai	திருவடிகளை	திருவடிகளை
thiruvarangkaththil	திருவரங்கத்தில்	திருவரங்கத்தில்
thiruvarankkaththil	திருவரங்கத்தில்	திருவருங்கத்தில்
thiruvarangan	திருவரங்கன்	திருவரங்கன்
thiruvarangkan	திருவரங்கன்	திருவரங்கன்
thiruvarankan	திருவரங்கன்	திருவரங்கன்
tiruvarankan	திருவரங்கன்	திருவரங்கன்
maraivil	திரை	மறைவில்
thiraikalil	திரைகளில்	திறைகளில்
tiraikalil	திரைகளில்	திறைக்களில்
thiraikal	திரைகள்	திறைகள்
tiraikal	திரைகள்	திறைகள்
thiraiyil	திரையில்	திறையில்
tiraiyil	திரையில்	திரையில்
thiraiyum	திரையும்	திறையும்
tiraiyum	திரையும்	திரையும்
thiraiyai	திரையை	திறையை
tiraiyai	திரையை	திரையை
thiranaal	திறனால்	திறனால்
thiranukku	திறனுக்கு	திறனுக்கு
thiranudan	திறனுடன்	திறனுடன்
thirangalai	திறன்களை	திறங்களை
thirankalai	திறன்களை	திறங்களை
divakar	திவாகர்	திவகர்
diwakar	திவாகர்	திவகார்
thivaakar	திவாகர்	திவாகர்
deevan	திவான்	தேவன்
deewan	திவான்	தேவான்
diiwan	திவான்	திவான்
divaan	திவான்	திவான்
divan	திவான்	திவான்
divann	திவான்	டிவான்
diwaan	திவான்	திவான்
diwan	திவான்	திவான்
diwann	திவான்	டிவான்
thivaan	திவான்	திவான்
tivan	திவான்	திவான்
theetchithar	தீட்சிதர்	தீட்சிதர்
thidshithar	தீட்சிதர்	திட்சித்தர்
theendaamaikku	தீண்டாமைக்கு	தீண்டமைக்கு
theeba	தீப	தீபா
theepa	தீப	தீபா
deepath	தீபத்	தீபத்
dheepath	தீபத்	தீபத்
theepath	தீபத்	தீபத்
deepa	தீபா	தீபா
deepaa	தீபா	தேபா
dheepa	தீபா	தீபா
dheepaa	தீபா	தீபா
diipa	தீபா	தீபா
diipaa	தீபா	தீபா
dipa	தீபா	திபா
dipaa	தீபா	திபா
theepaa	தீபா	தீபா
tiipa	தீபா	தீபா
theepparri	தீப்பற்றி	தீப்பரர்
theeppatri	தீப்பற்றி	திப்பற்றி
theeppattri	தீப்பற்றி	திப்பற்றி
theeparrik	தீப்பற்றிக்	தீபார்க்கி
theepattrik	தீப்பற்றிக்	தீபார்ட்கி்
theeppatrik	தீப்பற்றிக்	திப்பற்றிக்
dheergadarisigal	தீர்க்கதரிசிகள்	தீர்காரிகரிகள்
theerkkatharisikal	தீர்க்கதரிசிகள்	தீர்க்தரககிகரில்
theerppadhil	தீர்ப்பதில்	தீர்ப்பதில்
theerppathil	தீர்ப்பதில்	தீர்ப்பதில்
theerppadhu	தீர்ப்பது	தீர்ப்பது
theerppathu	தீர்ப்பது	தீர்ப்பது
theerppil	தீர்ப்பில்	தீர்ப்பில்
theerppai	தீர்ப்பை	தீர்ப்பை
theermaaniththadhu	தீர்மானித்தது	தீர்மானத்துது
theermaaniththathu	தீர்மானித்தது	தீர்மானித்தது
theermaaniththaar	தீர்மானித்தார்	தீர்மானித்தார்
theermaaniththu	தீர்மானித்து	தீர்மானித்து
theervaaga	தீர்வாக	தீர்வாக
theervaaka	தீர்வாக	தீர்வாக
theevana	தீவன	தேவன
theevanaththil	தீவனத்தில்	தேவந்ததில்
theevaththil	தீவனத்தில்	தேவத்தில்
theevanam	தீவனம்	தேவனம்
theeviravaadhi	தீவிரவாதி	தீவிரவாதி
theeviravaathi	தீவிரவாதி	தீவிராவதி
theeviravaadhigalaal	தீவிரவாதிகளால்	தீவிரவாதிலாலர்
theeviravaathigalaal	தீவிரவாதிகளால்	தீவிரவாதிலாலர்
theeviravaathigazhaal	தீவிரவாதிகளால்	தீவிரவாதிலாலர்
theeviravaathikalaal	தீவிரவாதிகளால்	தீவிரவதாலிலால்
theeviravaadhigalin	தீவிரவாதிகளின்	தீவிரவிிகளின்
theeviravaathigalin	தீவிரவாதிகளின்	தீவிரவதிிகளின்
theeviravaathigazhin	தீவிரவாதிகளின்	தீவிரவதிிகளின்
theeviravaathikalin	தீவிரவாதிகளின்	தீவிரவதிிகளின்
theeviravaathigalay	தீவிரவாதிகளை	தீவிரவதிிலாக
theeviravaathigazhai	தீவிரவாதிகளை	தீவிரவதிகளை
theeviravaathikalai	தீவிரவாதிகளை	தீவிரவதிகளை
theeviravaathikalay	தீவிரவாதிகளை	தீவிரவதிிலாக
theeviravaathigal	தீவிரவாதிகள்	தீவிரவதிகள்
theeviravaathikal	தீவிரவாதிகள்	தீவிரவதிகள்
theeviravaadhiyaaga	தீவிரவாதியாக	தீவிரவதியாக
theeviravaathiyaaga	தீவிரவாதியாக	தீவிரவதியாக
theeviravaathiyaaka	தீவிரவாதியாக	தீவிரவதியாக
thundaaga	துண்டாக	துண்டாக
thundaaka	துண்டாக	துண்டாக
thundai	துண்டை	துண்டை
thunburuthalil	துன்புறுத்தலில்	துன்புறுதலில்
thunburuththalil	துன்புறுத்தலில்	துன்புறுத்தில்
thunpuruththalil	துன்புறுத்தலில்	துன்புறுத்தில்
thunburuththum	துன்புறுத்தும்	துன்புறுத்தும்
thunburuthum	துன்புறுத்தும்	துன்புறுுதும்
thunpuruththum	துன்புறுத்தும்	துன்புறுத்தும்
tumi	துமி	டுமி
tumii	துமி	டுமி
tuumi	துமி	டுமி
thuruva	துருவ	துருவ
thuruvangalil	துருவங்களில்	துருவங்களில்
thuruvangal	துருவங்கள்	துருவங்கள்
thuruvaththil	துருவத்தில்	துறுவத்தில்
thuruvap	துருவப்	துறுவப்
dhroanarin	துரோணரின்	துரோனின்
dronarin	துரோணரின்	டிரோனின்
thuronarin	துரோணரின்	துரோணாரின்
thuravigalum	துறவிகளும்	துறவிகளும்
thuravikalum	துறவிகளும்	துறவிகளும்
thuravikku	துறவிக்கு	துறவிக்கு
thuraviyaaga	துறவியாக	துறவியாக
thuraviyaaka	துறவியாக	துறவியாக
thuraviyaana	துறவியான	துறவியான
thuraikku	துறைக்கு	துறைக்கு
thulaigalil	துளைகளில்	துலைகளில்
thulaikalil	துளைகளில்	துலைகளில்
thuvakka	துவக்க	துவக்க
thuvakkap	துவக்கப்	துவக்கப்
thuvakkappatta	துவக்கப்பட்ட	துவக்கப்பட்ட
thuvakkiya	துவக்கிய	துவக்கிய
thuvanga	துவங்க	துவங்க
thuvangga	துவங்க	துவங்க
thuvangka	துவங்க	துவங்க
thuvangapatu	துவங்கப்பட்டு	துவங்கப்பட்டு
thuvangappattu	துவங்கப்பட்டு	துவங்கப்பட்டு
thuvanggappattu	துவங்கப்பட்டு	துவங்கப்பட்டு
thuvangkappattu	துவங்கப்பட்டு	துவங்கப்பட்டு
thuvanggum	துவங்கும்	துவங்கும்
thuvangkum	துவங்கும்	துவங்கும்
thuvangum	துவங்கும்	துவங்கும்
thuvangguvatharku	துவங்குவதற்கு	துவங்குவதற்கு
thuvangkuvatharku	துவங்குவதற்கு	துவங்குவதற்கு
thuvanguvatharku	துவங்குவதற்கு	துவங்குவதற்கு
dvaitham	துவைதம்	துவிதம்
thuvaitham	துவைதம்	துவைத்தம்
thwaytham	துவைதம்	துவைத்
thoodhuvar	தூதுவர்	தூதுவர்
thoothuvar	தூதுவர்	தூத்துவர்
thoothuvargal	தூதுவர்கள்	தூத்துவர்கள்
thoothuvarkal	தூதுவர்கள்	தூத்துவர்கள்
thoorvaari	தூர்வாரி	தூர்வாரி
thenasia	தென்னாசிய	தென்சாய்
thennaasiya	தென்னாசிய	தென்னாசிய
therkil	தெற்கில்	தெர்கில்
therkkil	தெற்கில்	தெற்கில்
therkae	தெற்கே	தெற்கே
therke	தெற்கே	தெர்கே
therkke	தெற்கே	தெற்க்க
thelivatra	தெளிவற்ற	தெளிவற்ற
dhegathil	தேகத்தில்	தேகத்தில்
thaegaththil	தேகத்தில்	தேகத்தில்
thaekaththil	தேகத்தில்	தேகத்தில்
thaekkam	தேக்கம்	தேக்கம்
thekkam	தேக்கம்	தேக்கம்
thaekku	தேக்கு	தேக்கு
thekku	தேக்கு	தேக்கு
thaekkum	தேக்கும்	தேக்கும்
thekkum	தேக்கும்	தேக்கும்
thaengaai	தேங்காய்	தேங்காய்
thaenkaai	தேங்காய்	தேங்காய்
thaenum	தேனும்	தேனும்
thenum	தேனும்	தெனும்
thaergal	தேர்கள்	தேர்கள்
thaerkal	தேர்கள்	தேர்கள்
therkal	தேர்கள்	தேர்கள்
teerth	தேர்த்	டிர்த்
thaerth	தேர்த்	தேர்த்
theerth	தேர்த்	தீர்த்
therth	தேர்த்	தேர்த்
thaernthaedukka	தேர்ந்தெடுக்க	தேர்ந்தெடுக்க
thaernthedukka	தேர்ந்தெடுக்க	தேர்ந்தெடுக்க
thernthedukka	தேர்ந்தெடுக்க	தேர்ந்தெடுக்க
thaernthedukkappada	தேர்ந்தெடுக்கப்பட	தேர்ந்தெடுக்கப்பட்ட
thernthedukkappada	தேர்ந்தெடுக்கப்பட	தேர்ந்தெடுக்கப்பட்ட
thaernthaedukkappadum	தேர்ந்தெடுக்கப்படும்	தேர்ந்தெடுக்கப்படும்
thaernthedukkappadum	தேர்ந்தெடுக்கப்படும்	தேர்ந்தெடுக்கப்படும்
thernthedukkappadum	தேர்ந்தெடுக்கப்படும்	தேர்ந்தெடுக்கப்படும்
devaalayanggalil	தேவாலயங்களில்	தேவாளர்களில்
devalayangalil	தேவாலயங்களில்	தேவாளர்களில்
thevaalayangalil	தேவாலயங்களில்	தேவாளரங்களில்
thevaalayangkalil	தேவாலயங்களில்	தேவாளரங்களில்
devaalayangal	தேவாலயங்கள்	தேவாளர்கள்
devalayangal	தேவாலயங்கள்	தேவலாயங்கள்
thevaalayangal	தேவாலயங்கள்	தேவாளரங்கள்
thevaalayangkal	தேவாலயங்கள்	தேவாளரங்கள்
devaalayaththin	தேவாலயத்தின்	தேவாளத்தின்
devalayaththin	தேவாலயத்தின்	தேவாளத்தின்
thevaalayaththin	தேவாலயத்தின்	தேவாளத்தின்
devaalayaththil	தேவாலயத்தில்	தேவாளத்தில்
devalayaththil	தேவாலயத்தில்	தேவாளத்தில்
thevaalayaththil	தேவாலயத்தில்	தேவாளத்தில்
devaalayaththai	தேவாலயத்தை	தேவாளதையத்
devalayaththai	தேவாலயத்தை	தேவளையத்தை
thevaalayaththai	தேவாலயத்தை	தேவாளதையத்
thoguththal	தொகுத்தல்	தொகுத்தல்
thoguththavar	தொகுத்தவர்	தொகுத்தவர்
thoguththullaar	தொகுத்துள்ளார்	தொகுத்துள்ளார்
thoguppinai	தொகுப்பினை	தொகுப்பினை
thokupinai	தொகுப்பினை	தொகுப்பினை
thokuppinai	தொகுப்பினை	தொகுப்பினை
thoguppai	தொகுப்பை	தொகுப்பை
thokupaip	தொகுப்பை	தொகுப்பைப்
thokuppai	தொகுப்பை	தொகுப்பை
thoguppaip	தொகுப்பைப்	தொகுப்பைப்
thokupaip	தொகுப்பைப்	தொகுப்பைப்
thokuppaip	தொகுப்பைப்	தொகுப்பைப்
thogai	தொகை	தொகை
thokai	தொகை	தொகை
tokai	தொகை	தொகை
thogaik	தொகைக்	தொகைக்
thokaik	தொகைக்	தொகைக்
tokaik	தொகைக்	தொகைக்
thogaip	தொகைப்	தொகைப்
thokaip	தொகைப்	தொகைப்
tokaip	தொகைப்	தொகைப்
thogaiyaaga	தொகையாக	தொகையாக
thokaiyaaka	தொகையாக	தொகையாக
thokaiyaka	தொகையாக	தொகையைக
thogaiyana	தொகையான	தொகையன
thokaiyaana	தொகையான	தொகையான
thokaiyana	தொகையான	தொகையை
thogaiyil	தொகையில்	தொகையில்
thokaiyil	தொகையில்	தொகையில்
tokaiyil	தொகையில்	தொக்கையில்
thogaiyudan	தொகையுடன்	தொகையுடன்
thokaiyudan	தொகையுடன்	தொகையுடன்
thokaiyutan	தொகையுடன்	தொகையுடன்
tokaiyutan	தொகையுடன்	தொகையுடன்
thogaiyum	தொகையும்	தொகையும்
thokaiyum	தொகையும்	தொகையும்
tokaiyum	தொகையும்	தொகையும்
thokaiyaich	தொகையைச்	தொகையைச்
tokaiyaich	தொகையைச்	தொடைகையை
thokaiyaiyum	தொகையையும்	தொகையையும்
tokaiyaiyum	தொகையையும்	தொகையையும்
thodandhu	தொடந்து	தொடைந்து
thodanththu	தொடந்து	தொடைந்து
thotanthu	தொடந்து	தொட்டந்து
totanthu	தொடந்து	தொட்ந்து
thodarbaana	தொடர்பான	தொடர்பான
thodarpaana	தொடர்பான	தொடர்பான
thotarpaana	தொடர்பான	தொடர்பான
thotarpana	தொடர்பான	தொடர்பன
thodarbaanathu	தொடர்பானது	தொடர்பானது
thodarpaanathu	தொடர்பானது	தொடர்பானது
thotarpaanathu	தொடர்பானது	தொடர்பானது
thotarpanathu	தொடர்பானது	தொடர்பனது
thodarbaanavai	தொடர்பானவை	தொடர்பானவை
thodarpaanavai	தொடர்பானவை	தொடர்பானவை
thotarpaanavai	தொடர்பானவை	தொடர்பானவை
thotarpanavai	தொடர்பானவை	தொடர்பனவை
thodarbu	தொடர்பு	தொடர்பு
thodarpu	தொடர்பு	தொடர்பு
thotarpu	தொடர்பு	தொடர்பு
totarpu	தொடர்பு	தொடர்பு
thodarbukalai	தொடர்புகளை	தொடர்புகளை
thodarpukalai	தொடர்புகளை	தொடர்புகளை
thotarpukalai	தொடர்புகளை	தொடர்புகளை
totarpukalai	தொடர்புகளை	தொடர்புகளை
thodarbukalaip	தொடர்புகளைப்	தொடர்புகளைப்
thodarpukalaip	தொடர்புகளைப்	தொடர்புகளைப்
thotarpukalaip	தொடர்புகளைப்	தொடர்ப்படுகளை
totarpukalaip	தொடர்புகளைப்	தொடர்புகளைப்
thodarbup	தொடர்புப்	தொடர்ப்பு
thodarpup	தொடர்புப்	தொடர்ப்பு
thodarbum	தொடர்பும்	தொடர்பும்
thodarpum	தொடர்பும்	தொடர்பும்
thoduthal	தொடுதல்	தொடுதல்
totuthal	தொடுதல்	தொடுத்தல்
thottuk	தொட்டுக்	தொட்டுக்
thotuk	தொட்டுக்	தொடுக்
thottum	தொட்டும்	தொட்டும்
thotum	தொட்டும்	தொடும்
tholaipaesigal	தொலைபேசிகள்	தொலைப்பேசிகள்
tholaipesigal	தொலைபேசிகள்	தொலைப்பேகிகள்
tholaipaesikku	தொலைபேசிக்கு	தொலைப்பேசிக்க
tholaipesikku	தொலைபேசிக்கு	தொலைப்பிக்கு
tholaipaesiyil	தொலைபேசியில்	தொலைப்பேசிலி
tholaipesiyil	தொலைபேசியில்	தொலைப்பிளியில
tholiyal	தொல்லியல்	தொழியல்
tholliyal	தொல்லியல்	தொழ்லியல்
tholilathibarai	தொழிலதிபரை	தொழிலதிபரப்
thozhilathibarai	தொழிலதிபரை	தொழிலதிபரப்
thozhilathiparai	தொழிலதிபரை	தொழிலதிப்பற்
tholilum	தொழிலும்	தொழிலும்
thozhilum	தொழிலும்	தொழிலும்
tolilum	தொழிலும்	தொழிலும்
tholilae	தொழிலே	தொழிலே
tholile	தொழிலே	தொழில்
tholilee	தொழிலே	தொழில்லி
thozhile	தொழிலே	தொழில்
thoandappatta	தோண்டப்பட்ட	தோண்டப்பட்ட
thondappatta	தோண்டப்பட்ட	தொண்டப்பட்ட
thontapata	தோண்டப்பட்ட	தொண்டப்பட்ட
thoontappatta	தோண்டப்பட்ட	தூண்டப்பட்ட
thoaththiram	தோத்திரம்	தோத்திரம்
thootthiram	தோத்திரம்	தூத்திரம்
thothiram	தோத்திரம்	தொதிரம்
thoththiram	தோத்திரம்	தொத்திரம்
thondriyadhaaga	தோன்றியதாக	தொன்றியதாக
thondriyadhaaka	தோன்றியதாக	தொன்றியதாக
thondriyathaaga	தோன்றியதாக	தொன்றியதாக
thondriyathaaka	தோன்றியதாக	தொன்றியதாக
thontriyathaka	தோன்றியதாக	தொன்றியதாக
thoontriyathaaka	தோன்றியதாக	தோன்றியதாக
thondriyadhu	தோன்றியது	தொன்றியது
thondriyathu	தோன்றியது	தொன்றியது
thontriyathu	தோன்றியது	தொன்றியது
thoontriyathu	தோன்றியது	தோன்றியது
thondriyadhai	தோன்றியதை	தொன்றியதை
thondriyathai	தோன்றியதை	தொன்றியதை
thontriyathai	தோன்றியதை	தொன்றியதை
thoontriyathai	தோன்றியதை	தோன்றியதை
thondriyavar	தோன்றியவர்	தொன்றியவர்
thontriyavar	தோன்றியவர்	தொன்றியவர்
thoontriyavar	தோன்றியவர்	தோன்றியவர்
thondriyavai	தோன்றியவை	தொன்றியவை
thontriyavai	தோன்றியவை	தொன்றியவை
thoontriyavai	தோன்றியவை	தோன்றியவை
thoarum	தோறும்	தோரும்
thaotrtru	தோற்று	தோற்று
thoarru	தோற்று	தோற்று
thoatrtru	தோற்று	தோற்று
thoatru	தோற்று	தோற்று
thoattru	தோற்று	தோற்று
thoarruvikkappadum	தோற்றுவிக்கப்படும்	தோற்றுவிக்கப்படும்
thoatruvikkappadum	தோற்றுவிக்கப்படும்	தோற்றுவிக்கப்படும்
thoattruvikkappadum	தோற்றுவிக்கப்படும்	தோற்றுவிக்கப்படும்
thoarruvikkappatta	தோற்றுவிக்கப்பட்ட	தோற்றுவிக்கப்பட்ட
thoatruvikkappatta	தோற்றுவிக்கப்பட்ட	தோற்றுவிக்கப்பட்ட
thoattruvikkappatta	தோற்றுவிக்கப்பட்ட	தோற்றுவிக்கப்பட்ட
thoarruvikkum	தோற்றுவிக்கும்	தோற்றுவிக்கும்
thoatruvikkum	தோற்றுவிக்கும்	தோற்றுவிக்கும்
thoattruvikkum	தோற்றுவிக்கும்	தோற்றுவிக்கும்
thoarruviththa	தோற்றுவித்த	தோற்றுவித
thoatruviththa	தோற்றுவித்த	தோற்றுவித்த
thoattruviththa	தோற்றுவித்த	தோற்றுவித்த
thoarruviththathu	தோற்றுவித்தது	தோற்றுவித்தது
thoatruviththathu	தோற்றுவித்தது	தோற்றுவித்தது
thoattruviththathu	தோற்றுவித்தது	தோற்றுவித்தது
thoalaal	தோலால்	தோலால்
thaan	தோல்வி	தான்
thoalvi	தோல்வி	தோல்வி
tholvi	தோல்வி	தொல்வி
thoolvi	தோல்வி	தூல்வி
thoalvigalai	தோல்விகளை	தோல்விகளை
thoalvigazhai	தோல்விகளை	தோல்விகளை
tholvigalai	தோல்விகளை	தொல்விகளை
tholvikalai	தோல்விகளை	தொல்விகளை
thoolvikalai	தோல்விகளை	தூல்விகளை
thoalvigalaiyum	தோல்விகளையும்	தோல்விகளையும்
thoalvigazhaiyum	தோல்விகளையும்	தோல்விகளையும்
tholvigalayum	தோல்விகளையும்	தொல்விகளையும்
tholvikalaiyum	தோல்விகளையும்	தொல்விகளையும்
tholvikalayum	தோல்விகளையும்	தொல்விகளையும்
thoolvikalaiyum	தோல்விகளையும்	தூல்விகளையும்
thoalvigal	தோல்விகள்	தோல்விகள்
thoalvigazh	தோல்விகள்	தோல்விகள்
tholvigal	தோல்விகள்	தொல்விகள்
tholvikal	தோல்விகள்	தொல்விகள்
thoolvikal	தோல்விகள்	தூல்விகள்
thoalviyaal	தோல்வியால்	தோழ்வியால்
thoalviyin	தோல்வியின்	தோல்வியின்
thoalviyai	தோல்வியை	தோல்வியை
thriller	த்ரில்லர்	திரில்லர்
nadunilaimai	நடுநிலைமை	நடுநிலையை
nadunilamai	நடுநிலைமை	நடுனிலையம்
nadaipera	நடைபெற	நடைபெற
nadaiperakkoodiya	நடைபெறக்கூடிய	நடைபெற்க்கூறிய
nadaiperath	நடைபெறத்	நடைபெறத்
nadiperath	நடைபெறத்	நடிபெரத்
nadaiperavillai	நடைபெறவில்லை	நடைபெறவில்லை
nadaiperrum	நடைபெறும்	நடைபெற்றும்
nadaiperum	நடைபெறும்	நடைபெறும்
nadaiperumbodhu	நடைபெறும்போது	நடைபெறும்போது
nadaiperumpoadhu	நடைபெறும்போது	நடைபெறும்போது
nadaiperumpothu	நடைபெறும்போது	நடைபெறும்போது
nadaiperuvadharku	நடைபெறுவதற்கு	நடைபெறுவதற்கு
nadaiperuvatharku	நடைபெறுவதற்கு	நடைபெறுவதற்கு
nadaiperuvadhu	நடைபெறுவது	நடைப்பெறுவது
nadaiperuvathu	நடைபெறுவது	நடைபெறுவது
nadhigalin	நதிகளின்	நதிகளின்
nadhigazhin	நதிகளின்	நதிகளின்
nadhikalin	நதிகளின்	நதிகளின்
nathigalin	நதிகளின்	நதிகளின்
nadhigalil	நதிகளில்	நதிகளில்
nadhigazhil	நதிகளில்	நதிகளில்
nadhikalil	நதிகளில்	நதிகளில்
nathigalil	நதிகளில்	நதிகளில்
nathikalil	நதிகளில்	நதிகளில்
nadhigalukku	நதிகளுக்கு	நதிகளுக்கு
nadhigazhukku	நதிகளுக்கு	நதிகழுக்கு
nadhikalukku	நதிகளுக்கு	நதிகளுக்கு
nathigalukku	நதிகளுக்கு	நதிகளுக்கு
nadhigal	நதிகள்	நதிகள்
nadhikal	நதிகள்	நதிகள்
nathigal	நதிகள்	நதிகள்
nadhikku	நதிக்கு	நதிக்கு
nathikku	நதிக்கு	நதிக்கு
nadhiyaaga	நதியாக	நதியாக
nadhiyaaka	நதியாக	நதியாக
nathiyaaga	நதியாக	நதியாக
nadhiyin	நதியின்	நதியின்
nathiyin	நதியின்	நதியின்
nadhiyum	நதியும்	நதியும்
nathiyum	நதியும்	நதியும்
nadhiyai	நதியை	நதியை
nathiyai	நதியை	நதியை
nanavili	நனவிலி	நன்விி
nanmaigalum	நன்மைகளும்	நண்மைகளும்
nanmaigazhum	நன்மைகளும்	நன்மைகளும்
nanmaikalum	நன்மைகளும்	நண்மைகளும்
nanmaigalaiyum	நன்மைகளையும்	நண்மைகளையும்
nanmaigazhaiyum	நன்மைகளையும்	நண்மைகளையும்
nanmaikalaiyum	நன்மைகளையும்	நண்மைகளையும்
nanmaiyin	நன்மையின்	நண்மையின்
nanmaiyum	நன்மையும்	நன்மையும்
nanmaiyai	நன்மையை	நன்மையை
namo	நமோ	நாம்
namoa	நமோ	நம்மா
narachimma	நரசிம்ம	நராச்மீ
narasima	நரசிம்ம	நரரசமமா
narasimma	நரசிம்ம	நரிசம்மம்
narachimmarin	நரசிம்மரின்	நராச்மீரி்ன
narasimarin	நரசிம்மரின்	நரிசமாரின்
narasimmarin	நரசிம்மரின்	நரிமமாரின்
narachimar	நரசிம்மர்	நராச்சம்
narachimmar	நரசிம்மர்	நராச்மீர்
narasimhar	நரசிம்மர்	நரிசம்்
narasimmar	நரசிம்மர்	நாரிமம்ர்
narambu	நரம்பு	நரம்பு
narampu	நரம்பு	நரம்பு
narambugalin	நரம்புகளின்	நரம்புகளின்
narambukalin	நரம்புகளின்	நரம்புகளின்
narampukalin	நரம்புகளின்	நரம்புகளின்
narambugalil	நரம்புகளில்	நரம்புகளில்
narambukalil	நரம்புகளில்	நரம்புகளில்
narampukalil	நரம்புகளில்	நரம்புகளில்
narambuth	நரம்புத்	நரம்புத்
naramputh	நரம்புத்	நரம்புத்
narmadhai	நர்மதை	நர்மததை
narmathai	நர்மதை	நர்மதத்
nalappanigal	நலப்பணிகள்	நலப்பணிகள்
nalappanikal	நலப்பணிகள்	நலப்பணிகள்
nalathu	நல்லது	நலது
nallathu	நல்லது	நல்லது
nalavan	நல்லவன்	நலவன்
nallavan	நல்லவன்	நல்லவன்
raga	நவீன	ரகக
raka	நவீன	ரகக
naveenamaana	நவீனமான	நவினமான
naagareega	நாகரீக	நாகரீக
naagareegaththin	நாகரீகத்தின்	நாகரிதத்தின்
naagarigaththin	நாகரீகத்தின்	நாகரிகத்தின்
naagareegam	நாகரீகம்	நாகரீகம்
naasaa	நாசா	நாசா
nasa	நாசா	நாசா
naashik	நாசிக்	நாஷிக்
naasik	நாசிக்	நாசிக்
naasiq	நாசிக்	நாசிக்
nashic	நாசிக்	நாசி
nashik	நாசிக்	நாஷிக்
nasic	நாசிக்	நாசிக்
nasik	நாசிக்	நாசிக்
nasiq	நாசிக்	நாசிக்
naisism	நாசிசம்	நிசிய்ஸ்
naisismm	நாசிசம்	நியஸ்ம்ம்
najism	நாசிசம்	நாஜிஸ்
nasism	நாசிசம்	நாஷி்
nazism	நாசிசம்	நாசி்
nesismm	நாசிசம்	நெசிய்ம்ம்
naadodikal	நாடோடிகள்	நாடுதிகள்
naadoodikal	நாடோடிகள்	நாடூடிகள்
nadoadigal	நாடோடிகள்	நடடடியாக்
naattavar	நாட்டவர்	நாட்டவர்
naattin	நாட்டின்	நாட்டின்
naattiyam	நாட்டியம்	நாட்டியம்
naathar	நாதர்	நாதர்
nathar	நாதர்	நாதர்
naangaam	நான்காம்	நாங்காம்
naankaam	நான்காம்	நான்காம்
naatram	நாற்றம்	நாற்றம்
naattram	நாற்றம்	நாற்றம்
naalanthaa	நாலந்தா	நாளந்தா
naalanththaa	நாலந்தா	நாழந்தா
nalanda	நாலந்தா	நலல்டன
nalantha	நாலந்தா	நலந்த
naalo	நாளோ	நாலு
nallloa	நாளோ	நல்லோ
nigalththappatta	நிகழ்த்தப்பட்ட	நிகழ்த்தப்பட்ட
nigazhththappatta	நிகழ்த்தப்பட்ட	நிகழ்த்தப்பட்ட
nikazhththappatta	நிகழ்த்தப்பட்ட	நிகழ்த்தப்பட்ட
nigalththappattu	நிகழ்த்தப்பட்டு	நிகழ்த்தப்பட்டு
nigazhththappattu	நிகழ்த்தப்பட்டு	நிகழ்த்தப்பட்டு
nikazhththappattu	நிகழ்த்தப்பட்டு	நிகழ்த்தப்பட்டு
nigalththuvathu	நிகழ்த்துவது	நிகழ்த்துவது
nigazhththuvadhu	நிகழ்த்துவது	நிகழ்த்துவது
nigazhththuvathu	நிகழ்த்துவது	நிகழ்த்துவது
nikazhththuvathu	நிகழ்த்துவது	நிகழ்த்துவது
nigalvu	நிகழ்வு	நிகழ்வு
nigazhvu	நிகழ்வு	நிகழ்வு
nikazhvu	நிகழ்வு	நிகழ்வு
nigalvugalaaga	நிகழ்வுகளாக	நிகழ்வுக்காாக
nigazhvugalaaga	நிகழ்வுகளாக	நிகழ்வுக்களாக
nigazhvugazhaaga	நிகழ்வுகளாக	நிகழ்வுக்களாக
nikazhvukalaaka	நிகழ்வுகளாக	நிகழுவுகளாக
nigalvugalilum	நிகழ்வுகளிலும்	நிகழ்வுகளிலும்
nigazhvugalilum	நிகழ்வுகளிலும்	நிகழ்வுகளிலும்
nigazhvugazhilum	நிகழ்வுகளிலும்	நிகழ்வுகளிலும்
nikazhvukalilum	நிகழ்வுகளிலும்	நிகழ்வுகளிலும்
nigalvugalil	நிகழ்வுகளில்	நிகழ்வுகளில்
nigazhvugalil	நிகழ்வுகளில்	நிகழ்வுகளில்
nigazhvugazhil	நிகழ்வுகளில்	நிகழ்வுகளில்
nikazhvukalil	நிகழ்வுகளில்	நிகழ்வுகளில்
nigalvugalukku	நிகழ்வுகளுக்கு	நிகழ்வுக்களுக்கு
nigazhvugalukku	நிகழ்வுகளுக்கு	நிகழ்வுக்களுக்கு
nigazhvugazhukku	நிகழ்வுகளுக்கு	நிகழ்வுக்களுக்கு
nikazhvukalukku	நிகழ்வுகளுக்கு	நிகழ்வுக்களுக்கு
nigalvugalukkum	நிகழ்வுகளுக்கும்	நிகழ்குக்களுக்கும
nigazhvugalukkum	நிகழ்வுகளுக்கும்	நிகழ்வுக்களுக்கும
nigazhvugazhukkum	நிகழ்வுகளுக்கும்	நிகழ்வுகளுக்கும்
nikazhvukalukkum	நிகழ்வுகளுக்கும்	நிகழ்வுகளுக்கும்
nigalvugaludan	நிகழ்வுகளுடன்	நிகழ்வுகளுடன்
nigazhvugaludan	நிகழ்வுகளுடன்	நிகழ்வுகளுடன்
nigazhvugazhudan	நிகழ்வுகளுடன்	நிகழ்வுகளுடன்
nikazhvukaludan	நிகழ்வுகளுடன்	நிகழ்வுகளுடன்
nigalvugalum	நிகழ்வுகளும்	நிகழ்வுகளும்
nigazhvugalum	நிகழ்வுகளும்	நிகழ்வுகளும்
nigazhvugazhum	நிகழ்வுகளும்	நிகழ்வுகளும்
nikazhvukalum	நிகழ்வுகளும்	நிகழ்வுகளும்
nigalvugalai	நிகழ்வுகளை	நிகழ்வுகளை
nigazhvugalai	நிகழ்வுகளை	நிகழ்வுகளை
nigazhvugazhai	நிகழ்வுகளை	நிகழ்வுகளை
nikazhvukalai	நிகழ்வுகளை	நிகழ்வுகளை
nigalvugalaich	நிகழ்வுகளைச்	நிகழ்வுக்களை
nigazhvugalaich	நிகழ்வுகளைச்	நிகழ்வுக்களை
nigazhvugazhaich	நிகழ்வுகளைச்	நிகழ்வுகளைக்
nikazhvukalaich	நிகழ்வுகளைச்	நிகழ்வுகளைக்
nigalvugal	நிகழ்வுகள்	நிகழ்வுகள்
nigazhvugal	நிகழ்வுகள்	நிகழ்வுகள்
nigazhvugazh	நிகழ்வுகள்	நிகழ்வுகள்
nikazhvukal	நிகழ்வுகள்	நிகழ்வுகள்
nigalvukku	நிகழ்வுக்கு	நிகழ்வுக்கு
nigazhvukku	நிகழ்வுக்கு	நிகழ்வுக்கு
nikazhvukku	நிகழ்வுக்கு	நிகழ்வுக்கு
nigalvukkup	நிகழ்வுக்குப்	நிகழ்வுக்குப்
nigazhvukkup	நிகழ்வுக்குப்	நிகழ்வுக்குப்
nikazhvukkup	நிகழ்வுக்குப்	நிகழ்வுக்குப்
nichayikapata	நிச்சயிக்கப்பட்ட	நிக்சியகப்பட
nichchayikkappatta	நிச்சயிக்கப்பட்ட	நிச்சயிக்கப்பட்ட
neenja	நிஞ்ஜா	நீஞ்ச
neenza	நிஞ்ஜா	நீஞ்ச
niinja	நிஞ்ஜா	நிஞ்ச
ninchjaa	நிஞ்ஜா	நிஞ்சா
ninja	நிஞ்ஜா	நிஞ்ச
ninjaa	நிஞ்ஜா	நிஞ்சா
ninza	நிஞ்ஜா	நிஞ்ச
ninzaa	நிஞ்ஜா	நிஞ்சா
nynjaa	நிஞ்ஜா	ஞஞ்சா
nynzaa	நிஞ்ஜா	நிஞ்சா
ninaivaaga	நினைவாக	நினைவாக
ninaivaaka	நினைவாக	நினைவாக
ninaivvaaga	நினைவாக	நினைவ்கவாக
ninaivaagavae	நினைவாகவே	நினைவகாவே
ninaivaagave	நினைவாகவே	நினைவாகவே
ninaivaakave	நினைவாகவே	நினைவாகவே
ninaivuchchinnam	நினைவுச்சின்னம்	நினைவுஞ்சினம்
niyamana	நியமன	நியமான
niyamanathil	நியமனத்தில்	நியமணத்தில்
niyamanaththil	நியமனத்தில்	நியமணத்தில்
niyamanatthil	நியமனத்தில்	நியமணத்தில்
niyamikapadum	நியமிக்கப்படும்	நியமிக்கப்படும்
niyamikkappadum	நியமிக்கப்படும்	நியமிக்கப்படும்
niyamikkappatum	நியமிக்கப்படும்	நியமிக்கப்படும்
niyamikavum	நியமிக்கவும்	நியமிக்கவும்
niyamikkavum	நியமிக்கவும்	நியமிக்கவும்
niyamikkum	நியமிக்கும்	நியமிக்கும்
niyamikum	நியமிக்கும்	நியமிக்கும்
nirai	நிரை	நிறை
nirvagikkappadum	நிர்வகிக்கப்படும்	நிர்வாக்கப்படுகிம்
nirvakikkappadum	நிர்வகிக்கப்படும்	நிர்வக்கப்படுகிறும
nirvagikkappattu	நிர்வகிக்கப்பட்டு	நிர்வாக்கப்பட்டி
nirvakikkappattu	நிர்வகிக்கப்பட்டு	நிர்வக்கப்பட்டிறது
nirvaagac	நிர்வாகச்	நிர்வாகக்
nirvaagach	நிர்வாகச்	நிர்வாகச்
nirvaagaththaal	நிர்வாகத்தால்	நிர்வாகத்தால்
nirvaagaththin	நிர்வாகத்தின்	நிர்வாகத்தின்
nirvaakaththin	நிர்வாகத்தின்	நிர்வாகத்தின்
nirvaagaththirku	நிர்வாகத்திற்கு	நிர்வாகத்திற்கு
nirvaagaththai	நிர்வாகத்தை	நிர்வாகத்தை
nirvaakaththai	நிர்வாகத்தை	நிர்வாகத்தை
nirvaakatthai	நிர்வாகத்தை	நிர்வாகத்தை
nirvakathai	நிர்வாகத்தை	நிர்வகத்தை
nirvaagaththaip	நிர்வாகத்தைப்	நிர்வாகத்தைப்
nirvaakaththaip	நிர்வாகத்தைப்	நிர்வாகத்தைப்
nirvaakatthaip	நிர்வாகத்தைப்	நிர்வாகத்தைப்
nirvakathaip	நிர்வாகத்தைப்	நிர்வகத்தைப்
nirvaagam	நிர்வாகம்	நிர்வாகம்
nirvaakam	நிர்வாகம்	நிர்வாகம்
nirvakam	நிர்வாகம்	நிர்வகம்
nilath	நிலத்	நிலத்
nilaththu	நிலத்து	நிலத்து
nilathu	நிலத்து	நிலது
nilatthu	நிலத்து	நிலத்து
nilaparapai	நிலப்பரப்பை	நிலப்பரபை
nilapparappai	நிலப்பரப்பை	நிலப்பரப்பை
nilainiluvaiyil	நிலுவையில்	நிலைநிலைவிலை
niluvaiyil	நிலுவையில்	நிலுவியைல்
nilainiruththi	நிலைநிறுத்தி	நிலைந்திருத்தி
neengalum	நீங்களும்	நீங்களும்
neengkalum	நீங்களும்	நீங்களும்
neengal	நீங்கள்	நீங்கள்
neengkal	நீங்கள்	நீங்கல்
neetti	நீட்டி	நீட்டி
neerilivu	நீரிழிவு	நீரிலிவு
neerizhivu	நீரிழிவு	நீரிழிவு
neeraetrtru	நீரேற்று	நேறேற்று
neeraetru	நீரேற்று	நேறேற்று
neereatru	நீரேற்று	நீரேற்று
neeraik	நீரைக்	நீரைக்
neeroatta	நீரோட்ட	நீரோட்டா
kneel	நீல்	கின்ல்
neal	நீல்	நேல்
neel	நீல்	நில்
neiil	நீல்	நெயில்
neil	நீல்	நெயில்
nel	நீல்	நெல்
niil	நீல்	நில்
nulainthavudan	நுழைந்தவுடன்	நுழந்தவுடன்
nuzhaindhavudan	நுழைந்தவுடன்	நுழந்துவன்டு
nuzhinththavudan	நுழைந்தவுடன்	நுழைந்தவுடன்
nulainthu	நுழைந்து	நுழைந்து
nuzhaindhu	நுழைந்து	நுழைந்து
nuzhinththu	நுழைந்து	நுழிந்து
noolagak	நூலகக்	நூலகக்
noolakak	நூலகக்	நூலகக்
noolagangalai	நூலகங்களை	நூலகங்களை
noolakangalai	நூலகங்களை	நூலகங்களை
noolakangkalai	நூலகங்களை	நூலகங்களை
noolangangkalai	நூலகங்களை	நூலங்கங்களை
noolagaththin	நூலகத்தின்	நூலதக்கின்
noolakaththin	நூலகத்தின்	நூலகத்தின்
noolagaththukku	நூலகத்துக்கு	நோலதக்குக்கு
noolakaththukku	நூலகத்துக்கு	நோலதக்குக்கு
noolagamaaga	நூலகமாக	நூலமகக
noolagamaaka	நூலகமாக	நூலமககக
noolakamaaga	நூலகமாக	நூலமககாக
noolakamaaka	நூலகமாக	நூலமககாக
noolagam	நூலகம்	நூலமக்
noolakam	நூலகம்	நூலமக்
noolagar	நூலகர்	நூலகர்
noolakar	நூலகர்	நூலகர்
noolaar	நூலார்	நூலார்
noolaal	நூலால்	நூலால்
noolilirundhu	நூலிலிருந்து	நூலிலிருந்து
noolilirunthu	நூலிலிருந்து	நூலிலிருந்து
negili	நெகிழி	நெகிலி
negizhi	நெகிழி	நெகிழி
negizhyi	நெகிழி	நெகிழி
nekili	நெகிழி	நெகிலி
nediya	நெடிய	நெடிய
network	நெட்வொர்க்	நெட்வொர்க்
nedharlaandhu	நெதர்லாந்து	நெதர்லாந்து
netharlaanthu	நெதர்லாந்து	நெதர்லாந்து
netherlaanththu	நெதர்லாந்து	நெதர்லாந்து
netherland	நெதர்லாந்து	நெதர்லாந்தி
netriyil	நெற்றியில்	நெற்றியில்
nettriyil	நெற்றியில்	நெற்றியில்
nel	நெல்	நெல்
nellai	நெல்லை	நெல்லை
nellaik	நெல்லைக்	நெல்லைக்
nellaip	நெல்லைப்	நெல்லைப்
naespid	நெஸ்பிட்	நேஸ்பிட்
nesbit	நெஸ்பிட்	நிஸ்பாட்
nesbitt	நெஸ்பிட்	நிஸ்பிட்ட்
naethraa	நேத்ரா	நேத்ரா
nethra	நேத்ரா	நெற்ற
neerittu	நேரிட்டு	நீரிட்டு
nerittu	நேரிட்டு	நெறிட்டு
neritu	நேரிட்டு	நெறிடு
naiirobii	நைரோபி	நையோரிப்
nairobi	நைரோபி	நைரோபி
nairoobi	நைரோபி	நைரூபி
nairoopi	நைரோபி	நைரூபி
nerobi	நைரோபி	நெரூபி
nairobiyil	நைரோபியில்	நையூரிப்பில்
nairopiyil	நைரோபியில்	நைறோப்பியில்
nokich	நோக்கிச்	நோகிக்
nokkich	நோக்கிச்	நோக்கிச்
nookkich	நோக்கிச்	நோக்கிச்
nokin	நோக்கின்	நோக்கின்
nokkin	நோக்கின்	நோக்கின்
nookkin	நோக்கின்	நோக்கின்
nokiyum	நோக்கியும்	நோக்கியும்
nokkiyum	நோக்கியும்	நோக்கியும்
nookkiyum	நோக்கியும்	நோக்கியும்
nokilum	நோக்கிலும்	நோகிலும்
nokkilum	நோக்கிலும்	நோக்கிலும்
nooyinaal	நோயினால்	நோயினால்
noyinaal	நோயினால்	நோயினால்
noyinal	நோயினால்	நோயினல்
nooyuttra	நோயுற்ற	நோயுட்ற
noyutra	நோயுற்ற	நோயுற்ற
noyuttra	நோயுற்ற	நோயுற்ற
noaiththotrukal	நோய்த்தொற்றுகள்	நோய்த்தொடுர்கள்
noayththotrugal	நோய்த்தொற்றுகள்	நோத்தொற்றுக்கள்
noiththottrugal	நோய்த்தொற்றுகள்	நிட்தொட்றொர்கள்
pagirnthuk	பகிர்ந்துக்	பகிர்ந்துக்
pakirnthuk	பகிர்ந்துக்	பகிர்ந்துக்
bhagujan	பகுஜன்	பகுசன்
pagujan	பகுஜன்	பகுஜன்
pakujan	பகுஜன்	பகுவன்
paguthiyai	பகுதியை	பகுதியை
pakuthiyai	பகுதியை	பகுதியை
paguthiyaich	பகுதியைச்	பகுதியைச்
pakuthiyaich	பகுதியைச்	பகுதியைச்
paguthiyaip	பகுதியைப்	பகுதியைப்
pakuthiyaip	பகுதியைப்	பகுதியைப்
paagoda	பகோடா	பாகோடா
paagooda	பகோடா	பாகோடா
pagoda	பகோடா	பகோத
pagodaa	பகோடா	பகோதா
pagooda	பகோடா	பகோத
pagoodaa	பகோடா	பகோதா
pagoovda	பகோடா	பகோவ்ட
pagoowda	பகோடா	பகோவத
pagovda	பகோடா	பகோவ்டா
pagowda	பகோடா	பகோதா
paguda	பகோடா	பகுு
pakoadaa	பகோடா	பகோதா
pakoda	பகோடா	பக்கோடா
pakooda	பகோடா	பக்கோ
pakootaa	பகோடா	பக்கோடா
pasukkalai	பசுக்களை	பசுக்களை
pasukkazhai	பசுக்களை	பசுக்கழை
pasukkazhil	பசுக்களை	பாசுக்களில்
padagai	படகை	படகை
padakai	படகை	படக்கை
padangalaaga	படங்களாக	படங்களாக
padangalaaka	படங்களாக	படங்களாக
padangkalaaka	படங்களாக	படங்களாக
padangalaana	படங்களான	படங்களான
padangkalaana	படங்களான	படங்களான
padangalil	படங்களில்	படங்களில்
padangkalil	படங்களில்	படங்களில்
pandangalil	படங்களில்	பண்டங்களில்
padangalukku	படங்களுக்கு	படங்களுக்கு
padangkalukku	படங்களுக்கு	படங்களுக்கு
padangalum	படங்களும்	படங்களும்
padanggalum	படங்களும்	படங்களும்
padappidippum	படப்பிடிப்பும்	படப்பிடிப்பும்
padarndha	படர்ந்த	படர்ந்த
padarntha	படர்ந்த	படர்ந்த
padalaththin	படலத்தின்	படலத்தின்
padalaththai	படலத்தை	படலத்தை
padi	படி	பாடி
padigalil	படிகளில்	படிகளில்
padikalil	படிகளில்	படிகளில்
padigalum	படிகளும்	படிகளும்
padikalum	படிகளும்	படிகளும்
padigalai	படிகளை	படிகளை
padikalai	படிகளை	படிகளை
padiththaal	படித்தால்	படித்தால்
paditthaal	படித்தால்	படித்தால்
padinilaigal	படிநிலைகள்	படினிலைகள்
padinilaikal	படிநிலைகள்	படினிலைகள்
padinilaiyil	படிநிலையில்	படினிலையில்
padippadiyaana	படிப்படியான	படிப்படியான
padipaip	படிப்பைப்	படிப்பை
padippaip	படிப்பைப்	படிப்பைப்
patippaip	படிப்பைப்	படிப்பைப்
padimangal	படிமங்கள்	படிமங்கள்
padimankal	படிமங்கள்	படிமன்கள்
patimankal	படிமங்கள்	படிமன்கள்
padimathai	படிமத்தை	படிமதை
padimaththai	படிமத்தை	படிமத்தை
padimatthai	படிமத்தை	படிமத்தை
patimatthai	படிமத்தை	படிமடைத்
padiyilum	படியிலும்	படியிலும்
patiyilum	படியிலும்	படியிலும்
paduthoalvi	படுதோல்வி	படுத்தொல்வி
padutholvi	படுதோல்வி	படுத்தொல்வி
paduthoolvi	படுதோல்வி	படுத்தொல்வி
patuthoolvi	படுதோல்வி	படுத்தொல்வி
paduthik	படுத்திக்	படுதிக்
paduththik	படுத்திக்	படுத்திக்
padutthik	படுத்திக்	படுத்திக்
patutthik	படுத்திக்	படுத்திக்
padaitha	படைத்த	படைத்த
padaiththa	படைத்த	படைத்த
padaittha	படைத்த	படைத்த
pataittha	படைத்த	படைத்த
padaithathaga	படைத்ததாக	படைத்ததாக
padaithathaka	படைத்ததாக	படைத்ததாக
padaiththathaaga	படைத்ததாக	படைத்ததாக
padaiththathaaka	படைத்ததாக	படைத்ததாக
padaitthathaaka	படைத்ததாக	படைத்ததாக
pataitthathaaka	படைத்ததாக	படைத்ததாக
padaithal	படைத்தல்	படைத்தல்
padaiththal	படைத்தல்	படைத்தல்
padaitthal	படைத்தல்	படைத்தல்
pataitthal	படைத்தல்	படைத்தல்
padaithavan	படைத்தவன்	படைத்தனன்
padaiththavan	படைத்தவன்	படைத்தவன்
padaitthavan	படைத்தவன்	படைத்தவன்
pataitthavan	படைத்தவன்	படைத்தவன்
padaithar	படைத்தார்	படைத்தர்
padaiththaar	படைத்தார்	படைத்தார்
padaitthaar	படைத்தார்	படைத்தார்
pataitthaar	படைத்தார்	படைத்தார்
padaiththullathu	படைத்துள்ளது	படைத்துள்ளது
padaithulathu	படைத்துள்ளது	படைத்துதல்
padaitthullathu	படைத்துள்ளது	படைத்துள்ளது
pataitthullathu	படைத்துள்ளது	படைத்துள்ளது
padaiththullaar	படைத்துள்ளார்	படைத்துள்ளார்
padaithular	படைத்துள்ளார்	படைத்துள்ள
padaitthullaar	படைத்துள்ளார்	படைத்துள்ளார்
pataitthullaar	படைத்துள்ளார்	படைத்துள்ளார்
padaiyani	படையணி	படையானி
pataiyani	படையணி	படையானி
padaiyanigal	படையணிகள்	படையானிகள்
padaiyanikal	படையணிகள்	படையனிகள்
pataiyanikal	படையணிகள்	படையானிகள்
padaiyinaraal	படையினரால்	படையினரால்
padaiyinaral	படையினரால்	படையினரர்
pataiyinaraal	படையினரால்	படையினார்்
padaiyinarin	படையினரின்	படையினரின்
pataiyinarin	படையினரின்	படையினரின்
padaiyinarai	படையினரை	படையினரை
padayinarai	படையினரை	படைநிரை
patayinarai	படையினரை	படையந்தி
pattaalum	பட்டாலும்	பட்டாலும்
panayam	பணயம்	பணையம்
panigalilum	பணிகளிலும்	பணிகளிலும்
panigazhilum	பணிகளிலும்	பணிகளிலும்
panigalil	பணிகளில்	பணிகளில்
panigalukkaana	பணிகளுக்கான	பணிகளுக்கான
panigazhukkaana	பணிகளுக்கான	பணிகளுக்கான
panigalaich	பணிகளைச்	பணிகளைச்
panigazhaich	பணிகளைச்	பணிகளைச்
panik	பணிக்	பனிக்
panikku	பணிக்கு	பணிக்கு
panikkum	பணிக்கும்	பணிக்கும்
panit	பணித்	பனிட்
panith	பணித்	பனித்
paniyagam	பணியகம்	பணியகம்
paniyakam	பணியகம்	பணியகம்
paniyaaga	பணியாக	பணியாக
paniyaaka	பணியாக	பணியாக
paniyaalarin	பணியாளரின்	பணியாளரின்
paniyil	பணியில்	பனியில்
paniyaiyum	பணியையும்	பணியையும்
panivum	பணிவும்	பணிவும்
panbaadugalil	பண்பாடுகளில்	பண்பாடுகளில்
panpaadugalil	பண்பாடுகளில்	பண்பாடுகளில்
panpaadugazhil	பண்பாடுகளில்	பன்பாடுகளில்
panpaadukalil	பண்பாடுகளில்	பண்பாடுகளில்
panbadugalai	பண்பாடுகளை	பன்படுகளை
panpaadugalai	பண்பாடுகளை	பன்பாடுகளை
panpaadugazhai	பண்பாடுகளை	பன்பாடுகளை
panpaadukalai	பண்பாடுகளை	பன்பாடுகளை
panbaadugal	பண்பாடுகள்	பண்பாடுகள்
panpaadugal	பண்பாடுகள்	பண்பாடுகள்
panpaadukal	பண்பாடுகள்	பண்பாடுகள்
panbaana	பண்பான	பண்பான
padhikka	பதிக்க	பதிக்க
pathikka	பதிக்க	பதிக்க
keelkkanakku	பதினெண்	கீழ்க்கங்கு
keezhkkanakku	பதினெண்	கீழ்க்கங்கு
kilkkanakku	பதினெண்	கிள்கங்ககு
padhinoaru	பதினோரு	பதினொரு
pathinoaru	பதினோரு	பதினொரு
padhipiththaar	பதிப்பித்தார்	பதிபித்தார்
pathippiththaar	பதிப்பித்தார்	பதிப்பித்தார்
pathippitthaar	பதிப்பித்தார்	பதிப்பித்தார்
padhipiththu	பதிப்பித்து	பதிிப்து
pathippiththu	பதிப்பித்து	பதிப்பித்து
pathippitthu	பதிப்பித்து	பதிப்பித்து
bathilaliththaan	பதிலளித்தான்	பதிலிழத்தான்
pathilaliththaan	பதிலளித்தான்	பதிலிலத்தான்
bathilaliththaar	பதிலளித்தார்	பதிலிழத்தார்
pathilaliththaar	பதிலளித்தார்	பதிலதில்தார்
paththaandugalukku	பத்தாண்டுகளுக்கு	பத்தான்டுகளுக்கு
paththaandukalukku	பத்தாண்டுகளுக்கு	பத்தான்டுகளுக்கு
paththandukalukku	பத்தாண்டுகளுக்கு	பத்தன்டுகளுக்கு
paththaandugalukkum	பத்தாண்டுகளுக்கும்	பத்தான்டுக்களும்
paththaandukalukkum	பத்தாண்டுகளுக்கும்	பத்தான்டுக்களும்
paththin	பத்தின்	பத்தின்
paththo	பத்தோ	பத்தோ
paththoa	பத்தோ	பத்தோ
padmanaaba	பத்மநாப	பட்மனமான
pathmanaaba	பத்மநாப	பத்மன்பான
pathmanaapa	பத்மநாப	பத்மனமான
pandhi	பந்தி	பந்தி
panthi	பந்தி	பந்தி
panththi	பந்தி	பந்தி
pandrikku	பன்றிக்கு	பன்றிக்கு
panrikku	பன்றிக்கு	பன்றிக்கு
payanitha	பயணித்த	பயனித
payaniththa	பயணித்த	பயனித்த
payanithar	பயணித்தார்	பயனித்தார்
payaniththaar	பயணித்தார்	பயனித்தார்
payirgalaana	பயிர்களான	பயிற்களான
payirkalaana	பயிர்களான	பயிற்களான
payirgalai	பயிர்களை	பயிற்களை
payirkalai	பயிர்களை	பயிற்களை
paiyrkalaiyum	பயிர்களையும்	பைர்களையும்
payirgalaiyum	பயிர்களையும்	பயிற்களையும்
payirkalaiyum	பயிர்களையும்	பயிற்களையும்
paiyrkal	பயிர்கள்	பைர்க்க
payirkal	பயிர்கள்	பயிற்கள்
parappalavil	பரப்பளவில்	பரப்பளவில்
parappazhavil	பரப்பளவில்	பரப்பழவில்
parappuraigal	பரப்புரைகள்	பரப்புறைகள்
parappuraikal	பரப்புரைகள்	பரப்புறைகள்
parchinai	பரிசினை	பார்சினை
parichinai	பரிசினை	பரிசினை
parisinai	பரிசினை	பரிசினை
parindhuraikka	பரிந்துரைக்க	பரிந்துரைக்க
parinthuraikka	பரிந்துரைக்க	பரிந்துரைக்க
parindhuraikkappadum	பரிந்துரைக்கப்படும்	பரிந்துரைக்கப்படும்
parinthuraikkappadum	பரிந்துரைக்கப்படும்	பரிந்துரைக்கப்படும்
parinthuraikkappatum	பரிந்துரைக்கப்படும்	பரிந்துரைக்கப்படும்
parindhuraikkum	பரிந்துரைக்கும்	பரிந்துரைக்கும்
parinththuraikkum	பரிந்துரைக்கும்	பரிந்துரைக்கும்
parinthuraikkum	பரிந்துரைக்கும்	பரிந்துரைக்கும்
parimaatra	பரிமாற்ற	பரிமாற்ற
parimaattra	பரிமாற்ற	பரிமாற்ற
parimaatrangalai	பரிமாற்றங்களை	பரிமாற்றங்களை
parimaatrangkalai	பரிமாற்றங்களை	பரிமாற்றங்களை
parimaattrangalai	பரிமாற்றங்களை	பரிமாற்றங்களை
parimaattrankalai	பரிமாற்றங்களை	பரிமாற்றங்களை
parimaatrangal	பரிமாற்றங்கள்	பரிமாற்றங்கள்
parimaatrangkal	பரிமாற்றங்கள்	பரிமாற்றங்கள்
parimaattrangal	பரிமாற்றங்கள்	பரிமாற்றங்கள்
parimaattrangalai	பரிமாற்றங்கள்	பரிமாற்றங்களை
parimaattrankal	பரிமாற்றங்கள்	பரிமாற்றங்கள்
parimaattrankalai	பரிமாற்றங்கள்	பரிமாற்றங்களை
parimaatraththin	பரிமாற்றத்தின்	பரிமாற்றத்தின்
parimaattraththin	பரிமாற்றத்தின்	பரிமாற்றத்தின்
parimaatram	பரிமாற்றம்	பரிமாற்றம்
parimaattram	பரிமாற்றம்	பரிமாற்றம்
barma	பர்மா	பர்மா
barmaa	பர்மா	பர்மா
berma	பர்மா	பெர்மா
burma	பர்மா	பர்மா
burmaa	பர்மா	பர்மா
buurma	பர்மா	பர்மா
buurmaa	பர்மா	பூர்மா
parma	பர்மா	பர்மா
parmaa	பர்மா	பர்மா
barmaavin	பர்மாவின்	பார்மாவின்
burmaavin	பர்மாவின்	புர்மாவின்
burmavin	பர்மாவின்	புர்மவின்
parmaavin	பர்மாவின்	பர்மாவின்
barmaavil	பர்மாவில்	பர்மாவில்
burmaavil	பர்மாவில்	பூர்மாவில்
burmavil	பர்மாவில்	பூர்மவில்
parmaavil	பர்மாவில்	பர்மாவில்
parmavil	பர்மாவில்	பர்மவில்
parappathu	பறப்பது	பரப்பது
parra	பற்ற	பற்ற
patra	பற்ற	பற்ற
patrra	பற்ற	வற்ற
pattra	பற்ற	வற்ற
patraamal	பற்றாமல்	பற்றாமல்
patrraamal	பற்றாமல்	பற்றாமல்
pattraamal	பற்றாமல்	பற்றாமல்
patrinaal	பற்றினால்	பற்றினால்
pattrinaal	பற்றினால்	பற்றினால்
parrulla	பற்றுள்ள	பற்றுள்ள
patrulla	பற்றுள்ள	பற்றுள்ள
pattrulla	பற்றுள்ள	பற்றுள்ள
palagai	பலகை	பலகை
palakai	பலகை	பலகை
palagaigalil	பலகைகளில்	பலைகளைகளில்
palagaikalil	பலகைகளில்	பலைகளைகளில்
palakaikalil	பலகைகளில்	பலகைகளில்
palakaiyil	பலகைகளில்	பலகையில்
palacharakku	பலசரக்கு	பலலச்சகரு
palasarakku	பலசரக்கு	பலலசர்கு
balanaaga	பலனாக	பலனாக
balanaaka	பலனாக	பலனாக
palanaaga	பலனாக	பலனாக
palanaaka	பலனாக	பலனாக
palavarrilum	பலவற்றிலும்	பலவற்றிலும்
palavatrilum	பலவற்றிலும்	பலவற்றிலும்
palavatrrilum	பலவற்றிலும்	பலவற்றிலும்
palavattrilum	பலவற்றிலும்	பலவற்றிலும்
pallakku	பல்லக்கு	பல்லக்கு
pallavar	பல்லவர்	பல்லவர்
pallavargalin	பல்லவர்களின்	பல்லவர்களின்
pallavargazhin	பல்லவர்களின்	பல்லவர்களின்
pallina	பல்லின	பல்லினா
pavudar	பவுடர்	பவுடர்
povder	பவுடர்	பவர்டர்
powdar	பவுடர்	பவட்டர்
powder	பவுடர்	பவரட்
pavurnami	பவுர்ணமி	பவர்ந்மி
pournami	பவுர்ணமி	பௌர்நாமி
pauli	பவுலி	பாலி
paulii	பவுலி	பாலி
pauuli	பவுலி	பாலி
pavuli	பவுலி	பவுலி
bowlin	பவுலின்	பாலின்
pavulin	பவுலின்	பவுலின்
paagupaadugal	பாகுபாடுகள்	பாகுபாடுகள்
paakupaadukal	பாகுபாடுகள்	பாகுபாடுகள்
paadalilum	பாடலிலும்	பாடலிலும்
paatalilum	பாடலிலும்	பாடலிலும்
paandavar	பாண்டவர்	பாண்டவர்
paantavar	பாண்டவர்	பாண்டவர்
pandavar	பாண்டவர்	பண்டவர்
paandavargalin	பாண்டவர்களின்	பாண்டவர்களின்
paandavarkalin	பாண்டவர்களின்	பாண்டவர்களின்
paantavarkalin	பாண்டவர்களின்	பாண்டவர்களின்
pandavargalin	பாண்டவர்களின்	பண்டவர்களின்
paandavargalukku	பாண்டவர்களுக்கு	பாண்டவர்களுக்கு
paandavarkalukku	பாண்டவர்களுக்கு	பாண்டவர்களுக்கு
paantavarkalukku	பாண்டவர்களுக்கு	பாண்டவர்களுக்கு
pandavargalukku	பாண்டவர்களுக்கு	பண்டவர்களுக்கு
paathagamaaka	பாதகமாக	பாதகமாக
paathakamaaka	பாதகமாக	பாதகமாக
paathaagamaana	பாதகமான	பாதாகமான
paathaakamaana	பாதகமான	பாதாகமான
paathagamaana	பாதகமான	பாதகமான
paathakamaana	பாதகமான	பாதகமான
paadhi	பாதி	பாதி
paathi	பாதி	பாதி
baathiththu	பாதித்து	பாதித்து
paathiththu	பாதித்து	பாதித்து
paadhiyei	பாதியை	பாதியை
paathiyai	பாதியை	பாதியை
baathaikalil	பாதைகளில்	பாதைகளில்
paathaikalil	பாதைகளில்	பாதைகளில்
baathaikalaiyum	பாதைகளையும்	பாதைகளையும்
paathaikalaiyum	பாதைகளையும்	பாதைகளையும்
baathaikal	பாதைகள்	பாதைகள்
paathaikal	பாதைகள்	பாதைகள்
baathaiyaaka	பாதையாக	பாதையாக
paathaiyaaka	பாதையாக	பாதையாக
paathaiyin	பாதையின்	பாதையின்
baathaiyilirinthu	பாதையிலிருந்து	பாதியிலிருந்து
paathaiyilirinthu	பாதையிலிருந்து	பாதியிலிருந்து
paathaiyilirunththu	பாதையிலிருந்து	பாதையிலிருந்து
paathaiyilirunthu	பாதையிலிருந்து	பாதையிலிருந்து
paathaiyum	பாதையும்	பாதையும்
bath	பாத்	பத்
beth	பாத்	பெத்
pat	பாத்	பேட்
baanarji	பானர்ஜி	பானர்ஜி
banerji	பானர்ஜி	பஞ்சரி
paanarji	பானர்ஜி	பான்ரி
baaba	பாபா	பாபா
baabaa	பாபா	பாபா
baba	பாபா	பாபா
babaa	பாபா	பபா
baabpaa	பாப்பா	பாப்பா
paapa	பாப்பா	பாப
paappaa	பாப்பா	பாப்பா
papa	பாப்பா	பாப
papaa	பாப்பா	பபா
pappa	பாப்பா	பப்பா
paamban	பாம்பன்	பாம்பன்
paampan	பாம்பன்	பாம்பன்
paaraattappatta	பாராட்டப்பட்ட	பாராட்டப்பட்ட
paaris	பாரிஸ்	பாரிஸ்
paeris	பாரிஸ்	பேரிஸ்
pariis	பாரிஸ்	பிரேஸ்
paris	பாரிஸ்	பிரிஸ்
pariss	பாரிஸ்	பிரிஸ்
paarungal	பாருங்கள்	பாருங்கள்
paarungkal	பாருங்கள்	பாருங்கள்
paarunkal	பாருங்கள்	பாருங்கள்
baalan	பாலன்	பாலன்
baillon	பாலன்	பாலின்
bailon	பாலன்	பாலன்
bailun	பாலன்	பாலின்
bailuun	பாலன்	பாலின்
balan	பாலன்	பாலன்
ballon	பாலன்	பாலன்
balon	பாலன்	பாலன்
bellon	பாலன்	பெல்லின்
belun	பாலன்	பெலன்
paalan	பாலன்	பாலன்
palan	பாலன்	பலன்
baalu	பாலு	பாலு
balu	பாலு	பாலு
paalu	பாலு	பாலு
balaiya	பாலையா	பலைய
paalaiyaa	பாலையா	பாலையா
bhaavangalai	பாவங்களை	பாவங்களை
paavangalai	பாவங்களை	பாவங்களை
paavangkalai	பாவங்களை	பாவங்களை
paavankalai	பாவங்களை	பாவங்களை
paavaththin	பாவத்தின்	பாவத்தின்
paavaththai	பாவத்தை	பாவத்தை
bhaavaththaith	பாவத்தைத்	பாவத்தைத்
paavaththaith	பாவத்தைத்	பாவத்தைத்
baavanaigal	பாவனைகள்	பாவனைகள்
bhaavanaigal	பாவனைகள்	பாவனைகள்
paavanaikal	பாவனைகள்	பாவனைகள்
paavam	பாவம்	பாவம்
pavam	பாவம்	பவம்
paavai	பாவை	பாவை
baav	பாவ்	பாவ்
paav	பாவ்	பாவ்
pav	பாவ்	பாவ்
piggu	பிக்கு	பிக்கு
pikku	பிக்கு	பிக்கு
bjb	பிஜேபி	பிப்
bjp	பிஜேபி	பிப்
pidyuuddari	பிட்யூட்டரி	பிடிட்டுரிய
pituitari	பிட்யூட்டரி	பிட்டுடியா
pituitarii	பிட்யூட்டரி	பிடுட்டியை
pituitary	பிட்யூட்டரி	பிட்டுடியர்
pitutari	பிட்யூட்டரி	பிட்டுடி
pitutary	பிட்யூட்டரி	பிட்டுடர்
pituuitarii	பிட்யூட்டரி	பிட்டுட்யி
pituuitary	பிட்யூட்டரி	பிட்ட்ட்யா
pituutary	பிட்யூட்டரி	பிட்ட்ட்டா
piththu	பித்து	பித்து
pinburaththil	பின்புறத்தில்	பின்புறத்தில்
pinpuraththil	பின்புறத்தில்	பின்புறத்தில்
pinburamulla	பின்புறமுள்ள	பின்புறுமல்ல
pinpuramulla	பின்புறமுள்ள	பின்புறுமல்ல
pinburam	பின்புறம்	பின்புரம்
pinpuram	பின்புறம்	பின்புறம்
binvaangi	பின்வாங்கி	பின்வாங்கி
binvaangki	பின்வாங்கி	பின்வாங்கி
pinvaangi	பின்வாங்கி	பின்வாங்கி
pinvaangki	பின்வாங்கி	பின்வாங்கி
pee	பியா	பி
peea	பியா	பீ
peeia	பியா	பீய்
peeya	பியா	பீய்
pia	பியா	பியா
piaa	பியா	பியா
piia	பியா	பியா
piiaa	பியா	பியா
piiya	பியா	பியா
piya	பியா	பியா
piyaa	பியா	பியா
pirachurankalai	பிரசுரங்களை	பிரசுரங்களை
pirasurangalai	பிரசுரங்களை	பிரசுரங்களை
pirasurangkalai	பிரசுரங்களை	பிரசுரங்களை
prachurankalai	பிரசுரங்களை	பிரசுருங்களை
pirachuramaanathu	பிரசுரமானது	பிரசுரமானது
pirasuramaanathu	பிரசுரமானது	பிரசுரமானது
prachuramaanathu	பிரசுரமானது	பிரசுரமுரந்த
prasuramaanathu	பிரசுரமானது	பிரசுராமானது
piradhaana	பிரதான	பிரதான
pirathaana	பிரதான	பிரதான
piradhaani	பிரதானி	பிராதனி
pirathaani	பிரதானி	பிராதனி
piraththyeaga	பிரத்யேக	பிரத்தியாக
pirathyaeka	பிரத்யேக	பிரத்தியாக
praththiyaeka	பிரத்யேக	பிரத்தியாக
bhrammatthin	பிரம்மத்தின்	பிரம்மத்தின்
biramatthin	பிரம்மத்தின்	பிரமமத்தின்
pirammaththin	பிரம்மத்தின்	பிரம்மத்தின்
brammanin	பிரம்மனின்	பிரம்மணின்
pirammanin	பிரம்மனின்	பிரம்மணின்
brammanukku	பிரம்மனுக்கு	பிரம்முக்கு
pirammanukku	பிரம்மனுக்கு	பிரம்முனக்கு
brahaman	பிரம்மன்	பிராமண்
brahamann	பிரம்மன்	பிராமண்்
brahhman	பிரம்மன்	பிராம்பன்
brahman	பிரம்மன்	பிராம்மன்
brahmun	பிரம்மன்	பிராமண்
brahmuun	பிரம்மன்	பிராமண்
bramman	பிரம்மன்	பிரம்மன்
piramman	பிரம்மன்	பிரம்மம்
brush	பிரஷ்	பிரஸ்
fresh	பிரஷ்	பிரேஷ்
pirash	பிரஷ்	பிரஸ்
prash	பிரஷ்	பிரஸ்
braamanar	பிராமணர்	பிராமண்்
piraamanar	பிராமணர்	பிராமணர்
praamanar	பிராமணர்	பிராமணர்
braamanargal	பிராமணர்கள்	பிராமண்றகள்
braamanarkal	பிராமணர்கள்	பிராமண்்கள்
piraamanarkal	பிராமணர்கள்	பிராமணர்கள்
praamanarkal	பிராமணர்கள்	பிராமண்றகள்
pirithadhu	பிரித்தது	பிரித்தது
piriththathu	பிரித்தது	பிரித்தது
priththathu	பிரித்தது	பிரித்தது
parant	பிறந்த	பரண்ட்
perant	பிறந்த	பெரண்ட்
piaanta	பிறந்த	பியாண்டா
piraant	பிறந்த	பிராண்ட்
pirandha	பிறந்த	பிரந்த
piranta	பிறந்த	பிரண்ட
pirantha	பிறந்த	பிரந்த
pirandhadhum	பிறந்ததும்	பிறந்ததும்
piranthathum	பிறந்ததும்	பிறந்ததும்
pirandhadhai	பிறந்ததை	பிரந்ததை
piranthathai	பிறந்ததை	பிறந்ததை
pirandhavan	பிறந்தவன்	பிறந்தனவ்
piranthavan	பிறந்தவன்	பிறந்தவன்
piranthaan	பிறந்தான்	பிரந்தான்
piranthaalum	பிறந்தாலும்	பிறந்தாலும்
piranthaal	பிறந்தால்	பிறந்தால்
pirarin	பிறரின்	பிராரின்
pirarum	பிறரும்	பிரறும்
pirarai	பிறரை	பிராரை
piravum	பிறவும்	பிரவும்
pirgaalach	பிற்காலச்	பிர்காலச்
pirkaalach	பிற்காலச்	பிர்காலச்
pirgaalaththil	பிற்காலத்தில்	பிர்காலத்தில்
pirkaalaththil	பிற்காலத்தில்	பிர்காலத்தில்
pirpaguthi	பிற்பகுதி	பிற்பகுதி
pirpakuthi	பிற்பகுதி	பிற்பகுதி
pirpaguthiyil	பிற்பகுதியில்	பிற்பகுதியில்
pirpakuthiyil	பிற்பகுதியில்	பிற்பகுதியில்
filipinej	பிலிப்பைன்ஸ்	பிலைபின்
filipines	பிலிப்பைன்ஸ்	பிலிபினிஸ்
filipinez	பிலிப்பைன்ஸ்	பிலிபின்ஸி
filippines	பிலிப்பைன்ஸ்	பிலிபிப்ஸிங்
fillipinnez	பிலிப்பைன்ஸ்	பிலில்பின்
philipines	பிலிப்பைன்ஸ்	பிலிபினிஸ்
philipinez	பிலிப்பைன்ஸ்	பிலிபின்ன்
philipinnez	பிலிப்பைன்ஸ்	பிலிபின்ஸ்
philippines	பிலிப்பைன்ஸ்	பிலிபிப்ஸிங்
phillipinez	பிலிப்பைன்ஸ்	பிலிபில்னி
phillipinnej	பிலிப்பைன்ஸ்	பில்லிபிங்
phillipinnez	பிலிப்பைன்ஸ்	பிலிப்லின்பி
pilippains	பிலிப்பைன்ஸ்	பிளிப்பினைன்
pilaikkum	பிழைக்கும்	பிளைக்கும்
pizhaikkum	பிழைக்கும்	பிழைக்கும்
pilaiyaana	பிழையான	பிளையான
pizhaiyaana	பிழையான	பிழையான
bisinas	பிஸினஸ்	பிசனிஸ்
business	பிஸினஸ்	பிசினஸ்
pisinas	பிஸினஸ்	பிசினஸ்
beach	பீச்	பேக்
beaich	பீச்	பேய்
beaych	பீச்	பேய்
bech	பீச்	பிக்
beech	பீச்	பிக்
beechh	பீச்	பீக்
beich	பீச்	பேக்
beiich	பீச்	பேக்
beych	பீச்	பிக்
bichh	பீச்	பிக்
biich	பீச்	பிக்
biichh	பீச்	பிக்
peach	பீச்	பேக்
pech	பீச்	பேக்
peech	பீச்	பிக்
pich	பீச்	பிக்
piich	பீச்	பிக்
fees	பீஸ்	பிஸ்
peace	பீஸ்	பேக்
peas	பீஸ்	பேஸ்
pees	பீஸ்	பிஸ்
peice	பீஸ்	பெக்
piece	பீஸ்	பிக்
pugalpetrtrathu	புகழ்பெற்றது	புகல்பெற்றது
pukalpetrtrathu	புகழ்பெற்றது	புகல்பேற்றது
pukalpettrathu	புகழ்பெற்றது	புகல்பெற்றது
pukazhpetrathu	புகழ்பெற்றது	புகழ்ப்பிற்றது
pukazhpettrathu	புகழ்பெற்றது	புகழ்பிட்டரு
pugalpetrtravar	புகழ்பெற்றவர்	புகல்பெற்றவர்
pukalpetrtravar	புகழ்பெற்றவர்	புகல்பெற்றவர்
pukalpettravar	புகழ்பெற்றவர்	புகல்பெற்றவர்
pukazhpetravar	புகழ்பெற்றவர்	புகழ்ப்பேர்வர்
pukazhpettravar	புகழ்பெற்றவர்	புகழ்ப்பேர்வர்
pugalpetrtru	புகழ்பெற்று	புகழ்ப்ற்று
pukalpetrtru	புகழ்பெற்று	புகழ்ப்ற்ற்று
pukalpettru	புகழ்பெற்று	புகல்பெற்று
pukazhpetru	புகழ்பெற்று	புகழ்ப்பேற்று
pukazhpettru	புகழ்பெற்று	புகழ்ப்பேற்று
bookhari	புகாரி	பூக்ரி
bookharii	புகாரி	பூகாரி
booqhari	புகாரி	பூக்ரி
bukhaari	புகாரி	புகாரி
bukhaarii	புகாரி	புகாரி
bukhari	புகாரி	புகரி
bukharii	புகாரி	புகரி
buqhaari	புகாரி	புகாரி
buqhari	புகாரி	புகரரி
buqharii	புகாரி	புகர்ி
buukhaari	புகாரி	புகாரி
buukhari	புகாரி	பூகரி
buukharii	புகாரி	புகரி
pokaari	புகாரி	போக்காரி
pugaari	புகாரி	புகாரி
pukaari	புகாரி	புகாரி
pukari	புகாரி	புகரி
pujangal	புஜங்கள்	புஜங்கள்
pujankal	புஜங்கள்	புஜங்கள்
puduchcheariyin	புதுச்சேரியின்	புடுச்சேளியின்
puthuchchaeriyin	புதுச்சேரியின்	புதுச்சேரியின்
puthucheri	புதுச்சேரியின்	புதுசேரி
padanggalil	புதுப்	படங்களில்
padankalil	புதுப்	படங்களில்
patankalil	புதுப்	படங்களில்
pudhumaiyaana	புதுமையான	புதுமையான
puthumaiyaana	புதுமையான	புதுமையான
pudhuvai	புதுவை	புதுவை
puthuvai	புதுவை	புதுவை
pudhaiththa	புதைத்த	புதைத்த
puthaiththa	புதைத்த	புதைத்த
buddha	புத்த	புத்த
budhdha	புத்த	புத்த
buththa	புத்த	புத்த
puththa	புத்த	புத்த
puththam	புத்தம்	புத்தம்
buddharukku	புத்தருக்கு	புத்தருக்கு
budhdharukku	புத்தருக்கு	புத்தருக்கு
buththarukku	புத்தருக்கு	புத்தருக்கு
puththaandu	புத்தாண்டு	புத்தாண்டு
punarvaalvu	புனர்வாழ்வு	புன்றாவ்ல்லு
punarvaazhvu	புனர்வாழ்வு	புன்வார்வுழு
punidhargalin	புனிதர்களின்	புனிதர்களின்
punitharkalin	புனிதர்களின்	புனிதர்களின்
punae	புனே	புணே
pune	புனே	புணே
punea	புனே	புணே
punee	புனே	புனே
punii	புனே	புனி
puune	புனே	பூண்
puunee	புனே	பூணே
punaeyil	புனேயில்	புனேயில்
puneayil	புனேயில்	புணியில்
puneiyl	புனேயில்	புனையில்
puneyil	புனேயில்	புணியில்
punaevil	புனேவில்	புனேவில்
puneavil	புனேவில்	புனிவேல்
punevil	புனேவில்	புனேவில்
ciripputan	புன்	சிறிப்புடன்
pan	புன்	பான்
pon	புன்	பான்
pun	புன்	புண்
puun	புன்	பூன்
sirippudan	புன்	சிறிப்புடன்
purandu	புரண்டு	புறந்து
puravi	புரவி	புரவி
kollaa	புரிந்து	கொல்லா
kollaalaam	புரிந்து	கொள்ளலாம்
kollaatha	புரிந்து	கொல்லாத
kollaavum	புரிந்து	கொள்ளாவும்
kollalaam	புரிந்து	கொள்ளலாம்
kollalam	புரிந்து	கொள்ளலாம்
kollata	புரிந்து	கொள்ளத
kollavum	புரிந்து	கொள்ளவும்
puribavargal	புரிபவர்கள்	புறிபவர்கள்
puriyum	புரியும்	பூரியும்
purivadhai	புரிவதை	புரிவதை
purivathai	புரிவதை	புறிவதை
puruva	புருவ	புருவ
puruvam	புருவம்	புறுவம்
pulampeyar	புலம்பெயர்	புலம்பெயர்
pulavargalaal	புலவர்களால்	புலவர்களால்
pulavarkalaal	புலவர்களால்	புலவர்களால்
pulavargalin	புலவர்களின்	புலவர்களின்
pulavarkalin	புலவர்களின்	புலவர்களின்
pulavargalil	புலவர்களில்	புலவர்களில்
pulavarkalil	புலவர்களில்	புலவர்களில்
pulavargalukku	புலவர்களுக்கு	புலவர்களுக்கு
pulavarkalukku	புலவர்களுக்கு	புலவர்களுக்கு
pulavargalum	புலவர்களும்	புலவர்களும்
pulavarkalum	புலவர்களும்	புலவர்களும்
bulet	புல்லட்	பால்ட்
bullat	புல்லட்	புல்ட்
bullet	புல்லட்	பலலட்
buulet	புல்லட்	பால்ட்
buullet	புல்லட்	பால்டி
pullad	புல்லட்	புல்டல்
pullat	புல்லட்	புல்
blue	புளூ	ப்ளை
puloo	புளூ	புலோ
puluu	புளூ	புலு
puvikku	புவிக்கு	புவிக்கு
puviyin	புவியின்	புவியின்
puviyil	புவியில்	புவியில்
bushkar	புஷ்கர்	புஷ்கர்
pushkar	புஷ்கர்	புஷ்கர்
puskar	புஷ்கர்	புஸ்கர்
pusqar	புஷ்கர்	புஸ்கர்
puuskar	புஷ்கர்	பூஸ்கர்
pooshkin	புஷ்கின்	பூஷ்கின்
pooskin	புஷ்கின்	பூஸ்கின்
poosqin	புஷ்கின்	போஸ்கின்
pushkeen	புஷ்கின்	புஷ்கீன்
pushkin	புஷ்கின்	புஷ்கின்
pushkinn	புஷ்கின்	புஷ்கின்
puskeen	புஷ்கின்	புஸ்கின்
puskiin	புஷ்கின்	புஸ்கின்
puskin	புஷ்கின்	புஸ்கின்
puskinn	புஷ்கின்	புஸ்கின்
pusqeen	புஷ்கின்	புக்கின்
pusqin	புஷ்கின்	புஸ்கின்
pusqinn	புஷ்கின்	புக்ஸின்
puuskeen	புஷ்கின்	புக்கின்
puuskin	புஷ்கின்	பூஸ்கின்
puuskinn	புஷ்கின்	பூஸ்கின்
bookambam	பூகம்பம்	பூக்மம்
poogambam	பூகம்பம்	பூகம்பம்
pookambam	பூகம்பம்	பூக்மம்
puukambam	பூகம்பம்	பூகம்பம்
puukampam	பூகம்பம்	பூகம்பம்
poojya	பூஜ்ய	பூஜ்யா
puujya	பூஜ்ய	பூச்ய
poojyam	பூஜ்யம்	பூஜ்யம்
puujiyam	பூஜ்யம்	பூஜியம்
puujyam	பூஜ்யம்	பூச்யம்
poonagari	பூநகரி	பூணகரி
poonakari	பூநகரி	பூணகரி
puunagari	பூநகரி	பூணகிர
puunakari	பூநகரி	பூணகரி
poonaigalai	பூனைகளை	பூணைகளை
poonaikalai	பூனைகளை	பூணைகளை
puunaigalai	பூனைகளை	பூணைகளை
puunaikalai	பூனைகளை	பூணைகளை
poonaigal	பூனைகள்	பூணைகள்
poonaikal	பூனைகள்	பூணைகள்
puunaigal	பூனைகள்	பூணைகள்
puunaikal	பூனைகள்	பூணைகள்
poonaiyai	பூனையை	பூனையை
poonaiyei	பூனையை	பூனையை
poorna	பூர்ணா	பூர்னா
poornaa	பூர்ணா	பூர்னா
puurnaa	பூர்ணா	பூர்னா
poolae	பூலே	பூலை
puulae	பூலே	பூல்
poolai	பூளை	பூலை
puulai	பூளை	பூலை
pennukku	பெண்ணுக்கு	பெண்ணுக்கு
pennnudan	பெண்ணுடன்	பெண்ணுடன்
pennudan	பெண்ணுடன்	பெண்ணுடன்
pennum	பெண்ணும்	பெண்ணும்
penmani	பெண்மணி	பெண்மானி
penmanigal	பெண்மணிகள்	பெண்மானிகள்
penmanikal	பெண்மணிகள்	பெண்மானிகள்
penmaniyaaga	பெண்மணியாக	பென்மானியாக
penmaniyaaka	பெண்மணியாக	பென்மானியாக
penmaniyin	பெண்மணியின்	பென்மானியின்
penmaniyum	பெண்மணியும்	பென்மானியும்
peyarum	பெயரும்	பெயரும்
peyarchchi	பெயர்ச்சி	பெயர்ச்சி
periyavan	பெரியவன்	பெரியவன்
periyavar	பெரியவர்	பெரியவர்
periyavargalukku	பெரியவர்களுக்கு	பெரியவர்களுக்கு
periyavargal	பெரியவர்கள்	பெரியவர்கள்
periyavai	பெரியவை	பெரியவை
periyoar	பெரியோர்	பெரியோர்
periyor	பெரியோர்	பெரியோர்
perugiya	பெருகிய	பெருகிய
perukiya	பெருகிய	பெறுகிய
perumidham	பெருமிதம்	பெருமிமம்
perumitham	பெருமிதம்	பெருமிதம்
bart	பெர்ட்	பார்ட்
bert	பெர்ட்	பெர்ட்
paerd	பெர்ட்	பெர்ட்
bay	பே	பாய்
bee	பே	பி
beei	பே	பி
bei	பே	பே
beii	பே	பே
faie	பே	பாய்
faye	பே	பாய்
fayee	பே	பாய்
pee	பே	பி
phaye	பே	பாய்
paechupavar	பேசுபவர்	பேசுபவர்
paesubavar	பேசுபவர்	பேசுபவர்
pesupavar	பேசுபவர்	பேசுபவர்
paenalgal	பேனல்கள்	பேனல்கள்
paenalkal	பேனல்கள்	பேண்லக்கள்
peanalkal	பேனல்கள்	பேணல்கள்
penalkal	பேனல்கள்	பெண்ளல்கள்
paep	பேப்	பேப்
pap	பேப்	பாப்
peap	பேப்	பேப்
peep	பேப்	பீப்
pep	பேப்	பெப்
bearaasiriyarin	பேராசிரியரின்	பேராசிரியரின்
paeraasiriyarin	பேராசிரியரின்	பேராசிரியரின்
pearaasiriyarin	பேராசிரியரின்	பேராசிரியரின்
paerunthil	பேருந்தில்	பேருந்தில்
pearunthil	பேருந்தில்	பேருந்தில்
perunthil	பேருந்தில்	பெருந்தில்
beal	பேல்	பேல்
bel	பேல்	பெல்
pael	பேல்	பேல்
pel	பேல்	பெல்
bealai	பேழை	பேலை
paelai	பேழை	பேலை
pelai	பேழை	பேலை
pezhai	பேழை	பேழை
paelaiyil	பேழையில்	பேலையில்
paezhaiyil	பேழையில்	பேழையில்
pezhaiyil	பேழையில்	பேழையில்
paigalai	பைகளை	பைகளை
paikalai	பைகளை	பைக்கலை
podhunala	பொதுநல	பொதுநல
pothunala	பொதுநல	பொதுநல
podhuvudamai	பொதுவுடமை	பொதுவுடமை
pothuvudamai	பொதுவுடமை	பொதுவுடமை
ponnai	பொன்னை	பொன்னை
pori	பொரி	போரி
porikkum	பொரிக்கும்	போரிக்கும்
poriththa	பொரித்த	பொரித்த
ubayoagangkal	பொருட்கள்	உபயோகங்கள்
ubayoakangkal	பொருட்கள்	உபயோகங்கள்
upayokankal	பொருட்கள்	உபயோகங்கள்
poruththappatta	பொருத்தப்பட்ட	பொருத்தப்பட்ட
poruththappattulla	பொருத்தப்பட்டுள்ள	பொருத்தப்பட்டுள்ள
poruththappatulla	பொருத்தப்பட்டுள்ள	பொருத்தப்பட்டுள்ள
porundhakkoodiya	பொருந்தக்கூடிய	பொருந்தக்கூடிய
porundhdhakkoodiya	பொருந்தக்கூடிய	பொருந்தக்கூடிய
porunthakkoodiya	பொருந்தக்கூடிய	பொருந்தக்கூடிய
porundhaadha	பொருந்தாத	பொருந்தாத
porundhdhaadha	பொருந்தாத	பொருந்ததா
porunthaatha	பொருந்தாத	பொருந்தாத
porundhum	பொருந்தும்	பொருந்தும்
porunthum	பொருந்தும்	பொருந்தும்
porulaagavea	பொருளாகவே	பொருளாகவே
porulaakavae	பொருளாகவே	பொருளாகவே
porulukku	பொருளுக்கு	பொருளுக்கு
porulukkum	பொருளுக்கும்	பொருளுக்கும்
poraamaiyum	பொறாமையும்	பொராமையும்
poriththa	பொறித்த	பொரித்த
porimuraiyil	பொறிமுறையில்	பொரிமுறையில்
poriyiyal	பொறியியல்	பொறியியல்
poruththa	பொறுத்த	பொருத்த
poruththal	பொறுத்தல்	பொருத்தல்
poruththae	பொறுத்தே	பொருத்தே
poruththe	பொறுத்தே	பொருத்தே
poruththea	பொறுத்தே	பொருத்தே
poruppaettraar	பொறுப்பேற்றார்	பொறுப்பேற்றார்
poruppetraar	பொறுப்பேற்றார்	பொறுப்பெற்றார்
poruppettraar	பொறுப்பேற்றார்	பொறுப்பெற்றார்
porupeattrullar	பொறுப்பேற்றுள்ளார்	பொறுபெற்றுள்ளார்
poruppaettrullaar	பொறுப்பேற்றுள்ளார்	பொறுப்பெற்றுள்ளார்
poruppetrullaar	பொறுப்பேற்றுள்ளார்	பொறுப்பெற்றுள்ளார்
poakka	பொழுது	போக்க
poluthu	பொழுது	பொழுது
pozhudhu	பொழுது	பொழுது
pozhuthu	பொழுது	பொழுது
poluthupokkukku	பொழுதுபோக்குக்கு	பொழுதுபொக்குக்கு
poluthupookkukku	பொழுதுபோக்குக்கு	பொழுதுதுக்கொக்கு
pozhudhupoakkuk	பொழுதுபோக்குக்கு	பொழுதுபோககக்கு
baus	பொஸ்	பாஸ்
bauus	பொஸ்	பாஸ்
bos	பொஸ்	பாஸ்
boss	பொஸ்	பாஸ்
bous	பொஸ்	பாஸ்
bouus	பொஸ்	பாஸ்
paoos	பொஸ்	போஸ்
bogach	போகச்	பாக்ச்
poagach	போகச்	போகச்
pogach	போகச்	போகாச்
pokach	போகச்	பொகச்
poagath	போகத்	போகத்
pogath	போகத்	போகத்
pokath	போகத்	போகத்
bhoagam	போகம்	போகம்
boagam	போகம்	போகம்
bogam	போகம்	பாகம்
bhoagar	போகர்	போகர்
boagar	போகர்	போகர்
bogar	போகர்	போக்
poagavae	போகவே	போகவே
poagavea	போகவே	போக்கவே
pogave	போகவே	போகவே
poagaamal	போகாமல்	போக்மால்
poakkaaga	போக்காக	போக்காக
poakkaaha	போக்காக	போக்கா
poakkuvaraththin	போக்குவரத்தின்	போக்குவதற்கின்
poakkuvaraththirku	போக்குவரத்திற்கு	போக்குவரித்துக்ற
boassu	போசு	போஸ்
poasu	போசு	போசு
boadi	போடி	போடி
poadi	போடி	போடி
poattigalin	போட்டிகளின்	போட்டிகளின்
poattikalin	போட்டிகளின்	போட்டிகளின்
poattigalilum	போட்டிகளிலும்	போட்டிகளிலும்
poattikalilum	போட்டிகளிலும்	போட்டிகளிலும்
poattigalil	போட்டிகளில்	போட்டிகளில்
poattikalil	போட்டிகளில்	போட்டிகளில்
poattigalukkaana	போட்டிகளுக்கான	போட்டிக்களுக்கான
poattikalukkaana	போட்டிகளுக்கான	போட்டிக்களுக்கான
poattigalukku	போட்டிகளுக்கு	போட்டிகளுக்கு
poattikalukku	போட்டிகளுக்கு	போட்டிகளுக்கு
poattigalum	போட்டிகளும்	போட்டிகளும்
poattigalaiyuim	போட்டிகளையும்	போட்டிகளையும்
poattigalaiyum	போட்டிகளையும்	போட்டிகளையும்
poattikalaiyum	போட்டிகளையும்	போட்டிகளையும்
poattigal	போட்டிகள்	போட்டிகள்
poattikal	போட்டிகள்	போட்டிகள்
poattikku	போட்டிக்கு	போட்டிக்கு
poattith	போட்டித்	போட்டித்
tervil	போட்டித்	தெர்வில்
thaervil	போட்டித்	தேர்வில்
poattiyaaga	போட்டியாக	போட்டியாக
poattiyaaka	போட்டியாக	போட்டியாக
poattiyaalarkalin	போட்டியாளர்களின்	போட்டியாளர்களின்
poattiyalargalin	போட்டியாளர்களின்	போட்டியல்களின்
poattiyaalargalai	போட்டியாளர்களை	போட்டியாளர்களை
poattiyaalarkalai	போட்டியாளர்களை	போட்டியாளர்களை
poattiyilirindhu	போட்டியிலிருந்து	போட்டியிலிருந்து
poattiyilirunthu	போட்டியிலிருந்து	போட்டியிலிருந்து
poattiyum	போட்டியும்	போட்டியும்
poattiayai	போட்டியை	போட்டியை
poattiyai	போட்டியை	போட்டியை
poattiyei	போட்டியை	போட்டியை
poattiyaith	போட்டியைத்	போட்டியைத்
poattiyeith	போட்டியைத்	போட்டியைத்
poathellaam	போதெல்லாம்	போதல்லாம்
poandrathu	போன்றது	போன்றது
poantrathu	போன்றது	போன்றது
poandravar	போன்றவர்	போன்றவர்
poantravar	போன்றவர்	போன்றவர்
poandravarkalukku	போன்றவர்களுக்கு	போன்றவர்களுக்கு
poantravargalukku	போன்றவர்களுக்கு	போன்றவர்களுக்கு
poantravarkalukku	போன்றவர்களுக்கு	போன்றவர்களுக்கு
poandravarkal	போன்றவர்கள்	போன்றவர்கள்
poanravarkal	போன்றவர்கள்	போன்றவர்கள்
poantravargal	போன்றவர்கள்	போன்றவர்கள்
poantravarkal	போன்றவர்கள்	போன்றவர்கள்
poandrum	போன்றும்	போன்றும்
poanrum	போன்றும்	போன்றும்
poantrum	போன்றும்	போன்றும்
poandrae	போன்றே	போன்றே
poanrae	போன்றே	போன்றே
poantrae	போன்றே	போன்றே
bauing	போயிங்	பாய்ங்
bauuing	போயிங்	பாயங்
boaing	போயிங்	பாய்ங்
boaying	போயிங்	போயிங்
boeengs	போயிங்	பாங்ஸ்
boeing	போயிங்	பாய்ங்
boiings	போயிங்	பாயிங்ஸ்
boing	போயிங்	பாய்ங்
booeengs	போயிங்	பாங்ஸ்
booeing	போயிங்	பூயங்
poaying	போயிங்	போயிங்
poayina	போயின	போயின
poyina	போயின	பாயின
poarkkaala	போர்க்கால	போர்க்கால
poarkkaalaththil	போர்க்காலத்தில்	போர்க்காலத்தில்
board	போர்ட்	போர்ட்
ford	போர்ட்	பார்ட்
poard	போர்ட்	போர்ட்
poart	போர்ட்	போர்ட்
poord	போர்ட்	போர்ட்
poort	போர்ட்	போர்ட்
port	போர்ட்	போர்ட்
poalak	போலக்	போலக்
polak	போலக்	பொலக்
poalirukkum	போலிருக்கும்	போலிறுக்கும்
polirukkum	போலிருக்கும்	பொலிறுக்கும்
poalum	போலும்	போலும்
polum	போலும்	பொலும்
bole	போலே	பால்
bolee	போலே	பாலி
boole	போலே	பூல்
fole	போலே	பால்
folee	போலே	பாலி
foleey	போலே	பாலி
folei	போலே	பாலி
foley	போலே	பாலி
foli	போலே	பாலி
folii	போலே	பாலி
foole	போலே	பால்
foolee	போலே	போலி
fooley	போலே	பாலி
fooli	போலே	பூலி
foolii	போலே	பாலி
phole	போலே	பால்
pholee	போலே	போலி
pholey	போலே	பாலி
pholi	போலே	பாலி
pholii	போலே	பாலி
poalae	போலே	போலே
poale	போலே	போல்
polae	போலே	போலே
poolee	போலே	போலி
magalaai	மகளாய்	மகளால்
magalaay	மகளாய்	மகளாய்
makalaai	மகளாய்	மகளாய்
makalaay	மகளாய்	மகலாய்
magalaiyum	மகளையும்	மகளையும்
makalaiyum	மகளையும்	மகளையும்
magaaraajan	மகாராஜன்	மகாராஜன்
mahaaraajan	மகாராஜன்	மகாராஜான்
maharajan	மகாராஜன்	மகாராஜன்
makaaraajan	மகாராஜன்	மகாராஜன்
magaalingam	மகாலிங்கம்	மகாலின்க்
magaalingkam	மகாலிங்கம்	மகாலின்க்கம்
mahalingam	மகாலிங்கம்	மகளாலின்
makaalingam	மகாலிங்கம்	மகாலின்க்
makaalingkam	மகாலிங்கம்	மகாலின்க்க
magaal	மகால்	மகால்
mahal	மகால்	மஹால்
makaal	மகால்	மகால்
magimai	மகிமை	மகிமை
makimai	மகிமை	மகிமை
magilchchiyai	மகிழ்ச்சியை	மகிழ்ச்சியை
makilchchiyai	மகிழ்ச்சியை	மகிழ்ச்சியை
makizhchchiyai	மகிழ்ச்சியை	மகிழ்ச்சியை
magilchchiyaiyum	மகிழ்ச்சியையும்	மகிழ்ச்சியையும்
makilchchiyaiyum	மகிழ்ச்சியையும்	மகிழ்ச்சியையும்
makizhchchiyaiyum	மகிழ்ச்சியையும்	மாழி்்சியையும்
magilchchiyoadu	மகிழ்ச்சியோடு	மகிழ்ச்சியோடு
makilchchiyoadu	மகிழ்ச்சியோடு	மகிழ்ச்சியோடு
makizhchchiyoadu	மகிழ்ச்சியோடு	மாழி்்சியோடு
maheshvari	மகேஸ்வரி	மஹேர்வரி
maheswari	மகேஸ்வரி	மாஸ்வரி
makaesvari	மகேஸ்வரி	மேகர்ஸ்வரி
makkiya	மக்கிய	மக்கிய
maggum	மக்கும்	மகக்ம்
makkum	மக்கும்	மக்கும்
machuuthi	மசூதி	மசுத்தி
masoodi	மசூதி	மசூடி
masoothi	மசூதி	மசூதி
masuthi	மசூதி	மசுதி
masuuthi	மசூதி	மசுதி
machuuthiukal	மசூதிகள்	மசுத்திக்கள்
masoothigal	மசூதிகள்	மசூதிகள்
masoothikal	மசூதிகள்	மசுதிகள்
masuthigal	மசூதிகள்	மசுதிகள்
masuuthigal	மசூதிகள்	மசுதிகள்
machuuthiyil	மசூதியில்	முசுதியில்
masoothiyil	மசூதியில்	மேசுதியில்
masuthiyil	மசூதியில்	மசுதியில்
masuuthiyil	மசூதியில்	முசுதியில்
madanthai	மடந்தை	மடந்தை
matanthai	மடந்தை	மடந்தை
madaalayam	மடாலயம்	மடலாயல்
mataalayam	மடாலயம்	மடலாயல்
mattumae	மட்டுமே	மட்டுமே
manakka	மணக்க	மனக்க
manakkaal	மணக்கால்	மகன்கால்
manappathu	மணப்பது	மனப்பது
manamurivu	மணமுறிவு	மனமுரிவு
maninaera	மணிநேர	மனினேற
maninera	மணிநேர	மணினீர
maninaerangal	மணிநேரங்கள்	மனினேரங்கள்
maninaeranggal	மணிநேரங்கள்	மனினேனர்கள்
maninerangkal	மணிநேரங்கள்	மனினேரங்கள்
maninaeraththirku	மணிநேரத்திற்கு	மனினேற்றத்திற்கு
manineraththirku	மணிநேரத்திற்கு	மனினேற்றிக்கது
maninaeram	மணிநேரம்	மனினேறம்
manineram	மணிநேரம்	மணினேரம்
manimuththaaru	மணிமுத்தாறு	மனிமுத்துற்ற
manimuththaru	மணிமுத்தாறு	மனிமுத்துற
manneeral	மண்ணீரல்	மண்ணீர்ல்
manneeril	மண்ணீரல்	மண்னீரில்
madhar	மதர்	மதர்
mathar	மதர்	மதர்
mother	மதர்	மாதர்
madhurakavi	மதுரகவி	மதுரகவி
madurakavi	மதுரகவி	மதுரகவே
mathurakavi	மதுரகவி	மதுரகவாசி
maddhiyath	மத்தியத்	மத்தியத்
maththiyath	மத்தியத்	மத்தியத்
mandhamaaga	மந்தமாக	மந்தமாக
manthamaaga	மந்தமாக	மந்தமாக
manthamaaka	மந்தமாக	மந்தமாக
mandhar	மந்தர்	மந்தர்
manthar	மந்தர்	மந்தர்
manaaluththam	மனஅழுத்தம்	மணல்லுத்தம்
manaalzhuththam	மனஅழுத்தம்	மணல்லுந்தாம்
manaazhuththam	மனஅழுத்தம்	மணலுந்தம்
manathoadu	மனதோடு	மகனோடு
manappaadam	மனப்பாடம்	மனப்படம்
manam	மனம்	மணம்
manaigalil	மனைகளில்	மனைகளில்
manaikalil	மனைகளில்	மனைகளில்
manaiyil	மனையில்	மனையில்
mannarai	மன்னரை	மன்னரை
marakkattai	மரக்கட்டை	மரக்கட்டை
marakattaigalai	மரக்கட்டைகளை	மரகட்டைகளை
marakkattaikalai	மரக்கட்டைகளை	மரக்கட்டைகளை
maraththinaal	மரத்தினால்	மரத்தினால்
maraththin	மரத்தின்	மரத்தின்
marabuvali	மரபுவழி	மரபுலவி
marabuvazhi	மரபுவழி	மரபுலவி
maravalli	மரவள்ளி	மாரல்வில்
mariyannai	மரியன்னை	மரியண்ணை
mariina	மரீனா	மரீனா
mariinaa	மரீனா	மரீனா
marina	மரீனா	மாரிணா
marinaa	மரீனா	மறினா
maru	மரு	மாரு
marukkal	மருக்கள்	மருக்கள்
maruththuvamanaigalukku	மருத்துவமனைகளுக்கு	மருத்துவனைகளுக்குு
maruththuvamanaikalukku	மருத்துவமனைகளுக்கு	மருத்துவனைக்களுக்கு
maruththuvamanaikku	மருத்துவமனைக்கு	மருத்துவமுக்கைை
maruththuvamanaiyaaga	மருத்துவமனையாக	மருத்துவமைனாாக
maruththuvamanaiyaaka	மருத்துவமனையாக	மருத்துவமையானவாக
maruththuvamanaiyin	மருத்துவமனையின்	மருத்துமைவனின்
maruththuvamanaiyil	மருத்துவமனையில்	மருத்துமைவியனை
marundhae	மருந்தே	முருந்தே
marunthae	மருந்தே	மருந்தே
marunththae	மருந்தே	மருந்தே
marukkappatta	மறுக்கப்பட்ட	மருக்கப்பட்ட
marukkum	மறுக்கும்	மருக்கும்
maraivaal	மறைவால்	மறைவால்
matravar	மற்றவர்	மற்றவர்
matrtravar	மற்றவர்	மற்றவர்
mattravar	மற்றவர்	மற்றவர்
matravargalaal	மற்றவர்களால்	மற்றவர்களால்
matrtravargalaal	மற்றவர்களால்	மற்றவர்களால்
matrtravarkalaal	மற்றவர்களால்	மற்றவர்களால்
mattravarkalaal	மற்றவர்களால்	மற்றவர்களால்
matravargalukku	மற்றவர்களுக்கு	மற்றவர்களுக்கு
matrtravargalukku	மற்றவர்களுக்கு	மற்றவர்களுக்கு
matrtravarkalukku	மற்றவர்களுக்கு	மற்றவர்களுக்கு
mattravarkalukku	மற்றவர்களுக்கு	மற்றவர்களுக்கு
matravargalukkum	மற்றவர்களுக்கும்	மற்றவர்களுக்கும்
matrtravargalukkum	மற்றவர்களுக்கும்	மற்றவர்களுக்கும்
matrtravarkalukkum	மற்றவர்களுக்கும்	மற்றவர்களுக்கும்
mattravarkalukkum	மற்றவர்களுக்கும்	மற்றவர்களுக்கும்
matravargaludan	மற்றவர்களுடன்	மற்றவர்களுடன்
matrtravargaludan	மற்றவர்களுடன்	மற்றவர்களுடன்
matrtravarkaludan	மற்றவர்களுடன்	மற்றவர்களுடன்
mattravarkaludan	மற்றவர்களுடன்	மற்றவர்களுடன்
matravargalai	மற்றவர்களை	மற்றவர்களை
matrtravargalai	மற்றவர்களை	மற்றவர்களை
matrtravarkalai	மற்றவர்களை	மற்றவர்களை
mattravarkalai	மற்றவர்களை	மற்றவர்களை
matravargalaip	மற்றவர்களைப்	மற்றவர்களைப்
matrtravargalaip	மற்றவர்களைப்	மற்றவர்களைப்
matrtravarkalaip	மற்றவர்களைப்	மற்றவர்களைப்
mattravarkalaip	மற்றவர்களைப்	மற்றவர்களைப்
malattu	மலட்டு	மலத்து
malarin	மலரின்	மலரரின்
malaril	மலரில்	மலரில்
malarai	மலரை	மலராரை
indraiya	மலர்	இன்றைய
inraiya	மலர்	இன்றைய
intraiya	மலர்	இன்றைய
malargalaal	மலர்களால்	மலர்களால்
malarkalaal	மலர்களால்	மலர்களால்
malargalin	மலர்களின்	மலர்களின்
malarkalin	மலர்களின்	மலர்களின்
malargalai	மலர்களை	மலர்களை
malarkalai	மலர்களை	மலர்களை
malargal	மலர்கள்	மலர்கள்
malarkal	மலர்கள்	மலர்கள்
malivaaga	மலிவாக	மலீவாக
malivaaka	மலிவாக	மலிவாக
maadangal	மாடங்கள்	மாடங்கள்
maadangkal	மாடங்கள்	மாடங்கள்
maatangkal	மாடங்கள்	மாடங்கள்
maadaththil	மாடத்தில்	மாடத்தில்
maataththil	மாடத்தில்	மாடத்தில்
maadam	மாடம்	மாடம்
maatam	மாடம்	மாடம்
maanikkak	மாணிக்கக்	மானிக்கக்
manickkak	மாணிக்கக்	மனிக்க்க்
maan	மாண்	மான்
maann	மாண்	மான்
maadhiriyaaga	மாதிரியாக	மாதிரியாக
maadhiriyaaka	மாதிரியாக	மாதிரியாக
maathiriyaaga	மாதிரியாக	மாதிரியாக
maathiriyaaka	மாதிரியாக	மாதிரியாக
maarkandaeya	மார்க்கண்டேய	மாற்கண்டிய
maarkkandaeya	மார்க்கண்டேய	மார்க்கட்ணிய
markandeya	மார்க்கண்டேய	மார்க்கட்டியா
markkandaeya	மார்க்கண்டேய	மார்க்கட்டியா
maarkkandaeyan	மார்க்கண்டேயன்	மார்க்கண்டியன்
markandeyan	மார்க்கண்டேயன்	மார்க்கண்டியன்
maarban	மார்பன்	மார்பன்
maarpin	மார்பன்	மார்பின்
maarbil	மார்பில்	மார்பில்
maarpil	மார்பில்	மார்பில்
maaraagak	மாறாகக்	மாறாகக்
maaraakak	மாறாகக்	மாறாகக்
maaraagath	மாறாகத்	மாராகத்
maaraakath	மாறாகத்	மாராகத்
maattramadaintha	மாற்றமடைந்து	மாற்றமடைந்த
maattramadainthu	மாற்றமடைந்து	மாற்றமடைந்து
mattramadaindhu	மாற்றமடைந்து	மற்றமடைந்து
maattru	மாற்று	மாற்று
maatrtruk	மாற்றுக்	மாற்றுக்
maattruk	மாற்றுக்	மாற்றுக்
maattruch	மாற்றுச்	மாற்றுச்
maatrum	மாற்றும்	மாற்றும்
maattrum	மாற்றும்	மாற்றும்
maalaimurasu	மாலைமுரசு	மாலைமுரசு
malaimurasu	மாலைமுரசு	மலைமுரசு
maalaiyilum	மாலையிலும்	மாலையிலும்
maalaiyil	மாலையில்	மாலையில்
maalaiyaiyum	மாலையையும்	மாலையையும்
maaligai	மாளிகை	மாலிகை
maalikai	மாளிகை	மாலிகை
maaligaigal	மாளிகைகள்	மாலிகைகள்
maalikaikal	மாளிகைகள்	மாலிகைகள்
maaligaikkul	மாளிகைக்குள்	மாலைக்குக்
maalikaikkul	மாளிகைக்குள்	மாலிகைகள்
maaligaiyin	மாளிகையின்	மேல்கையின்
maalikaiyin	மாளிகையின்	மேலிகையின்
maaligaiyai	மாளிகையை	மாலிகையை
maalikaiyai	மாளிகையை	மாலிகையை
maavilakku	மாவிளக்கு	மாவிளக்கு
maavoa	மாவோ	மாவோ
maavoo	மாவோ	மாவு
mao	மாவோ	மா
maoo	மாவோ	மோ
maoow	மாவோ	மோ
maov	மாவோ	மாவ்
maow	மாவோ	மோ
mau	மாவோ	மு
mavoo	மாவோ	மோவு
maavoavin	மாவோவின்	மாவவின்
maavoovin	மாவோவின்	மாவுவின்
maasgoa	மாஸ்கோ	மாஸ்கோ
maaskoa	மாஸ்கோ	மாஸ்கோ
maaskoo	மாஸ்கோ	மாஸ்கோ
maskoo	மாஸ்கோ	மோஸ்கோ
moosccoov	மாஸ்கோ	மோக்குவ்
mooscoo	மாஸ்கோ	மோஸ்கோ
mooscoow	மாஸ்கோ	மோஸ்கோ
mosccov	மாஸ்கோ	மோக்கோ
mosccow	மாஸ்கோ	மோக்கோ
moscoo	மாஸ்கோ	மோஸ்கோ
moscov	மாஸ்கோ	மோஸ்கவவு
moscow	மாஸ்கோ	மோஸ்கோ
moscu	மாஸ்கோ	மோக்கு
maaskoavil	மாஸ்கோவில்	மாஸ்கோவில்
maaskoovil	மாஸ்கோவில்	மாஸ்கூவில்
massgoavil	மாஸ்கோவில்	மாஸ்கோவில்
moscowil	மாஸ்கோவில்	மோஸ்கோலில்
mikka	மிக்க	மிக்க
mikkadhaaga	மிக்கதாக	மிக்கத்தாக
mikkathaaka	மிக்கதாக	மிக்கத்தாக
mikku	மிக்கு	மிக்கு
michchigan	மிச்சிகன்	மிக்சிகன்
michigan	மிச்சிகன்	மிகிசன்
midhakkum	மிதக்கும்	மிதக்கும்
mithakkum	மிதக்கும்	மிதக்கும்
midhappu	மிதப்பு	மிதப்பு
mithappu	மிதப்பு	மிதப்பு
midhavaadha	மிதவாத	மிதவாத
mithavaatha	மிதவாத	மிதவதா
midhilai	மிதிலை	மிதிலை
mithilai	மிதிலை	மிதிலை
miyaanmar	மியான்மர்	மியான்மார்
myanmar	மியான்மர்	மைந்மர்
meov	மியாவ்	மெய்
meow	மியாவ்	மியோ
mev	மியாவ்	மே
meva	மியாவ்	மே
mew	மியாவ்	மே
mewa	மியாவ்	மேவா
meyaavu	மியாவ்	மெய்வாு
miev	மியாவ்	மீவ்
miew	மியாவ்	மீவு
miyaav	மியாவ்	மியாவ்
miyav	மியாவ்	மியாவ்
mirsaa	மிர்ஸா	மிர்சா
mirshaa	மிர்ஸா	மிர்ஷா
mirzaa	மிர்ஸா	மிர்சா
milagu	மிளகு	மிலகு
milaku	மிளகு	மிலகு
mee	மீ	மே
mie	மீ	மி
mii	மீ	மி
miie	மீ	மே
meenavargalin	மீனவர்களின்	மீனவர்களின்
meenavarkalin	மீனவர்களின்	மீனவர்களின்
meenavargal	மீனவர்கள்	மீனவர்கள்
meenavarkal	மீனவர்கள்	மீனவர்கள்
meena	மீனா	மீனா
meenaa	மீனா	மேனா
mena	மீனா	மென்
miina	மீனா	மினா
miinaa	மீனா	மீனா
mina	மீனா	மின
meengalil	மீன்களில்	மீங்களில்
meenkalil	மீன்களில்	மீன்களில்
meengalum	மீன்களும்	மீங்களும்
meenkalum	மீன்களும்	மீங்களும்
meengalai	மீன்களை	மெங்களை
meenkalai	மீன்களை	மீன்களை
meengalaik	மீன்களைக்	மீங்களைக்
meenkalaik	மீன்களைக்	மீன்களைக்
meara	மீரா	மேற
meera	மீரா	மேற
meeraa	மீரா	மீறா
meiira	மீரா	மேறா
meira	மீரா	மேற
miira	மீரா	மீற
miiraa	மீரா	மிரா
mira	மீரா	மிர
miraa	மீரா	மிரா
meeraan	மீரான்	மீரான்
meeran	மீரான்	மேரன்
meelaad	மீலாத்	மீலாட்
meelaath	மீலாத்	மீலாத்
mugam	முகம்	முகம்
mukam	முகம்	முகம்
thaan	முகம்	தான்
muguntha	முகுந்த	முகுந்த
mukunda	முகுந்த	முகுண்ட
mukundha	முகுந்த	முகுந்த
mukundhdha	முகுந்த	முகுந்த
mukuntha	முகுந்த	முகுந்த
thiruththum	முடி	திருத்தும்
tiruttum	முடி	திருட்டும்
mudigaludan	முடிகளுடன்	முடிகளுடன்
mudikaludan	முடிகளுடன்	முடிகளுடன்
mudigalum	முடிகளும்	முடிகளும்
mudikalum	முடிகளும்	முடிகளும்
mudigalai	முடிகளை	முடிகளை
mudikalai	முடிகளை	முடிகளை
mudigal	முடிகள்	முடிகள்
mudikal	முடிகள்	முடிகள்
boadhu	முடிக்கும்	போது
poadhu	முடிக்கும்	பதி
poathu	முடிக்கும்	போது
potu	முடிக்கும்	பொட்டு
mudindhdhana	முடிந்தன	முதிந்தன
mudinthana	முடிந்தன	முடிந்தன
mudiyaamal	முடியாமல்	முடியாமல்
mudiyaamai	முடியாமை	முடியாமை
mudiyin	முடியின்	முடியின்
mudiyil	முடியில்	முடியில்
mudiyai	முடியை	முடியை
mudivadaiyum	முடிவடையும்	முடிவடையும்
mudivin	முடிவின்	முடிவின்
mudivilum	முடிவிலும்	முடிவிலும்
mudivae	முடிவே	முடிவே
muthanilai	முதனிலை	முதனிலை
muthalamaichchar	முதலமைச்சர்	முதலமைச்சர்
muthalamaichchargal	முதலமைச்சர்கள்	முதலமைச்சகர்கள்
muthalamaichcharkal	முதலமைச்சர்கள்	முதலமைச்சகர்கள்
muthaluthavi	முதலுதவி	முதல்ளவத
muthaludhavip	முதலுதவிப்	முதல்ளுபத்
muthaluthavip	முதலுதவிப்	முதல்துபவிட்
munaivadhaaga	முனைவதாக	முனைவதாக
munaivathaaka	முனைவதாக	முனைவதாக
munnani	முன்னணி	முன்னனி
munnaniyil	முன்னணியில்	முன்னணியில்
munnaniyum	முன்னணியும்	முன்னணியும்
munnarae	முன்னரே	முன்னே
padugindrana	முன்னெடுக்கப்	படுகின்றன
padukinrana	முன்னெடுக்கப்	படுகின்றன
padukintrana	முன்னெடுக்கப்	படுகின்றன
patukinrana	முன்னெடுக்கப்	படுகின்றன
munnedukappatta	முன்னெடுக்கப்பட்ட	முன்னுடுக்கப்பட்ட
munnedukkappatta	முன்னெடுக்கப்பட்ட	முன்னெடுக்கப்பட்ட
munnetukkappatta	முன்னெடுக்கப்பட்ட	முன்னெடுக்கப்பட்ட
munnedukkum	முன்னெடுக்கும்	முன்னெடுக்கும்
munnetukkum	முன்னெடுக்கும்	முன்னெட்டுக்கும்
munmaadhiriyaga	முன்மாதிரியாக	முன்மாதிதியாக
munmaadhiriyaka	முன்மாதிரியாக	முன்மாதிதியாக
munmaathiriyaaga	முன்மாதிரியாக	முன்மாதிரியாக
munmaathiriyaaka	முன்மாதிரியாக	முன்மாதியாகரா
munmadiriyaga	முன்மாதிரியாக	முன்மடிிியாக
munvaiththa	முன்வைத்த	முன்வைத்த
munvaiththaanr	முன்வைத்தனர்	முன்வைந்தார்
munvaiththanar	முன்வைத்தனர்	முன்வைந்தனர்
muppathu	முப்பது	முப்பது
muppathukkum	முப்பதுக்கும்	முப்பதுக்கும்
muyandra	முயன்ற	முயர்ன்ற
muyanra	முயன்ற	முயர்ன்
muyantra	முயன்ற	முயர்ன்ற
muyandrathaaga	முயன்றதாக	முன்றத்தாக
muyandrathaaha	முயன்றதாக	முயன்றதாத
muyandrathaaka	முயன்றதாக	முன்றத்தாக
muyanrathaaka	முயன்றதாக	முன்றத்தாக
muyantrathaaga	முயன்றதாக	முன்றத்தாக
muyantrathaaka	முயன்றதாக	முன்றத்தாக
muyandrathu	முயன்றது	முயன்று
muyanrathu	முயன்றது	முயன்று
muyantrathu	முயன்றது	முயன்று
muyandrana	முயன்றன	முயந்தனர
muyanrana	முயன்றன	முய்னரன்
muyantrana	முயன்றன	முயந்தனர
muyandraan	முயன்றான்	முயந்தான்
muyanraan	முயன்றான்	முய்்னார்
muyantraan	முயன்றான்	முயந்தான்
muyanru	முயன்று	முய்று
muyantru	முயன்று	முயற்று
murachu	முரசு	முரசு
murasu	முரசு	முராசு
muraigaettil	முறைகேட்டில்	முறைகேட்டில்
muraikaettil	முறைகேட்டில்	முறைகேட்டில்
muraikettil	முறைகேட்டில்	முறைகேட்டில்
muraimai	முறைமை	முறைமை
muraimaiyaanathu	முறைமையானது	முறைமையானது
muraimaiyin	முறைமையின்	முறைமையின்
muraimaiyil	முறைமையில்	முறைமையில்
murpatta	முற்பட்ட	முற்பட்ட
murpattanar	முற்பட்டனர்	முற்பட்டனர்
murpattapoathu	முற்பட்டபோது	முற்பட்டபோது
murpattapoothu	முற்பட்டபோது	முற்பட்டோதுப்
murpattapothu	முற்பட்டபோது	முற்பட்டபோது
murpattaan	முற்பட்டான்	முற்பட்டான்
theevai	முல்லைத்	தேவை
tivai	முல்லைத்	திவ்
mullum	முள்ளும்	முல்லும்
mullai	முள்ளை	முல்லை
mulunera	முழுநேர	முழுநீர
muzhunaera	முழுநேர	முழுநீர
muzhunera	முழுநேர	முழுநீர
moodupani	மூடுபனி	மூடுபணி
moondraavadhu	மூன்றாவது	மூன்றாவது
moondraavathu	மூன்றாவது	மூன்றாவது
moor	மூர்	மோர்
mur	மூர்	வார்
muur	மூர்	வார்
moolakkooru	மூலக்கூறு	மூகல்கூறு
moolakkoorugalin	மூலக்கூறுகளின்	மூலக்கூருகளின்
moolakkoorukalin	மூலக்கூறுகளின்	மூலக்கூருக்களின
moolakkoorugalai	மூலக்கூறுகளை	மூலக்கூருகளை
moolakkoorukalai	மூலக்கூறுகளை	மூலக்கூருகளை
mechchi	மெச்சி	மெக்சி
maegalai	மேகலை	மேகளை
maekalai	மேகலை	மேகலை
megalai	மேகலை	மேகலை
madein	மேட்டின்	மேடன்
maettin	மேட்டின்	மேட்டின்
mate	மேட்டின்	மேட்
matein	மேட்டின்	மேடன்
maeniyil	மேனியில்	மேனியில்
maembaalaththai	மேம்பாலத்தை	மேம்பாலத்தை
maempaalaththai	மேம்பாலத்தை	மேம்பாலத்தை
meampaalaththai	மேம்பாலத்தை	மேம்பாலத்தை
maicroa	மைக்ரோ	மைக்ரோ
maikro	மைக்ரோ	மைக்ரோ
maikroa	மைக்ரோ	மைக்ரோ
maikroo	மைக்ரோ	மைக்ரோ
maiqro	மைக்ரோ	மைக்ரோ
mekro	மைக்ரோ	மெக்ரோ
micro	மைக்ரோ	மிக்ரோ
microo	மைக்ரோ	மிக்ரோ
micru	மைக்ரோ	மிக்ரு
mikro	மைக்ரோ	மிக்ரோ
mykro	மைக்ரோ	மிக்ரோ
mykroo	மைக்ரோ	மிக்ரோ
myqro	மைக்ரோ	மிக்ரோ
moe	மோ	மோ
moo	மோ	மோ
mooe	மோ	மோ
moasaeyin	மோசேயின்	மோசையின்
moaseayin	மோசேயின்	மோசியின்
mosaeyin	மோசேயின்	மோசாயின்
moad	மோட்	மோட்
moat	மோட்	மோட்
mod	மோட்	மோட்
mode	மோட்	மோட்
mood	மோட்	மோட்
mote	மோட்	மோட்
iaak	யாக்	யாக்
iacc	யாக்	இய்க்
iak	யாக்	யாக்
iakk	யாக்	யாக்
iokk	யாக்	ஐய்க்
yaak	யாக்	யாக்
yaaq	யாக்	யாக்
yacc	யாக்	யாக்
yak	யாக்	யாக்
yakk	யாக்	யாக்
yaq	யாக்	யாக்
yaqq	யாக்	யாக்
yok	யாக்	யாக்
yokk	யாக்	யோக்க்
yoqq	யாக்	யாக்க்
iaang	யாங்	யாங்
ianag	யாங்	இயாக்
iang	யாங்	யாங்
yaang	யாங்	யாங்
yan	யாங்	யான்
yanag	யாங்	யானக்
yang	யாங்	யங்
yaadhavar	யாதவர்	யாதவர்
yaathavar	யாதவர்	யாதவர்
yaadhavarkal	யாதவர்கள்	யாதர்வர்கள
yaathavargal	யாதவர்கள்	யாதர்வர்கள
yaathavarkal	யாதவர்கள்	யாதர்வர்கள
iaadav	யாதவ்	ஆடாவ்
iadav	யாதவ்	ஆடவே
iaduv	யாதவ்	இடுவே
jadav	யாதவ்	ஜடவே
jadaw	யாதவ்	ஜடாவ்
yaadav	யாதவ்	யாதவவ
yaadaw	யாதவ்	யாதவ
yaadhav	யாதவ்	யாதவ
yaathav	யாதவ்	யாதவ்
yadav	யாதவ்	யாதவ்
yadaw	யாதவ்	யாதவ
yaduuv	யாதவ்	யாதுவ
yaduv	யாதவ்	யாதுவ
yaduw	யாதவ்	யாதுவ
yatav	யாதவ்	யாதவ்
zadav	யாதவ்	ஜடவே
yaavarum	யாவரும்	யாவரும்
yaahoo	யாஹூ	யாகூ
yahoo	யாஹூ	யாகூ
yaaka	யோக	யாக
yoaga	யோக	யோக
yoaka	யோக	யோக
yoga	யோக	யோகா
yaakangkalai	யோகங்களை	யாகங்களை
yoagangkalai	யோகங்களை	யோகங்களை
yoakangalai	யோகங்களை	யோகங்களை
yoakangkalai	யோகங்களை	யோகங்களை
yoagaththil	யோகத்தில்	யோகத்தில்
yoakaththil	யோகத்தில்	யோகத்தில்
yookaththil	யோகத்தில்	யூககத்தில்
yoakaththai	யோகத்தை	யோகத்தை
yogaththai	யோகத்தை	யோகத்தை
yookaththai	யோகத்தை	யூகத்தை
yoagaa	யோகா	யோகா
yoakaa	யோகா	யோகா
yoga	யோகா	யோகா
yogaa	யோகா	யோகா
yooga	யோகா	யூகா
yookaa	யோகா	யூகா
youga	யோகா	யூகா
yoachanai	யோசனை	யோசனை
yoasanai	யோசனை	யோசனை
yoosanai	யோசனை	யூசனை
yoasanaiyin	யோசனையின்	யோசனையின்
yoosanaiyin	யோசனையின்	யூசனையின்
yoasanaiyai	யோசனையை	யோசனையை
yoosanaiyai	யோசனையை	யூசனையை
yosanaiyai	யோசனையை	யூசனையை
jordan	யோர்தான்	ஜோர்டன்
yoarthaan	யோர்தான்	யோர்தான்
yoorthaan	யோர்தான்	யூர்தான்
rachippathil	ரசிப்பதில்	ரரிச்பபித்
rasippathil	ரசிப்பதில்	ரரிப்பதில்
ranchi	ரஞ்சி	ராஞ்சி
ranjchi	ரஞ்சி	ரஞ்சி
ranji	ரஞ்சி	ரஞ்சி
ranchith	ரஞ்சித்	ரஞ்சித்
ranjchith	ரஞ்சித்	ரஞ்சித்
ranjeet	ரஞ்சித்	ரா்்நீத்
ranjeit	ரஞ்சித்	ராஞ்சிட்
ranjiit	ரஞ்சித்	ராஞ்சித்
ranjit	ரஞ்சித்	ராஞ்சித்
ranjith	ரஞ்சித்	ரஞ்சித்
ranjyt	ரஞ்சித்	ராஞ்சித்
ranzeet	ரஞ்சித்	ரான்கிட்
ranzeit	ரஞ்சித்	ரான்கெட்
ranzit	ரஞ்சித்	ரான்கிட்
ranzyt	ரஞ்சித்	ரான்சிட்
runjeet	ரஞ்சித்	ரு்்நீத்
runjiit	ரஞ்சித்	ரு்்ி
runzeet	ரஞ்சித்	ரு்்
ruunjeet	ரஞ்சித்	ரூ்்
rail	ரயில்	ரயல்
raill	ரயில்	ரயல்
raiyl	ரயில்	ரயில்
rayil	ரயில்	ரயில்
rayl	ரயில்	ராய்
reil	ரயில்	ரியல்
rel	ரயில்	ரியல்
rell	ரயில்	ரெல்
ravikkai	ரவிக்கை	ரவிக்கை
ravudi	ரவுடி	ரவுடி
rovdy	ரவுடி	ராவி
rowdi	ரவுடி	ரோடி
rowdy	ரவுடி	ராடி
rashiya	ரஷ்ய	ரஷ்யா
rashya	ரஷ்ய	ரஷ்யா
rassia	ரஷ்ய	ரஷ்ய
russia	ரஷ்ய	ரஷ்யா
raagul	ராகுல்	ராகுல்
raahul	ராகுல்	ராலுல்
raahuul	ராகுல்	ரால்
ragul	ராகுல்	ராகுல்
rahool	ராகுல்	ரோல்
rahul	ராகுல்	ரால்
rahuul	ராகுல்	ரால்
rakul	ராகுல்	ரக்குல்
raajan	ராஜன்	ராஜன்
rajan	ராஜன்	ராஜன்
raajaraaja	ராஜராஜ	ராஜராஜ
rajaraja	ராஜராஜ	ரராஜராஜ
raajjiyam	ராஜ்ஜியம்	ராஜ்சியம்
rajjiyam	ராஜ்ஜியம்	ராஜ்சியம்
raanuvaththin	ராணுவத்தின்	ராணுவத்தின்
raanuvam	ராணுவம்	ராணுவம்
raat	ராத்	ராட்
raath	ராத்	ராத்
raamachchandhira	ராமச்சந்திர	ராமச்சந்திர
raamachchanthira	ராமச்சந்திர	இராமச்சந்திர
ramachandra	ராமச்சந்திர	ராமமா்சி்
raamu	ராமு	ராமு
ramu	ராமு	ராமு
raayin	ராயின்	ராயின்
raiyin	ராயின்	ரயின்
raavin	ராவின்	ராவின்
ravin	ராவின்	ரவின்
rawin	ராவின்	ரவின்
ring	ரிங்	ரிங்
reader	ரீடர்	ரேடர்
reedar	ரீடர்	ரீடர்
ruchi	ருசி	ரச்சி
rusi	ருசி	ரூசி
rendu	ரெண்டு	ரெண்டு
raadaun	ரேடான்	ராடன்
raadauun	ரேடான்	ராடன்
raadon	ரேடான்	ராடன்
radon	ரேடான்	ராடன்
reedan	ரேடான்	ரீடன்
raemand	ரேமண்ட்	ரேமண்ட்
raemant	ரேமண்ட்	ரேமண்ட்
raimond	ரேமண்ட்	ராமன்ட்
raymond	ரேமண்ட்	ராய்மண்ட்
reemand	ரேமண்ட்	ரிமண்ட்
roo	ரோ	ரோ
roow	ரோ	ரோ
rov	ரோ	ரோ
row	ரோ	ரோ
landanin	லண்டனின்	லண்டனின்
londanin	லண்டனின்	லூண்டினன்
londonin	லண்டனின்	லண்டினின்
lav	லவ்	லாவ்
lov	லவ்	லோ
love	லவ்	லாவ்
low	லவ்	லோ
lowe	லவ்	லோ
luuv	லவ்	லூவ்
luv	லவ்	லூவ்
luw	லவ்	லூவா
laak	லாக்	லாக்
lack	லாக்	லாக்
lock	லாக்	லாக்
laaba	லாப	லாபா
laba	லாப	லபா
laabam	லாபம்	லாபம்
laapam	லாபம்	லாபம்
laalu	லாலு	லாலு
lalu	லாலு	லாு
linam	லிங்கம்	லினம்
lingam	லிங்கம்	லிங்கம்
linggam	லிங்கம்	லிங்கம்
lingkam	லிங்கம்	லிங்கம்
linkam	லிங்கம்	லிங்கம்
lemeted	லிமிடெட்	லிமேட்ட்
limidaed	லிமிடெட்	லிமிடம்ட்
limitade	லிமிடெட்	லிமிட்டா
limited	லிமிடெட்	லிமிட்ட்
limitedd	லிமிடெட்	லிமிட்ட்ட்
leeli	லில்லி	லிலி
leelii	லில்லி	லிலி
liili	லில்லி	லிலி
liilii	லில்லி	லிலி
liilly	லில்லி	லிலி
liily	லில்லி	லிலி
lilee	லில்லி	லை
lili	லில்லி	லிலி
lilii	லில்லி	லிலி
lilli	லில்லி	லில்லி
lilly	லில்லி	லில்லி
lily	லில்லி	லிலி
lyly	லில்லி	லிலி
leagueil	லீக்கில்	லேகுயில்
leakkil	லீக்கில்	லேக்கில்
leena	லீனா	லீனா
leenaa	லீனா	லீனா
lena	லீனா	லெனா
liina	லீனா	லீனா
lina	லீனா	லினா
looyi	லூயி	லூய்
louie	லூயி	லையோ
louis	லூயி	லாய்ஸ்
louuie	லூயி	லூய்
luuyi	லூயி	லூய்
looyis	லூயிஸ்	லாய்ஸ்
loues	லூயிஸ்	லோஸ்
louis	லூயிஸ்	லாய்ஸ்
louues	லூயிஸ்	லூஸ்
louuis	லூயிஸ்	லூசிஸ்
lues	லூயிஸ்	லூஸ்
luis	லூயிஸ்	லூஸ்
luues	லூயிஸ்	லூஸ்
luuis	லூயிஸ்	லூஸ்
luuyis	லூயிஸ்	லூய்ஸ்
leptinan	லெப்டினன்	லெப்டினன்
lace	லெஸ்	லேக்
laes	லெஸ்	லேஸ்
lais	லெஸ்	லேஸ்
laiss	லெஸ்	லேஸ்
lays	லெஸ்	லேஸ்
layss	லெஸ்	லேஸ்
leis	லெஸ்	லெஸ்
les	லெஸ்	லேஸ்
less	லெஸ்	லெஸ்
laac	லேக்	லாக்
laak	லேக்	லாக்
laakh	லேக்	லாக்
laaq	லேக்	லாக்
laaqh	லேக்	லாக்
lac	லேக்	லாக்
laek	லேக்	லேக்
lake	லேக்	லேக்
lakh	லேக்	லக்
laqh	லேக்	லாக்
leek	லேக்	லீக்
vaguththanar	வகுத்தனர்	வகுத்தனர்
vakuththanar	வகுத்தனர்	வகுத்தனர்
vaguththulladhu	வகுத்துள்ளது	வகுத்துள்ளது
vaguththullathu	வகுத்துள்ளது	வகுத்துள்ளது
vakuththullathu	வகுத்துள்ளது	வகுத்துள்ளது
vagaith	வகைத்	வகைத்
vakaith	வகைத்	வகைத்
vakkiramaana	வக்கிரமான	வக்கிரமான
vakbu	வக்பு	வக்கப்
vakpu	வக்பு	வாக்பு
vangadesa	வங்கதேச	வங்கேஷ
vangathaesa	வங்கதேச	வங்கேதே
vangkadhaesa	வங்கதேச	வங்கேதே
vangadhaesaththil	வங்கதேசத்தில்	வங்கேதத்தில்
vangathaesaththil	வங்கதேசத்தில்	வங்கேதத்தில்
vangkadhaesaththil	வங்கதேசத்தில்	வங்கேதத்தில்
vangaali	வங்காளி	வங்காலி
vangkaali	வங்காளி	வங்காலி
vasam	வசம்	வாசம்
vasiththa	வசித்த	வசித்த
vasiththaar	வசித்தார்	வசித்தார்
vadakkae	வடக்கே	வடக்கே
vadakke	வடக்கே	வடக்கே
vadamaerkae	வடமேற்கே	வடமேற்கே
vatamaerkae	வடமேற்கே	வடமேற்கே
vadikka	வடிக்க	வடிக்க
vadikkum	வடிக்கும்	வடிக்கும்
vadivaana	வடிவான	வடிவான
vadivil	வடிவில்	வடிவில்
vatti	வட்டி	வேட்டி
vana	வண	வன
ven	வண	வென்
wen	வண	வென்
vanigar	வணிகர்	வணிகர்
vanikar	வணிகர்	வணிகர்
vanigarkalukku	வணிகர்களுக்கு	வணிகர்களுக்கு
vanikarkalukku	வணிகர்களுக்கு	வணிகர்களுக்கு
vadhanam	வதனம்	வதனம்
vathanam	வதனம்	வதனம்
wadhanam	வதனம்	வதனம்
vanaviyal	வனவியல்	வனவியல்
vamsa	வம்ச	வம்சா
vamsaththin	வம்சத்தின்	வம்சத்தின்
vamsaththu	வம்சத்து	வம்சத்து
vamchi	வம்சி	வம்சி
vamsi	வம்சி	வாம்சி
vayathaagum	வயதாகும்	வயதாகும்
vayathaakum	வயதாகும்	வயதாகும்
vayathilum	வயதிலும்	வயதிலும்
vayathilaeyae	வயதிலேயே	வயதிலேயே
varagu	வரகு	வரகு
varadha	வரத	வராத
varatha	வரத	வரத
vardha	வரத	வார்த
varadhar	வரதர்	வரதர்
varathar	வரதர்	வரதர்
varalaattru	வரலாற்று	வரலாற்று
varalaattruk	வரலாற்றுக்	வரலாற்றுக்
varalaattrukku	வரலாற்றுக்கு	வரலாற்றுக்கு
varalaattrudan	வரலாற்றுடன்	வரலாற்றுடன்
varalaattrup	வரலாற்றுப்	வரலாற்றுப்
varavaerka	வரவேற்க	வரவேற்க
varavaerkum	வரவேற்கும்	வரவேற்கும்
varigalin	வரிகளின்	வரிகளின்
varikalin	வரிகளின்	வரிகளின்
varigalil	வரிகளில்	வரிகளில்
varikalil	வரிகளில்	வரிகளில்
varigalukku	வரிகளுக்கு	வரிகளுக்கு
varikalukku	வரிகளுக்கு	வரிகளுக்கு
varigalum	வரிகளும்	வரிகளும்
varikalum	வரிகளும்	வரிகளும்
varikku	வரிக்கு	வரிக்கு
varich	வரிச்	வரிச்
varinum	வரினும்	வரிணும்
panaththai	வரிப்	பணத்தை
panattai	வரிப்	பணன்டை
variyaaga	வரியாக	வரியாக
variyaaka	வரியாக	வரியாக
variyin	வரியின்	வரியின்
variyum	வரியும்	வரியும்
varumaaru	வருமாறு	வருமாறு
variya	வறிய	வரிய
valimaiyaanathu	வலிமையானது	வழிமையானது
valuvaaga	வலுவாக	வழுவாக
valuvaaka	வலுவாக	வழுவாக
valuvvaaga	வலுவாக	வழுவாக
valaiyamaippai	வலையமைப்பை	வலைமைப்பை
valaiyamaippu	வலையமைப்பை	வலைமைப்பு
valaiththathu	வளைத்தது	வலைத்தது
valaivaaga	வளைவாக	வளைவாக
valaivaaka	வளைவாக	வளைவாக
valakkarignarum	வழக்கறிஞரும்	வழக்கறிஞரும்
valakkarinarum	வழக்கறிஞரும்	வழக்கறிஞரும்
vazhakkarinarum	வழக்கறிஞரும்	வழக்கறிஞரும்
valakkugalin	வழக்குகளின்	வழக்குகளின்
valakkukalin	வழக்குகளின்	வழக்குகளின்
vazhakkukalin	வழக்குகளின்	வழக்குகளின்
valakkugalai	வழக்குகளை	வழக்குகளை
valakkukalai	வழக்குகளை	வழக்குகளை
vazhakkukalai	வழக்குகளை	வழக்குகளை
valakkugal	வழக்குகள்	வழக்குகள்
valakkukal	வழக்குகள்	வழக்குகள்
vazhakkukal	வழக்குகள்	வழக்குகள்
valakkuth	வழக்குத்	வழக்குத்
vazhakkuth	வழக்குத்	வழக்குத்
valakkum	வழக்கும்	வழக்கும்
vazhakkum	வழக்கும்	வழக்கும்
valangappada	வழங்கப்பட	வழங்கப்பட
vazhangappada	வழங்கப்பட	வழங்கப்பட
vazhanggappada	வழங்கப்பட	வழங்கப்பட
valangappadaatha	வழங்கப்படாத	வழங்கப்படாத
vazhangappadaadha	வழங்கப்படாத	வழங்கப்படாத
vazhanggappattathaa	வழங்கப்படாத	வழங்கப்பட்டதா
valangappadum	வழங்கப்படும்	வழங்கப்படும்
valangkappadum	வழங்கப்படும்	வழங்கப்படும்
vazhanggappadum	வழங்கப்படும்	வழங்கப்படும்
vazhangkappadum	வழங்கப்படும்	வழங்கப்படும்
valangavillai	வழங்கவில்லை	வளங்கவில்லை
valangkavillai	வழங்கவில்லை	வழங்கவில்லை
vazhangkavillai	வழங்கவில்லை	வழங்கவில்லை
valinadaththa	வழிநடத்த	வழிநடத்த
vazhinadaththa	வழிநடத்த	வழிநடத்த
valiyil	வழியில்	வலிலில்
vazhiyil	வழியில்	வழியில்
valiyillai	வழியில்லை	வலிலிலை
vazhiyillai	வழியில்லை	வழியில்லை
valiyae	வழியே	வழியே
valiyea	வழியே	வழியே
vazhiyae	வழியே	வழியே
valukkum	வழுக்கும்	வழுக்கும்
vazhukkum	வழுக்கும்	வழுக்கும்
vavuniyaavil	வவுனியாவில்	வவுனியாவில்
vavuniyavil	வவுனியாவில்	வவுனியவில்
vastook	வஸ்தோக்	வாஸ்டோக்
vastuk	வஸ்தோக்	வாஸ்டுக்
voostook	வஸ்தோக்	வோஸ்டோக்
vostok	வஸ்தோக்	வோஸ்டக்
vostook	வஸ்தோக்	வோஸ்டோக்
vostoq	வஸ்தோக்	வோஸ்டோக்
wastuk	வஸ்தோக்	வாஸ்டுக்
wastuq	வஸ்தோக்	வாஸ்டுக்
wastuuk	வஸ்தோக்	வாஸ்டுக்
woostook	வஸ்தோக்	வோஸ்டோக்
wostok	வஸ்தோக்	வோஸ்டக்
wostook	வஸ்தோக்	வோஸ்டோக்
wostooq	வஸ்தோக்	வாஸ்டோக்
wostuk	வஸ்தோக்	வோஸ்டுக்
vaagana	வாகன	வாகன
vaakana	வாகன	வாக்க
vaagananggalil	வாகனங்களில்	வாகங்கங்களில்
vaaganangkalil	வாகனங்களில்	வாகங்கங்களில்
vaakanangkalil	வாகனங்களில்	வாகங்கங்களில்
vaagananggalum	வாகனங்களும்	வாகங்கங்களும்
vaaganangkalum	வாகனங்களும்	வாகங்கங்களும்
vaakanangkalum	வாகனங்களும்	வாகங்கங்களும்
vaagananggalai	வாகனங்களை	வாகங்கங்களை
vaaganangkalai	வாகனங்களை	வாகங்கங்களை
vaakanangkalai	வாகனங்களை	வாகங்கங்களை
vaagananggal	வாகனங்கள்	வாகங்கங்கள்
vaaganangkal	வாகனங்கள்	வாகங்கங்கள்
vaakanangkal	வாகனங்கள்	வாகங்கங்கள்
vaaganaththin	வாகனத்தின்	வாகந்ததின்
vaakanaththin	வாகனத்தின்	வாக்கத்தின்
vaaganaththilirunththu	வாகனத்திலிருந்து	வாக்கத்திலிருந்து
vaaganaththilirunthu	வாகனத்திலிருந்து	வாகந்திலிருந்து
vaakanaththilirunththu	வாகனத்திலிருந்து	வாக்கத்திலிருந்து
vaakanaththilirunthu	வாகனத்திலிருந்து	வாக்கத்திலிருந்து
vaaganaththil	வாகனத்தில்	வாகந்ததில்
vaakanaththil	வாகனத்தில்	வாக்கத்தில்
vaaganap	வாகனப்	வாகணப்
vaakanap	வாகனப்	வாகணப்
vaaganamaana	வாகனமான	வாகணமான
vaaganamana	வாகனமான	வாகணமான
vaakanamaana	வாகனமான	வாக்கணமான
vaakanamana	வாகனமான	வாக்கணமான
vaak	வாக்	வாக்
vag	வாக்	வாக்
vak	வாக்	வாக்
wag	வாக்	வாக்
wak	வாக்	வாக்
walk	வாக்	வால்
vaangappatta	வாங்கப்பட்ட	வாங்கப்பட்ட
vaanggappatta	வாங்கப்பட்ட	வாங்கப்பட்ட
vaangkappatta	வாங்கப்பட்ட	வாங்கப்பட்ட
vaangalil	வாங்கலில்	வாங்களில்
vaanggalil	வாங்கலில்	வாங்களில்
vaangal	வாங்கல்	வாங்கள்
vaanggal	வாங்கல்	வாங்கள்
vaangguvatharku	வாங்குவதற்கு	வாங்குவதற்கு
vaangkuvatharku	வாங்குவதற்கு	வாங்குவதற்கு
vaangguvathu	வாங்குவது	வாங்குவது
vaangkuvathu	வாங்குவது	வாங்குவது
vaangguvathai	வாங்குவதை	வாங்குவதை
vaangkuvathai	வாங்குவதை	வாங்குவதை
vaasippavargal	வாசிப்பவர்கள்	வாசிப்பவர்கள்
vaachippil	வாசிப்பில்	வாசிப்பில்
vaasippil	வாசிப்பில்	வாசிப்பில்
vaachippai	வாசிப்பை	வாசிப்பை
vaasippai	வாசிப்பை	வாசிப்பை
vaadi	வாடி	வாடி
vadi	வாடி	வேடி
wadi	வாடி	வேடி
wadii	வாடி	வேடி
vaatch	வாட்ச்	வாட்ச்
watch	வாட்ச்	வட்ச
vaani	வாணி	வானி
vani	வாணி	வானி
vaathittanar	வாதிட்டனர்	வாதிட்டனர்
vaathumai	வாதுமை	வாதுமை
vaamana	வாமன	வாமண
vamana	வாமன	வமண
vaayilaaga	வாயிலாக	வாயிலாக
vaayilaaka	வாயிலாக	வாயிலாக
vaayilaagath	வாயிலாகத்	வாயிலாதத்
vaayilaakath	வாயிலாகத்	வாயிலாதத்
vaayilaagap	வாயிலாகப்	வாயிலாகப்
vaayilaakap	வாயிலாகப்	வாயிலாகப்
vaariyaaga	வாரியாக	வாரியாக
vaariyaaka	வாரியாக	வாரியாக
vaalt	வால்ட்	வால்ட்
vald	வால்ட்	வால்ட்
valt	வால்ட்	வால்ட்
vaoolt	வால்ட்	வோல்ட்
vault	வால்ட்	வோல்ட்
vauult	வால்ட்	வோல்ட்
volt	வால்ட்	வோல்ட்
vult	வால்ட்	வெல்ட்
vuult	வால்ட்	வோல்ட்
walt	வால்ட்	வால்ட்
waoolt	வால்ட்	வோல்ட்
wault	வால்ட்	வால்ட்
wult	வால்ட்	வால்ட்
vaalidankal	வாழிடங்கள்	வாழிடங்கள்
vaazhidanggal	வாழிடங்கள்	வாழிடங்கள்
vaazhidangkal	வாழிடங்கள்	வாழிடங்கள்
vaazhitangkal	வாழிடங்கள்	வாழிட்டங்கள்
vaalidam	வாழிடம்	வாழிடம்
vaazhaidam	வாழிடம்	வாழைடம்
vaazhidam	வாழிடம்	வாழிடம்
vaazhitam	வாழிடம்	வாழிடம்
vaalai	வாழை	வாலை
vaazhai	வாழை	வாழை
vaalaiyaaga	வாழையாக	வாழையாக
vaazhaiyaaga	வாழையாக	வாழையாக
vaazhaiyaaka	வாழையாக	வாழையாக
vaazhga	வாழ்க	வாழ்க
vaazhka	வாழ்க	வாழ்க
valamudan	வாழ்க	வலமுடன்
valamutan	வாழ்க	வலமுடன்
vaazhvathaaga	வாழ்வதாக	வாழ்வதாக
vaazhvathaal	வாழ்வதால்	வாழ்வதால்
vaalvukku	வாழ்வுக்கு	வாழ்வுக்கு
vaazhvukku	வாழ்வுக்கு	வாழ்வுக்கு
vaalvoar	வாழ்வோர்	வால்வோர்
vaazhvoar	வாழ்வோர்	வாழ்வோர்
vaas	வாஸ்	வாஸ்
vase	வாஸ்	வாசி
was	வாஸ்	வாஸ்
vigaaraiyil	விகாரையில்	விகாரையில்
viharaiyil	விகாரையில்	விழையரில்
vikaaraiyil	விகாரையில்	விகாரையில்
vikkirama	விக்கிரம	விக்கிறமா
vikkrama	விக்கிரம	விக்கரம
vikrama	விக்கிரம	விக்ரமமா
visaariththu	விசாரித்து	விசாரித்து
vichaesha	விசேஷ	விசேச
visaesha	விசேஷ	விஷேச
vichaikal	விசைகள்	விசைகள்
visaigal	விசைகள்	விசைகள்
visaikal	விசைகள்	விசைகள்
vichaikku	விசைக்கு	விகைக்கு
visaikku	விசைக்கு	விசைக்கு
visaiyaal	விசையால்	விசையால்
visaiyil	விசையில்	விசையில்
visaiyum	விசையும்	விசையும்
visaiyai	விசையை	விசையை
vingngnaani	விஞ்ஞானி	விஞ்ஞானி
vinjnjaani	விஞ்ஞானி	விஞ்ஞானி
vinniaani	விஞ்ஞானி	விஞ்நானி
vingngnaanikalukku	விஞ்ஞானிகளுக்கு	விஞ்ஞாங்களுக்கு
vinjnjaanikalukku	விஞ்ஞானிகளுக்கு	விஞ்ஞானிக்குு
vinniaanigalukku	விஞ்ஞானிகளுக்கு	விந்நியானிக்குக்க
vingngnaanikal	விஞ்ஞானிகள்	விஞ்ஞாங்கின்
vinjnjaanikal	விஞ்ஞானிகள்	விஞ்ஞானிகள்
vinniaanigal	விஞ்ஞானிகள்	விந்நியானின்
vingngnaaniyaana	விஞ்ஞானியான	விஞ்ஞான்கியான
vinjnjaaniyaana	விஞ்ஞானியான	விஞ்ஞானியான
vinniaaniyaana	விஞ்ஞானியான	விஞ்நானியான
vidayangalil	விடயங்களில்	விடாயங்களில்
vidayanggalil	விடயங்களில்	விடாயங்களில்
vidayangkalil	விடயங்களில்	விடாயங்களில்
vidayanggalum	விடயங்களும்	விடாயங்களும்
vidayangkalum	விடயங்களும்	விடாயங்களும்
vitayangkalum	விடயங்களும்	விடாயங்களும்
vidayanggal	விடயங்கள்	விடாயங்கள்
vidayangkal	விடயங்கள்	விடாயங்கள்
vitayangkal	விடயங்கள்	விடாயங்கள்
vidayaththil	விடயத்தில்	விடாயத்தில்
vitayaththil	விடயத்தில்	விடாத்தில்
vidayaththaiyum	விடயத்தையும்	விடைத்தையும்
vitayaththaiyum	விடயத்தையும்	விடைத்தயையும்
poaraattam	விடுதலைப்	போராட்டம்
porattam	விடுதலைப்	போரத்தம்
viduthalaip	விடுதலைப்	விடுதலைப்
vidum	விடும்	விடும்
vittaalum	விட்டாலும்	விட்டாலும்
vittup	விட்டுப்	விட்டுப்
viththiyaachangkal	வித்தியாசங்கள்	வித்தியானங்கள்
viththiyaasanggal	வித்தியாசங்கள்	வித்தியானங்கள்
viththiyaasangkal	வித்தியாசங்கள்	வித்தியானங்கள்
viththiyaasankal	வித்தியாசங்கள்	வித்தியானவர்கள்
viththiyaachappadum	வித்தியாசப்படும்	வித்தியானப்படும்
viththiyaasappadum	வித்தியாசப்படும்	வித்தியானப்படும்
vidhdhiyaasaalai	வித்தியாசாலை	வித்தியாலையால்
vidhyaasaalai	வித்தியாசாலை	வித்தாயாலை
vidhyasalai	வித்தியாசாலை	வித்தியாலை
vidyasalai	வித்தியாசாலை	வித்தாயலை
viththiyaasaalai	வித்தியாசாலை	வித்தியாசையாலை
vinaa	வினா	வினா
vinaavirku	வினாவிற்கு	வினாவிற்கு
vinaavukku	வினாவுக்கு	வினாவுக்கு
vibaththaal	விபத்தால்	விபத்தால்
vipaththaal	விபத்தால்	விபத்தால்
booshan	விபூதி	பூசன்
vibhoodhi	விபூதி	விபோதி
viboodhi	விபூதி	விபோதி
viboothi	விபூதி	விபோதி
vimarisaiyaaga	விமரிசையாக	விமரிசையாக
vimarisaiyaaka	விமரிசையாக	விமரிசையாக
vimarsiththathu	விமர்சித்தது	விமர்ச்திதது
vimarsiththatu	விமர்சித்தது	விமர்ச்திடது
vimarsiththanar	விமர்சித்தனர்	விமர்ச்தினர்
vimarsiththu	விமர்சித்து	விமர்ச்சிது
vimaanangalil	விமானங்களில்	விமானங்களில்
vimaananggalil	விமானங்களில்	விமானங்களில்
vimaananggalai	விமானங்களை	விமானங்களை
vimaanankalai	விமானங்களை	விமானங்களை
veem	விம்	வீம்
viim	விம்	எவிம்
vim	விம்	விம்
vimm	விம்	விம்
weem	விம்	வீம்
wiim	விம்	விம்
wim	விம்	விம்
wimm	விம்	விம்
viyaabaari	வியாபாரி	வியாபாரி
viyaapaari	வியாபாரி	வியாபாரி
viyaabaarigalukkum	வியாபாரிகளுக்கும்	வியாபாரிகளுக்கும்
viyaapaarigalukkum	வியாபாரிகளுக்கும்	வியாபாரிகளுக்கும்
viyaabaarigal	வியாபாரிகள்	வியாபாரிகள்
viyaapaarigal	வியாபாரிகள்	வியாபாரிகள்
viyabaarigal	வியாபாரிகள்	வியாபிரகள்
viralaal	விரலால்	விராலல்
virivaagak	விரிவாகக்	விரிவாகக்
virivaagap	விரிவாகப்	விரிவாகப்
virivaagavum	விரிவாகவும்	விரிவாகவும்
virivagavum	விரிவாகவும்	விரிவகவும்
virivurai	விரிவுரை	விரிவுரை
virkum	விற்கும்	விற்கும்
virkumpoadhu	விற்கும்போது	விற்கும்போது
virkumpoathu	விற்கும்போது	விற்கும்போது
virpathum	விற்பதும்	விற்பதும்
vitrtra	விற்ற	விற்ற
vittra	விற்ற	விற்ற
villiamin	வில்லியமின்	விள்ளியின்
villiyamin	வில்லியமின்	வில்லியம்
williamin	வில்லியமின்	வில்லியம்
villai	வில்லை	வில்லை
villaigalai	வில்லைகளை	வில்லைகளை
villaikalai	வில்லைகளை	வில்லைகளை
vilimbu	விளிம்பு	விழிம்பு
vilimpu	விளிம்பு	விழிம்பு
vilimbugalil	விளிம்புகளில்	விளிமுக்களில்
vilimbukalil	விளிம்புகளில்	விளிமுக்களில்
vilimpugalil	விளிம்புகளில்	விளிம்புகளில்
vilimpukalil	விளிம்புகளில்	விளிம்புகளில்
vilaindha	விளைந்த	விளைந்த
vilaintha	விளைந்த	விளைந்த
vilaindhadhu	விளைந்தது	விளைந்தது
vilaindhathu	விளைந்தது	விளைந்தது
vilainthadhu	விளைந்தது	விளைந்தது
vilainthathu	விளைந்தது	விளைந்தது
vilaindhu	விளைந்து	விளைந்து
vilainthu	விளைந்து	விளைந்து
vilaiyaadinaal	விளையாடினால்	விளையாடினால்
vilaiyaadum	விளையாடும்	விளையாடும்
vilaiyaadumpoadhu	விளையாடும்போது	விளையாடும்போது
vilaiyaadumpoathu	விளையாடும்போது	விளையாடும்போது
vilaiyaaduvadharku	விளையாடுவதற்கு	விளையாடுவதற்கு
vilaiyaaduvatharku	விளையாடுவதற்கு	விளையாடுவதற்கு
vilaiyaaduvadhu	விளையாடுவது	விளையாடுவது
vilaiyaaduvathu	விளையாடுவது	விளையாடுவது
vilaiyaattaaka	விளையாட்டாக	விளையாட்டாக
vilaiyattaaga	விளையாட்டாக	விளையட்டாக
vilaiyattaaka	விளையாட்டாக	விளையட்டாக
vilayaattaaga	விளையாட்டாக	விளையாட்டாக
vivariththa	விவரித்த	விவரித்த
vivariththu	விவரித்து	விவரித்து
vivaagaraththu	விவாகரத்து	விவாகரத்து
vivaakaraththu	விவாகரத்து	விவாகரத்து
vivakaaraththu	விவாகரத்து	விவகாரத்து
veesa	வீச	விசா
veesi	வீசி	விசி
veechinaar	வீசினார்	வீசினார்
veesinaan	வீசினார்	வீசினான்
veesinaar	வீசினார்	வீசினார்
veechum	வீசும்	வீசும்
veesum	வீசும்	வீசும்
veechumpoathu	வீசும்போது	வீச்பும்போது
veesumpoathu	வீசும்போது	விசும்போது
veetirku	வீட்டிற்கு	வீட்டிற்கு
veettirgu	வீட்டிற்கு	வீட்டிருக்
veettirku	வீட்டிற்கு	வீட்டிற்கு
veeraraagavan	வீரராகவன்	வீரரகவான்
veeraraakavan	வீரராகவன்	வீரரகவான்
veeraraghavan	வீரராகவன்	வீரரகவன்
veeraraagavum	வீரராகவும்	வீரராகவும்
veeraraakavum	வீரராகவும்	வீரராகவும்
veetriruntha	வீற்றிருந்த	வீற்றுநிரு
veetrtriruntha	வீற்றிருந்த	வீற்றிருந்த
veettriruntha	வீற்றிருந்த	வீற்றிருந்த
veelchchi	வீழ்ச்சி	வீழ்ச்சி
veerzhchchi	வீழ்ச்சி	வீழ்ச்சி
veezhchchi	வீழ்ச்சி	வீழ்ச்சி
veelchchikku	வீழ்ச்சிக்கு	வீழ்ச்சிக்கு
veerzhchchikku	வீழ்ச்சிக்கு	வீழ்ச்சிக்கு
veezhchchikku	வீழ்ச்சிக்கு	வீழ்ச்சிக்கு
veelchchiyaal	வீழ்ச்சியால்	வெள்ச்சியால்
veezhchchiyaal	வீழ்ச்சியால்	வீழ்ச்சியால்
veelchchiyai	வீழ்ச்சியை	வெள்ச்சியை
veezhchchiyai	வீழ்ச்சியை	வீழ்ச்சியை
veelnththa	வீழ்ந்த	வீழ்ந்த
veezhntha	வீழ்ந்த	வீழ்ந்த
veelnththathil	வீழ்ந்ததில்	வீழ்ந்திதல்
veezhnthathil	வீழ்ந்ததில்	வீழ்ந்தில்
veelnththaar	வீழ்ந்தார்	விழ்ந்தார்
veezhnthaar	வீழ்ந்தார்	விழ்ந்தார்
veelnththu	வீழ்ந்து	வெள்ந்து
veezhnthu	வீழ்ந்து	விழ்ந்து
vekkai	வெக்கை	விக்கை
vedikka	வெடிக்க	வெடிக்க
vedikkaatha	வெடிக்காத	வெடிக்காத
vedikkumpoathu	வெடிக்கும்போது	வெடிக்கும்போது
vettiya	வெட்டிய	வெட்டிய
vettiyaan	வெட்டியான்	வெட்டியான்
veppa	வெப்ப	வெப்ப
veppak	வெப்பக்	வேப்பக்
calanam	வெப்பச்	கலனம்
chalanam	வெப்பச்	சாலனம்
salanam	வெப்பச்	சாலனம்
veppach	வெப்பச்	வேப்பாச்
veppath	வெப்பத்	வேப்பத்
veppaththaal	வெப்பத்தால்	வெப்பத்தால்
veppaththil	வெப்பத்தில்	வெப்பத்தில்
veppaththai	வெப்பத்தை	வெப்பத்தை
veppaththaik	வெப்பத்தைக்	வெப்பத்தைக்
veppamaana	வெப்பமான	வேப்பமான
veppamaanathu	வெப்பமானது	வெப்பமானது
veppamum	வெப்பமும்	வேப்பமும்
veppam	வெப்பம்	வேப்பம்
veruththu	வெறுத்து	வெருத்து
verumaiyaana	வெறுமையான	வெருமையான
vetrikaramaakath	வெற்றிகரமாகத்	வெற்றிகராகத்தக்
vetrtrigaramaagath	வெற்றிகரமாகத்	வெற்றிகராமாகத்
vetrtrikaramaakath	வெற்றிகரமாகத்	வெற்றிகராகத்தம்
vetrikaramaakap	வெற்றிகரமாகப்	வெற்றிக்கபாரமம்
vetrtrigaramaagap	வெற்றிகரமாகப்	வெற்றிகராகப்படம்
vetrtrikaramaakap	வெற்றிகரமாகப்	வெற்றிகர்கபாாக
velippadaiyaana	வெளிப்படையான	வெளிப்படையான
velippataiyaana	வெளிப்படையான	வெளிப்படையான
velipppadaiyaana	வெளிப்படையான	வெளிப்படையான
velippaadae	வெளிப்பாடே	வெளிப்பாடே
velippura	வெளிப்புற	வெளிப்புற
velippurak	வெளிப்புறக்	வெளிப்புரக்
velippurath	வெளிப்புறத்	வெளிப்புரத்
velippuraththil	வெளிப்புறத்தில்	வெளிப்புறத்தில்
velippuramaaga	வெளிப்புறமாக	வெளிப்புரமாக
veliyaagi	வெளியாகி	வெளியாகி
veliyaaki	வெளியாகி	வெளியாகி
veliyaagina	வெளியாகின	வெளியாகின
veliyaakina	வெளியாகின	வெளியாகின
veliyidappatta	வெளியிடப்பட்ட	வெளியிடப்பட்ட
veliyidappattadhu	வெளியிடப்பட்டது	வெளியிடப்பட்டது
veliyidappattathu	வெளியிடப்பட்டது	வெளியிடப்பட்டது
veliyidappattu	வெளியிடப்பட்டு	வெளியிடப்பட்டு
vaedkai	வேட்கை	வேட்கை
vaetgai	வேட்கை	வேட்கை
vaetkai	வேட்கை	வேட்கை
vaedkaiyil	வேட்கையில்	வேட்கையில்
vaetkaiyil	வேட்கையில்	வேட்கையில்
vaedhangkalin	வேதங்களின்	வேதங்களின்
vaethangalin	வேதங்களின்	வேதங்களின்
vaethangkalin	வேதங்களின்	வேதங்களின்
vaedhangkalai	வேதங்களை	வேதங்களை
vaethangalai	வேதங்களை	வேதங்களை
vaethangkalai	வேதங்களை	வேதங்களை
vaedhangkalaiyum	வேதங்களையும்	வேதங்களையும்
vaethangalaiyum	வேதங்களையும்	வேதங்களையும்
vaethangkalaiyum	வேதங்களையும்	வேதங்களையும்
vaedhangkal	வேதங்கள்	வேதங்கள்
vaethangal	வேதங்கள்	வேதங்கள்
vaethangkal	வேதங்கள்	வேதங்கள்
vaedham	வேதம்	வேதம்
vaetham	வேதம்	வேதம்
vedam	வேதம்	வேடம்
vedham	வேதம்	வேதம்
vaedhaala	வேதாள	வேதால
vaethaala	வேதாள	வேதால
vedhaala	வேதாள	வேதால
vaedhik	வேதிக்	வேதிக்
vaethik	வேதிக்	வேதிக்
vaedhiya	வேதிய	வேதிய
vaethiya	வேதிய	வேதிய
vaeyappatta	வேயப்பட்ட	வேயப்பட்ட
vaeril	வேரில்	வேரில்
giragavaasiyaa	வேற்று	கிரகாசியா
gragavaasiyaa	வேற்று	கிரகாசியா
kiragavaasiyaa	வேற்று	கிரகாசியா
kirakavaasiyaa	வேற்று	கிரகாசியவா
kirakavaciya	வேற்று	கிறகவசய்
vaeloor	வேலூர்	வேலூர்
vellore	வேலூர்	வெல்லூர்
vaelaigalilum	வேலைகளிலும்	வேலைகளிலும்
vaelaikalilum	வேலைகளிலும்	வேலைகளிலும்
vaelaigalil	வேலைகளில்	வேலைகளில்
vaelaikalil	வேலைகளில்	வேலைகளில்
vaelaigalukku	வேலைகளுக்கு	வேலைகளுக்கு
vaelaikalukku	வேலைகளுக்கு	வேலைகளுக்கு
vaelaigalaiyum	வேலைகளையும்	வேலைகளையும்
vaelaikalaiyum	வேலைகளையும்	வேலைகளையும்
vaelaigal	வேலைகள்	வேலைகள்
vaelaikal	வேலைகள்	வேலைகள்
vaelaikkaaga	வேலைக்காக	வேலைக்காக
vaelaikkaaka	வேலைக்காக	வேலைக்காக
vaelaikku	வேலைக்கு	வேலைக்கு
chellavum	வேலைக்குச்	செல்லவும்
vaelaikkuch	வேலைக்குச்	வேலைக்குச்
vealaikkuch	வேலைக்குச்	வேலைக்குச்
thittangalukku	வேலைத்	திட்டங்களுக்கு
thittangkalukku	வேலைத்	திட்டங்களுக்கு
thittaththin	வேலைத்	திட்டத்தின்
tittankalukku	வேலைத்	திட்டங்களுக்கு
vaelaiththittangal	வேலைத்திட்டங்கள்	வேலைத்திடங்கள்
vaelaiththittanggal	வேலைத்திட்டங்கள்	வேலைத்திடங்கள்
vaelaiththittangkal	வேலைத்திட்டங்கள்	வேலைத்திடங்கள்
vaelaiyilirunththu	வேலையிலிருந்து	வேலையிலிருந்து
vaelaiyilirunthu	வேலையிலிருந்து	வேலையிலிருந்து
vealaiyilirunthu	வேலையிலிருந்து	வேலையிலிருந்து
vaelaiyum	வேலையும்	வேலையும்
vealaiyum	வேலையும்	வேலையும்
vaelaangganni	வேளாங்கண்ணி	வேலாங்கண்ணி
vaelaangkanni	வேளாங்கண்ணி	வேலாங்கண்ணி
vealaankanni	வேளாங்கண்ணி	வேலாங்குணி
velankanni	வேளாங்கண்ணி	வெளங்கன்
vaiguntaththil	வைகுண்டத்தில்	வைகுண்டத்தில்
vaikundaththil	வைகுண்டத்தில்	வைகுண்டத்தில்
vaiguntam	வைகுண்டம்	வைகுண்டம்
vaikundam	வைகுண்டம்	வைகுண்டம்
vaiko	வைகோ	வைக்கோ
vaikoa	வைகோ	வைக்கோ
vaibava	வைபவ	வைப்
vaipava	வைபவ	வைப்ப
vaibav	வைபவ்	வைப்
vaibhav	வைபவ்	வைப்
vaipav	வைபவ்	வைப்
shaa	ஷா	ஷா
shah	ஷா	ஷா
shaavin	ஷாவின்	சாவின்
shahvin	ஷாவின்	ஷா்்ி
shavin	ஷாவின்	சாவின்
scot	ஸ்காட்	ஸ்கோட்
scott	ஸ்காட்	ஸ்கட்
skaat	ஸ்காட்	ஸ்காட்
skad	ஸ்காட்	ஸ்கட்
spais	ஸ்பைஸ்	ஸ்பாய்ஸ்
spice	ஸ்பைஸ்	ஸ்பிடிக்
shreenivaacha	ஸ்ரீநிவாச	ஸ்ரீனிவாசா
sreenivaasa	ஸ்ரீநிவாச	ஸ்ரீனிவாசா
srinivaacha	ஸ்ரீநிவாச	ஸ்ரீனிவாசா
srinivaasa	ஸ்ரீநிவாச	ஸ்ரீனிவாசா
srinivasa	ஸ்ரீநிவாச	ஸ்ரீனிவாசா
shreerangkam	ஸ்ரீரங்கம்	ஸ்ரீரங்கம்
sreerangam	ஸ்ரீரங்கம்	ஸ்ரீரங்கம்
srirangam	ஸ்ரீரங்கம்	ஸ்ரீரங்கம்
sriranggam	ஸ்ரீரங்கம்	ஸ்ரீரங்கம்
srirangkam	ஸ்ரீரங்கம்	ஸ்ரீரங்கம்
svaram	ஸ்வரம்	சுவரம்
swaram	ஸ்வரம்	சுவாரம்
sveet	ஸ்வீட்	ஸ்வீட்
sviid	ஸ்வீட்	சுவிட்
sweet	ஸ்வீட்	சுவிட்
swiit	ஸ்வீட்	சுவிட்
hangari	ஹங்கேரி	ஹாங்கரி
hangary	ஹங்கேரி	ஹாங்கரி
hanggaeri	ஹங்கேரி	ஹங்கேறி
hankeari	ஹங்கேரி	ஹாங்கேரி
hankeeri	ஹங்கேரி	ஹாங்கிரி
hungaeri	ஹங்கேரி	ஹுங்கேறி
hungari	ஹங்கேரி	ஹுங்கரி
hungarii	ஹங்கேரி	ஹுங்கரி
hungary	ஹங்கேரி	ஹுங்கரி
hungeery	ஹங்கேரி	ஹுங்கேரி
hungeri	ஹங்கேரி	ஹுங்கேரி
hungery	ஹங்கேரி	ஹுங்கேரி
huungarii	ஹங்கேரி	ஹுங்கரி
huungary	ஹங்கேரி	ஹுங்கரி
huungery	ஹங்கேரி	ஹுங்கேரி
handar	ஹண்டர்	ஹந்தர்
hantar	ஹண்டர்	ஹந்தர்
hanter	ஹண்டர்	ஹெட்டர்
huntar	ஹண்டர்	ஹுந்தர்
huntarr	ஹண்டர்	ஹுந்தர்
hunter	ஹண்டர்	ஹுந்தர்
hunterr	ஹண்டர்	ஹுந்தர்
huuntar	ஹண்டர்	ஹுந்தர்
huunter	ஹண்டர்	ஹுந்தர்
huunterr	ஹண்டர்	ஹுந்தர்
hampi	ஹம்பி	ஹாம்பி
haam	ஹாம்	ஹாம்
haem	ஹாம்	ஹேம்
haim	ஹாம்	ஹாம்
ham	ஹாம்	ஹாம்
hamm	ஹாம்	ஹாம்
haum	ஹாம்	ஹாம்
hauum	ஹாம்	ஹாம்
haym	ஹாம்	ஹாம்
hom	ஹாம்	ஹாம்
home	ஹாம்	ஹாம்
haarisan	ஹாரிசன்	ஹாரிசன்
haarison	ஹாரிசன்	ஹாரிஷ்
haarisun	ஹாரிசன்	ஹாரின்ஸ்
hareeson	ஹாரிசன்	ஹரீசியன்
harisan	ஹாரிசன்	ஹரிசன்
harisaun	ஹாரிசன்	ஹரிசன்
harison	ஹாரிசன்	ஹாரிஷ்
harreeson	ஹாரிசன்	ஹர்ரியிஸ்
harriison	ஹாரிசன்	ஹரி்்சியின்
harrisaun	ஹாரிசன்	ஹரிச்சன்
harrisauun	ஹாரிசன்	ஹரிசுன்
harrison	ஹாரிசன்	ஹாரிஷ்யன்
he	ஹி	ஹே
hi	ஹி	ஹி
hills	ஹில்ஸ்	ஹில்ஸ்
hils	ஹில்ஸ்	ஹில்ஸ்
hook	ஹூக்	ஹுக்
hooq	ஹூக்	ஹாக்
huk	ஹூக்	ஹக்
huuk	ஹூக்	ஹக்
helsiinkii	ஹெல்சின்கி	ஹெல்சிகினி
helsinki	ஹெல்சின்கி	ஹெல்சிக்கி
helsinqi	ஹெல்சின்கி	ஹெல்சிக்னி
health	ஹெல்த்	ஹெல்
haerath	ஹேரத்	ஈரத்
hearath	ஹேரத்	ஈராத்
herath	ஹேரத்	ஈரத்
heyrath	ஹேரத்	ஹெற்த்
haikkoo	ஹைக்கூ	ஹெக்கோ
haiku	ஹைக்கூ	ஹெக்கு
hikkoo	ஹைக்கூ	ஹிக்கோ
haidrookarpan	ஹைட்ரோகார்பன்	ஹைட்ரோர்கப்
hidrocarbon	ஹைட்ரோகார்பன்	ஹிட்ரோப்பரின்
hydrocarbon	ஹைட்ரோகார்பன்	எத்ரோப்பரின்
hydroocarboon	ஹைட்ரோகார்பன்	எத்ர்பூபர்ஜுன்
hoali	ஹோலி	ஹாலி
holee	ஹோலி	ஹாலி
holey	ஹோலி	ஹாலி
holi	ஹோலி	ஹாலி
holii	ஹோலி	ஹாலி
hollee	ஹோலி	ஹால்
hollei	ஹோலி	ஹால்
holley	ஹோலி	ஹால்
holli	ஹோலி	ஹாலி
hollii	ஹோலி	ஹால்
holly	ஹோலி	ஹாலி
holy	ஹோலி	ஹாலி
hooli	ஹோலி	ஹாலி
hoolii	ஹோலி	ஹாலி
hoollee	ஹோலி	ஹலல
hoolley	ஹோலி	ஹால்
hoolli	ஹோலி	ஹாலி
hoolly	ஹோலி	ஹாலி
hooly	ஹோலி	ஹாலி
huli	ஹோலி	ஹலி
